sqft_living,grade,sqft_above,bathrooms,quartier,view,sqft_basement,bedrooms,waterfront,floors
1430,7,1430,1.5,0,0,0,2,0,3.0
4670,12,4670,3.25,0,0,0,4,0,2.0
1440,7,1200,0.75,0,0,240,2,0,1.0
1130,8,1130,1.0,0,0,0,2,0,1.0
3180,9,3180,2.5,0,2,0,4,0,2.0
1650,7,1650,2.5,0,0,0,3,0,2.0
1720,7,1720,2.75,0,0,0,3,0,1.0
2538,8,2538,2.5,0,0,0,3,0,2.0
2460,9,2460,2.5,0,0,0,4,0,2.0
4460,10,3280,3.5,0,2,1180,5,0,3.0
2360,9,2360,1.75,1,0,0,4,0,1.0
1720,7,1720,2.5,0,0,0,3,0,2.0
1020,8,1020,1.5,0,0,0,2,0,3.0
1340,7,1340,1.5,0,0,0,3,0,1.0
3180,9,3180,2.5,1,0,0,4,0,2.0
1220,6,610,1.75,0,0,610,2,0,1.0
1530,7,1530,2.25,0,0,0,3,0,2.0
2130,7,1650,2.0,0,0,480,4,0,1.5
930,6,930,1.0,0,0,0,2,0,1.0
1370,7,1130,2.0,0,0,240,3,0,1.0
1670,7,1130,2.5,0,0,540,3,0,1.0
2220,7,1260,2.75,0,0,960,4,0,1.0
1900,7,1900,3.0,0,0,0,4,0,2.0
1100,6,1100,1.75,0,0,0,3,0,1.0
2370,8,1660,2.5,0,0,710,4,0,1.0
1100,6,840,1.0,0,0,260,3,0,1.0
1530,7,1530,2.0,0,0,0,4,0,1.0
1640,7,1480,1.75,0,0,160,4,0,1.5
2110,9,1760,1.75,0,4,350,2,0,1.0
1690,7,1230,1.5,0,0,460,3,0,1.0
2070,9,1760,3.25,0,3,310,2,1,2.0
2020,6,1010,1.75,0,0,1010,4,0,1.0
2560,8,2560,2.5,0,0,0,4,0,2.0
3330,9,2870,3.25,1,0,460,4,0,2.0
3070,9,3070,2.25,0,0,0,4,0,2.0
1820,7,1220,2.5,0,0,600,3,0,1.0
1260,7,1040,1.5,0,0,220,3,0,2.0
2040,7,2040,2.5,0,0,0,4,0,2.0
2600,7,1300,1.75,0,0,1300,3,0,1.0
1080,6,990,1.0,0,0,90,3,0,1.5
1180,7,1180,1.0,0,0,0,3,0,1.0
1390,6,1390,1.0,0,0,0,1,0,1.0
2410,7,1510,1.0,0,0,900,4,0,1.0
2650,9,2650,2.5,0,0,0,4,0,2.0
2350,8,1430,2.25,1,0,920,4,0,1.0
2370,8,2370,2.5,1,0,0,4,0,2.0
1870,7,1870,2.0,0,0,0,4,0,1.5
3140,9,3140,2.5,0,0,0,4,0,2.0
1550,7,1550,1.0,0,0,0,3,0,1.5
3170,10,3170,2.5,1,0,0,4,0,2.0
1420,7,1420,1.5,0,0,0,3,0,1.0
2210,7,1540,2.25,0,0,670,3,0,1.0
3200,8,1600,2.25,1,0,1600,5,0,1.0
1150,7,1150,1.75,0,0,0,3,0,1.0
3510,10,3510,2.5,0,0,0,4,0,2.0
1330,7,900,1.0,0,0,430,3,0,1.0
1530,7,1116,2.25,0,0,414,3,0,2.0
2000,7,1300,2.25,0,0,700,5,0,1.0
1280,7,1280,1.0,0,0,0,3,0,1.5
2700,8,1760,2.25,0,0,940,3,0,2.0
1250,8,1080,2.5,0,0,170,3,0,2.0
2070,7,2070,2.5,0,0,0,4,0,2.0
1350,8,1350,2.0,0,0,0,2,0,1.0
3110,8,1560,2.5,0,2,1550,3,0,1.0
2840,8,2840,2.5,0,0,0,5,0,2.0
3160,10,3160,3.75,1,0,0,4,0,2.5
1640,8,1640,2.0,0,0,0,3,0,1.0
2740,7,1440,1.75,0,0,1300,4,0,1.0
3460,10,2560,3.5,0,0,900,4,0,2.0
1970,7,1170,1.75,0,0,800,5,0,1.0
3672,9,3006,3.5,0,0,666,5,0,2.0
1540,7,1540,2.0,0,0,0,4,0,1.5
2110,8,2110,2.5,0,0,0,4,0,2.0
1630,10,1630,2.0,0,0,0,3,0,1.0
3190,10,3190,2.25,0,0,0,4,0,2.0
4480,9,4480,3.0,0,0,0,4,0,2.0
2610,9,2610,3.25,0,4,0,3,1,2.0
3390,8,1750,2.5,0,0,1640,5,0,1.0
1680,7,1680,1.5,1,0,0,3,0,1.0
2130,9,2130,2.5,0,0,0,4,0,2.0
2010,9,2010,2.5,0,0,0,3,0,2.0
2390,9,1790,1.5,0,1,600,3,0,2.0
3910,8,3910,2.5,1,0,0,4,0,1.5
2150,7,1330,2.5,0,0,820,3,0,2.0
2070,9,1590,2.5,0,0,480,4,0,1.5
2060,8,1900,2.5,0,0,160,3,0,2.0
1550,7,1550,2.25,0,0,0,3,0,2.0
1340,7,1340,1.75,0,0,0,3,0,1.0
1750,7,1150,2.25,0,0,600,4,0,1.0
1150,7,1150,1.0,0,0,0,3,0,1.0
5584,11,5584,4.25,0,0,0,4,0,2.0
2690,7,2690,2.5,0,0,0,3,0,2.0
2390,8,1360,2.75,1,0,1030,3,0,1.0
2320,7,1140,1.75,0,0,1180,4,0,1.0
4810,11,4810,4.0,1,3,0,4,0,2.0
1610,7,1610,2.25,0,0,0,2,0,2.0
2080,8,1530,2.25,0,0,550,3,0,1.0
2710,9,2710,2.5,0,0,0,4,0,2.0
1530,7,1150,1.75,1,0,380,3,0,1.0
2130,7,2130,3.0,0,0,0,4,0,1.5
1200,7,1000,1.5,0,0,200,3,0,1.0
2390,8,1750,1.5,0,0,640,3,0,2.0
2500,9,2500,2.5,0,0,0,4,0,2.0
4060,11,4060,3.25,1,3,0,4,0,2.0
1700,7,1700,1.75,1,0,0,3,0,1.0
2430,8,2430,2.5,0,0,0,4,0,2.0
1940,7,1940,2.5,0,0,0,3,0,2.0
2210,8,1410,2.25,0,0,800,2,0,1.0
1120,7,1120,1.0,0,0,0,2,0,1.0
1820,7,1820,1.5,0,0,0,2,0,2.0
1920,7,960,1.75,0,2,960,3,0,1.0
3040,10,3040,2.75,1,0,0,5,0,2.0
1010,6,1010,1.0,0,0,0,4,0,1.0
3000,8,3000,2.5,0,0,0,4,0,2.0
2490,8,2490,2.5,0,0,0,4,0,2.0
3160,10,3160,2.5,0,0,0,4,0,1.0
1600,7,1600,2.5,0,0,0,3,0,2.0
1740,7,1400,1.5,0,0,340,4,0,1.5
1660,7,1000,2.0,0,0,660,3,0,1.0
3600,9,3600,2.75,0,0,0,5,0,2.0
1847,7,1847,2.5,0,0,0,4,0,2.0
1710,8,1710,2.5,0,0,0,3,0,2.0
1160,7,1160,1.0,0,0,0,3,0,1.5
3960,9,2500,3.5,0,0,1460,5,0,2.0
1230,8,1020,2.25,0,0,210,2,0,2.0
1200,7,1200,1.0,0,0,0,3,0,1.0
810,6,810,1.0,0,0,0,3,0,1.0
2080,7,1040,2.5,0,0,1040,4,0,1.0
950,7,830,1.0,0,0,120,3,0,1.0
950,6,950,1.0,0,0,0,3,0,1.0
2880,9,2880,2.5,0,3,0,4,0,2.0
980,7,980,1.0,0,0,0,3,0,1.5
1140,7,1140,1.0,0,0,0,2,0,1.0
1240,7,1240,1.5,0,0,0,4,0,1.0
2140,8,1370,2.5,0,2,770,5,0,1.0
1760,7,1760,2.0,0,0,0,4,0,1.0
2740,9,2740,2.5,0,0,0,4,0,2.0
1050,7,1050,1.0,0,0,0,3,0,1.5
1370,7,1370,2.5,0,0,0,3,0,2.0
2010,9,2010,1.75,0,0,0,4,0,1.0
2800,9,2800,2.25,0,0,0,3,0,2.0
1450,7,1450,2.0,0,0,0,4,0,1.0
2590,10,2590,2.75,1,0,0,3,0,2.0
1860,7,1860,1.0,0,0,0,4,0,1.0
1310,7,1310,1.75,0,0,0,3,0,1.0
2680,8,2680,2.5,0,0,0,4,0,2.0
3000,8,3000,2.5,0,0,0,4,0,2.0
1960,6,980,2.5,0,0,980,4,0,1.0
2040,8,2040,2.5,0,0,0,4,0,2.0
1200,8,1200,2.25,0,0,0,3,0,3.0
3720,9,3720,3.25,0,0,0,4,0,2.0
2610,8,2610,2.75,0,0,0,4,0,2.0
1290,8,1290,1.5,0,0,0,3,0,3.0
2570,8,1720,2.75,0,0,850,4,0,2.0
1370,6,1370,1.5,0,0,0,3,0,1.0
2400,7,1780,3.25,0,0,620,5,0,2.0
1590,7,1590,1.0,0,0,0,3,0,2.0
3190,9,3190,2.5,0,2,0,4,0,2.0
940,7,860,1.5,0,0,80,2,0,2.0
2150,8,2150,2.5,0,0,0,4,0,2.0
1440,8,1440,1.5,0,0,0,3,0,1.0
3410,10,2220,3.0,1,4,1190,3,1,2.0
2870,9,2870,2.75,0,0,0,4,0,2.0
1840,7,1840,2.5,0,0,0,3,0,2.0
1850,8,1850,2.0,0,0,0,2,0,1.0
2170,7,2170,2.75,0,0,0,4,0,1.5
1790,6,1410,1.75,0,0,380,4,0,1.5
1820,7,1820,2.5,0,0,0,3,0,2.0
2320,8,2320,2.5,0,0,0,3,0,2.0
1090,6,1090,2.0,0,0,0,3,0,1.0
1690,7,1690,1.75,0,0,0,4,0,1.0
2000,7,2000,2.5,0,0,0,3,0,2.0
3200,10,3200,3.5,0,0,0,3,0,2.0
1090,6,1090,1.0,0,0,0,1,0,1.0
2640,8,1730,2.75,0,0,910,4,0,2.0
1160,7,1160,1.0,0,0,0,3,0,1.0
1620,7,1620,2.5,0,0,0,4,0,2.0
5550,11,4270,4.25,1,2,1280,6,0,2.0
860,6,860,1.0,0,0,0,3,0,1.0
1800,8,1800,2.25,0,0,0,4,0,2.0
930,6,730,1.0,0,0,200,2,0,1.0
1220,6,1220,1.0,0,0,0,3,0,1.0
2290,8,2290,2.5,0,0,0,4,0,2.0
2410,7,2410,2.5,0,0,0,3,0,2.0
750,6,750,1.0,0,0,0,2,0,1.0
1660,8,1660,2.0,0,0,0,3,0,2.0
1320,6,880,1.0,0,0,440,3,0,1.0
4650,10,3260,4.25,0,0,1390,5,0,2.0
3410,11,3410,5.25,1,0,0,5,0,2.0
2520,9,1590,2.25,0,0,930,3,0,2.0
1770,7,1770,2.0,0,0,0,3,0,1.0
820,6,820,1.0,0,0,0,3,0,1.0
2100,7,1030,1.75,0,0,1070,4,0,1.0
2340,7,2340,2.25,0,0,0,4,0,2.0
2500,9,2500,2.5,0,0,0,4,0,2.0
2390,8,1810,2.5,0,3,580,2,0,2.0
1230,6,1230,1.5,0,0,0,3,0,1.0
2250,9,2250,2.5,0,0,0,4,0,2.0
1980,7,1980,2.5,0,0,0,3,0,2.0
2230,7,1330,2.75,0,2,900,4,0,1.0
1590,7,1220,2.5,0,0,370,2,0,2.0
1650,7,1000,1.75,1,0,650,2,0,1.0
1040,6,1040,1.0,0,0,0,4,0,1.5
4060,9,4060,3.25,0,0,0,4,0,2.0
1040,6,1040,1.0,0,0,0,3,0,1.0
1190,7,1190,1.75,0,0,0,3,0,1.0
3870,10,3150,3.25,1,0,720,3,0,2.0
1520,8,1520,1.75,0,0,0,3,0,1.0
3045,8,3045,3.0,0,0,0,5,0,2.0
2250,7,1340,2.5,0,0,910,4,0,1.0
1480,7,1480,1.5,0,0,0,3,0,1.0
1880,8,1480,1.5,0,0,400,3,0,1.0
1320,7,1320,1.5,0,0,0,3,0,1.0
2240,8,1340,2.0,0,2,900,4,0,1.0
1090,7,1090,1.5,1,0,0,3,0,1.0
1870,7,1470,1.5,0,0,400,3,0,1.0
1260,6,840,1.0,0,0,420,3,0,1.0
3150,10,2480,2.75,0,0,670,4,0,1.0
3000,9,1610,2.5,1,0,1390,5,0,1.0
1640,6,1640,1.75,0,0,0,3,0,1.0
1540,7,1120,2.0,0,0,420,3,0,1.0
3290,10,3290,2.5,0,0,0,4,0,2.0
2940,8,1470,1.5,0,0,1470,5,0,1.0
2100,7,1050,1.75,0,0,1050,4,0,1.0
1120,7,870,1.75,0,0,250,3,0,1.0
1270,7,1270,1.0,0,0,0,3,0,1.0
1690,7,1690,2.25,0,0,0,3,0,2.0
2760,7,1790,2.25,0,0,970,4,0,2.0
1880,7,1880,3.0,0,0,0,6,0,1.0
1270,7,1120,1.0,0,0,150,3,0,1.0
2800,8,2800,3.0,0,0,0,4,0,2.0
2700,8,2700,2.5,0,0,0,4,0,2.0
2880,8,2880,2.25,0,0,0,5,0,2.0
2290,8,2290,2.25,0,0,0,2,0,1.0
1360,7,1360,1.5,0,0,0,3,0,1.0
3030,8,3030,2.5,0,0,0,3,0,2.0
810,7,810,1.5,1,0,0,1,0,2.0
2280,7,1540,2.75,0,0,740,4,0,1.5
1890,8,1290,2.5,0,0,600,4,0,1.0
1660,8,1660,2.25,0,0,0,2,0,2.0
2940,9,1710,2.5,1,0,1230,3,0,1.0
3060,8,2460,3.0,0,2,600,4,0,1.0
1970,7,1220,1.75,0,0,750,4,0,1.0
1460,9,1180,2.25,0,0,280,2,0,2.0
1370,7,1370,1.5,0,0,0,3,0,1.0
1640,7,840,2.0,0,2,800,2,0,1.0
2590,8,1440,2.25,0,0,1150,3,0,1.0
1820,7,1100,1.75,0,0,720,4,0,1.0
1660,7,1150,2.5,0,0,510,3,0,1.0
2170,7,2170,1.75,0,0,0,3,0,1.0
1550,7,1550,1.75,0,0,0,3,0,1.5
1430,7,830,2.0,0,0,600,3,0,1.0
2660,8,2660,2.75,0,0,0,3,0,1.0
1470,7,1470,2.0,0,0,0,3,0,1.5
3350,7,2140,3.5,0,1,1210,4,0,1.0
2100,8,2100,2.5,0,0,0,3,0,2.0
1380,7,750,2.0,0,0,630,3,0,1.0
2590,8,2590,3.0,0,0,0,4,0,2.0
900,6,900,0.75,0,0,0,2,0,1.0
1040,6,850,2.0,0,0,190,2,0,1.0
2090,8,1360,1.75,0,0,730,4,0,1.0
2230,7,1220,1.5,0,1,1010,4,0,1.0
850,6,850,1.0,0,0,0,1,0,1.0
1650,8,1650,1.75,0,0,0,4,0,1.0
940,7,940,1.0,0,0,0,3,0,1.0
2820,8,2820,2.5,0,0,0,5,0,2.0
2560,10,2110,3.0,0,0,450,3,0,2.0
1030,7,1030,1.0,0,0,0,3,0,1.0
2000,8,2000,2.25,1,0,0,4,0,2.0
1820,7,1220,2.5,0,0,600,4,0,1.0
1250,8,1250,2.5,0,2,0,3,0,3.0
3110,9,3110,2.5,0,0,0,4,0,2.0
3930,10,3930,3.25,1,0,0,4,0,2.0
1780,8,1780,2.5,0,0,0,3,0,3.0
1140,7,1140,1.0,0,0,0,3,0,1.0
1240,7,1240,1.0,0,0,0,2,0,1.0
640,6,640,1.0,0,0,0,2,0,1.0
2330,8,1740,2.25,0,0,590,4,0,1.0
2330,9,2330,2.75,0,0,0,4,0,2.0
880,7,880,1.0,0,0,0,2,0,1.0
2410,8,1860,1.75,0,0,550,3,0,1.0
1730,7,1730,2.0,0,0,0,3,0,1.0
2330,7,1180,1.75,0,0,1150,5,0,1.0
2260,9,1660,2.5,0,0,600,3,0,1.0
4380,11,4380,3.5,0,0,0,4,0,1.0
970,6,970,1.0,0,0,0,3,0,1.0
1790,7,1330,1.75,0,0,460,3,0,1.0
930,6,930,1.0,0,0,0,3,0,1.0
1600,7,1600,2.0,0,0,0,4,0,1.0
1553,8,1553,2.5,0,0,0,3,0,3.0
2060,7,1460,1.75,0,0,600,4,0,1.5
2180,8,2180,2.5,0,0,0,4,0,2.0
2200,8,2200,2.5,0,0,0,4,0,2.0
2980,10,1820,3.0,0,0,1160,3,0,1.0
1730,7,1360,2.5,0,0,370,3,0,1.0
1670,7,1670,1.75,0,0,0,2,0,2.0
2430,7,2430,2.75,0,0,0,4,0,1.0
1870,7,1870,2.5,0,0,0,4,0,2.0
1940,7,1290,2.5,0,0,650,5,0,1.0
2020,8,2020,2.25,1,0,0,3,0,2.0
1750,7,1350,2.0,0,0,400,3,0,1.0
3210,7,1810,2.75,0,2,1400,4,0,1.0
1390,7,930,1.0,0,0,460,2,0,1.0
1700,7,1700,1.0,0,0,0,3,0,1.5
3640,10,3640,2.75,0,0,0,4,0,1.5
2780,8,2780,2.25,0,0,0,3,0,2.0
1720,7,1720,1.0,1,0,0,3,0,1.0
5150,11,4170,4.25,1,2,980,3,0,2.5
1950,7,1250,1.75,0,0,700,3,0,1.0
3970,9,3970,2.5,0,0,0,3,0,1.5
1890,7,1390,1.0,0,0,500,3,0,1.5
870,7,870,1.0,0,0,0,3,0,1.0
2330,8,2330,2.25,0,0,0,3,0,1.5
2200,9,2200,1.5,0,0,0,3,0,1.5
1090,7,1090,2.0,0,0,0,3,0,1.0
2120,8,1590,2.25,0,0,530,3,0,1.0
1160,7,1160,1.75,0,0,0,3,0,1.0
1970,8,1970,1.75,0,0,0,3,0,1.0
3160,9,2020,2.5,0,4,1140,4,0,1.5
1830,7,1370,2.0,0,0,460,4,0,1.0
1360,7,1050,1.5,0,0,310,3,0,1.0
2380,8,2380,1.75,0,0,0,6,0,2.0
2730,7,2730,2.5,0,0,0,4,0,2.0
2490,7,2490,2.5,0,0,0,4,0,2.0
1780,6,930,2.0,0,0,850,4,0,1.5
2360,8,2360,2.5,0,0,0,3,0,2.0
1440,8,1440,2.0,0,0,0,2,0,1.0
1620,7,1280,2.25,0,0,340,3,0,1.0
1870,7,1070,1.75,0,0,800,4,0,1.0
1770,8,1430,3.25,0,0,340,3,0,2.0
3750,10,3750,2.5,0,0,0,4,0,2.0
4240,10,4240,3.25,1,2,0,4,0,2.0
1550,7,1550,2.0,0,0,0,4,0,1.5
3090,9,3090,2.75,1,0,0,5,0,1.0
3560,9,2970,3.0,1,2,590,4,0,3.0
1090,7,1090,1.0,0,0,0,3,0,1.5
3640,9,1960,3.25,0,2,1680,4,0,2.0
1750,5,1750,2.0,0,0,0,4,0,1.0
2660,9,2660,2.5,0,0,0,4,0,2.0
820,6,820,1.0,0,0,0,2,0,1.0
1940,8,970,1.75,0,0,970,4,0,1.0
1350,7,1350,1.0,0,0,0,3,0,1.0
2250,8,2250,3.0,0,0,0,4,0,2.0
4830,9,3930,5.25,1,1,900,5,0,2.0
940,6,940,1.0,0,0,0,3,0,1.0
1610,8,1610,2.0,0,0,0,3,0,2.0
3480,9,3480,3.25,0,0,0,5,0,2.0
1230,7,1230,1.5,0,0,0,3,0,1.0
3840,10,2750,3.25,0,3,1090,5,0,3.0
2690,8,2690,2.75,0,0,0,4,0,2.0
1060,6,1060,1.0,0,0,0,2,0,1.0
1600,7,1600,2.25,0,0,0,2,0,2.0
1750,7,1750,1.75,0,0,0,3,0,2.0
3090,9,3090,2.75,1,0,0,4,0,2.0
3420,9,2540,3.0,1,0,880,5,0,2.0
2210,8,2210,2.5,0,0,0,4,0,1.0
1750,7,1350,2.25,0,0,400,3,0,1.0
1890,8,1430,1.75,0,0,460,3,0,1.0
2030,8,2030,2.5,0,0,0,4,0,2.0
1570,7,1570,1.5,0,0,0,4,0,1.0
2160,9,2160,2.0,0,0,0,2,0,1.0
2560,6,1280,3.5,0,0,1280,2,0,1.0
1080,5,1080,1.0,0,0,0,3,0,1.0
1080,7,1080,1.0,0,0,0,3,0,1.5
1190,7,1030,1.0,0,0,160,3,0,1.0
1940,7,1940,2.0,0,0,0,5,0,1.5
3500,7,3500,4.5,0,0,0,6,0,2.0
1584,7,1584,2.25,0,0,0,3,0,2.0
3180,9,2500,3.75,1,0,680,4,0,2.0
2110,7,1990,2.0,0,0,120,3,0,1.5
1450,7,1450,2.25,0,0,0,3,0,2.0
2810,9,2810,2.5,0,0,0,4,0,2.0
1830,8,1830,2.5,0,0,0,3,0,2.0
2820,9,1770,2.5,0,4,1050,3,0,1.0
1880,8,1880,2.5,0,0,0,3,0,2.0
820,6,820,1.0,0,0,0,2,0,1.0
1220,6,1220,1.0,1,0,0,2,0,1.0
1680,7,840,1.0,0,0,840,3,0,1.0
2650,8,2650,2.5,0,0,0,4,0,2.0
1920,9,1920,2.0,0,3,0,3,0,1.0
2410,9,2410,2.5,0,3,0,4,0,2.0
1770,7,1400,1.75,0,0,370,3,0,1.0
2940,7,2940,3.75,0,0,0,6,0,2.0
3100,7,1790,2.25,0,0,1310,3,0,1.0
1980,7,1080,2.5,0,0,900,5,0,1.0
1384,7,1384,2.0,0,0,0,2,0,2.0
880,6,880,1.0,1,0,0,3,0,1.0
1100,6,1100,1.75,0,0,0,3,0,1.0
800,6,800,1.0,0,0,0,2,0,1.0
1710,7,910,2.0,0,0,800,4,0,1.0
1150,7,1150,1.0,0,0,0,2,0,1.0
1570,7,1110,2.5,0,0,460,3,0,1.0
2360,7,1660,1.75,0,0,700,4,0,2.0
1980,7,1180,2.5,0,0,800,1,0,1.0
2570,9,2570,2.5,0,0,0,4,0,2.0
7440,12,5550,6.0,1,0,1890,5,0,2.0
1660,7,1000,1.0,0,0,660,3,0,1.0
1840,7,1720,2.0,1,0,120,3,0,2.0
2310,10,2310,2.0,1,0,0,3,0,1.0
1890,7,1890,1.75,0,0,0,3,0,1.5
950,7,950,1.0,1,0,0,3,0,1.0
2060,8,1360,2.25,0,0,700,4,0,1.0
2400,7,1390,2.5,0,0,1010,3,0,1.0
890,7,740,1.0,0,0,150,2,0,1.0
2060,8,1070,2.25,1,0,990,3,0,1.0
1130,7,1130,1.5,0,0,0,4,0,1.0
1630,7,1100,2.5,0,0,530,5,0,1.0
2301,9,2301,2.5,0,0,0,4,0,2.0
1290,7,1290,1.0,0,0,0,3,0,1.0
3290,10,3290,2.75,0,0,0,3,0,2.0
1980,8,1980,1.0,0,0,0,3,0,1.5
1480,8,1390,2.5,0,0,90,2,0,2.0
1180,7,1180,1.5,0,0,0,3,0,1.0
1100,7,880,1.0,0,0,220,4,0,1.0
1660,7,1160,1.75,0,0,500,2,0,1.0
1677,7,1677,2.5,0,0,0,4,0,2.0
2905,9,2905,2.5,0,0,0,4,0,2.0
1150,7,1150,1.0,0,0,0,4,0,1.5
1820,7,1320,1.75,0,2,500,4,0,1.0
2240,7,1310,2.5,0,2,930,4,0,1.0
1920,7,1920,2.25,0,0,0,4,0,2.0
1880,8,1880,2.25,0,0,0,3,0,2.0
880,6,880,1.0,0,0,0,2,0,1.0
3440,9,3440,2.25,0,2,0,5,0,2.0
2820,7,1410,2.5,0,0,1410,5,0,1.0
1550,7,1550,1.75,0,1,0,2,0,1.0
1150,7,1150,1.5,0,0,0,3,0,2.0
2810,8,1640,2.75,0,0,1170,4,0,1.0
1840,7,1040,1.75,0,0,800,3,0,1.0
3080,8,3080,2.5,0,0,0,3,0,2.0
2560,7,1900,3.75,0,0,660,4,0,2.0
920,6,920,1.0,0,0,0,3,0,1.0
680,6,680,1.0,0,0,0,2,0,1.0
1880,7,1260,2.5,0,0,620,3,0,1.0
1720,7,1720,2.5,0,0,0,3,0,2.0
2580,8,2580,2.25,0,0,0,4,0,2.0
2140,8,1770,2.5,0,0,370,3,0,2.0
2360,8,2360,2.5,0,0,0,4,0,2.0
960,6,960,1.0,0,0,0,2,0,1.0
1400,8,940,2.25,0,0,460,3,0,2.0
1630,8,1630,1.75,0,0,0,3,0,3.0
2430,8,2430,2.5,0,0,0,3,0,2.0
1380,7,1380,1.0,0,0,0,3,0,1.0
1610,7,1100,1.75,0,0,510,3,0,1.0
3970,11,3390,4.75,0,2,580,4,0,2.0
3110,9,3110,2.5,0,0,0,3,0,2.0
3070,9,2050,3.25,0,0,1020,5,0,2.0
1940,8,1940,1.0,0,3,0,1,0,1.0
2540,9,2540,2.5,0,0,0,4,0,2.0
1600,7,850,1.75,1,0,750,2,0,1.0
1550,6,1370,1.0,0,4,180,4,1,1.5
1600,7,1030,1.75,1,0,570,3,0,1.0
3028,7,3028,5.0,0,0,0,6,0,2.0
2020,7,1010,1.75,0,0,1010,4,0,1.0
3370,10,3370,4.0,0,0,0,3,0,2.0
1500,8,1500,2.25,0,0,0,3,0,3.0
2000,7,1250,2.75,1,0,750,3,0,1.0
1570,7,1570,1.75,0,0,0,3,0,1.0
3110,9,3110,3.0,0,0,0,4,0,2.0
1210,7,1210,1.75,0,0,0,3,0,1.0
3490,8,3490,2.25,0,0,0,4,0,1.5
2080,8,2080,2.5,0,0,0,3,0,2.0
2480,7,2480,2.5,0,0,0,3,0,2.0
2210,8,2210,2.5,0,0,0,3,0,2.0
1870,8,1870,2.5,0,0,0,4,0,2.0
740,6,740,1.0,0,0,0,2,0,1.0
1680,7,1680,2.5,0,0,0,3,0,2.0
1350,7,1160,2.25,0,0,190,3,0,2.0
4370,11,4370,3.5,0,0,0,4,0,2.0
1120,7,1120,1.0,0,0,0,3,0,1.0
1480,7,1480,1.5,0,0,0,3,0,3.0
2580,9,2580,2.5,0,0,0,4,0,2.0
2190,7,2190,2.0,0,0,0,3,0,1.0
1970,8,1130,1.75,0,3,840,3,0,1.0
1340,6,1340,1.5,0,0,0,4,0,1.0
1260,6,1260,1.0,0,0,0,3,0,1.0
2300,7,1650,2.5,0,3,650,4,0,1.0
1120,7,1120,1.5,0,0,0,3,0,1.0
700,7,700,1.0,0,0,0,1,0,1.0
1700,8,1340,2.25,0,0,360,3,0,1.0
2220,7,1270,2.5,0,0,950,4,0,1.0
4530,8,3220,2.5,0,2,1310,3,0,2.0
1540,7,1250,1.75,0,0,290,3,0,1.0
1180,6,1180,1.75,0,0,0,3,0,1.0
1790,7,1400,3.0,0,0,390,2,0,2.0
3740,11,3100,3.25,0,0,640,3,0,2.5
1270,7,1270,1.0,0,0,0,2,0,3.0
2900,8,1450,2.5,1,3,1450,4,0,1.0
1080,7,980,1.0,0,0,100,3,0,1.0
1450,7,1450,2.0,0,0,0,3,0,2.0
1710,7,1240,1.75,0,0,470,3,0,1.0
2190,8,2190,2.5,0,0,0,4,0,2.0
1730,7,1180,1.0,0,0,550,3,0,1.0
3420,11,3420,2.5,0,0,0,3,0,2.0
7850,12,7850,4.0,0,0,0,4,0,2.0
1620,7,1620,1.75,0,0,0,2,0,1.5
2590,8,1390,2.5,0,0,1200,6,0,1.0
3090,9,1800,2.75,0,2,1290,4,0,1.0
2460,7,2460,2.5,0,0,0,3,0,2.0
1530,8,1530,1.75,0,0,0,3,0,1.0
2660,8,1470,2.75,1,4,1190,5,0,1.0
2150,8,1330,2.0,0,2,820,4,0,1.0
1990,8,1990,2.25,0,0,0,3,0,2.0
980,7,980,1.0,0,0,0,3,0,1.0
720,5,720,1.0,0,0,0,2,0,1.0
2640,10,2640,2.25,1,0,0,3,0,1.0
1190,7,1190,1.5,0,3,0,3,0,1.5
1130,7,930,1.75,0,0,200,3,0,1.0
1760,7,1160,1.75,0,0,600,3,0,1.0
1370,8,1130,1.0,0,2,240,2,0,1.0
2120,7,2120,2.25,0,0,0,3,0,2.0
2230,8,2230,2.25,0,0,0,4,0,2.0
3480,9,1980,2.5,0,0,1500,4,0,1.0
2850,8,2850,2.75,0,0,0,4,0,2.0
1390,7,1390,1.0,0,0,0,4,0,1.5
1440,7,1440,1.0,0,0,0,4,0,1.0
1900,8,1900,2.5,0,0,0,3,0,2.0
3210,9,3210,3.5,0,0,0,4,0,3.0
2570,7,2570,2.5,0,0,0,4,0,2.0
2310,8,1630,1.75,0,0,680,3,0,1.0
4100,9,4100,4.0,0,0,0,5,0,2.0
1710,6,1310,1.0,0,0,400,3,0,1.0
2370,7,2370,2.0,0,0,0,2,0,1.0
2590,10,2590,2.0,0,2,0,4,0,2.0
1670,7,1170,2.0,0,0,500,3,0,1.0
1850,8,1370,2.25,0,0,480,3,0,1.0
2730,7,2730,2.75,0,0,0,4,0,2.0
1530,7,1200,1.75,0,0,330,3,0,1.0
1120,7,1120,1.0,0,0,0,3,0,1.0
2140,8,2140,2.5,0,0,0,3,0,2.0
3360,10,3360,2.5,0,0,0,4,0,2.0
1570,7,1570,1.75,0,0,0,4,0,1.0
860,7,860,1.0,0,0,0,2,0,1.0
1060,6,1060,1.5,0,0,0,3,0,1.0
1010,6,750,1.0,0,0,260,4,0,1.0
3160,9,3160,2.5,0,3,0,3,0,2.0
3230,10,1640,3.5,1,1,1590,4,0,1.0
1890,8,1890,2.75,0,0,0,3,0,2.0
2190,7,1240,2.5,1,3,950,4,0,1.0
2370,9,2370,2.5,0,0,0,3,0,2.0
2130,8,2130,2.5,0,0,0,4,0,2.0
2750,9,1810,2.75,1,2,940,3,0,1.0
2700,8,2700,2.5,0,0,0,3,0,2.0
1560,7,1560,2.5,0,0,0,3,0,2.0
1590,7,1170,2.25,0,0,420,3,0,1.0
2420,7,2420,3.0,0,0,0,4,0,2.0
3250,9,3250,2.75,0,0,0,4,0,2.0
1620,7,920,1.0,0,0,700,2,0,1.0
5860,10,4910,4.25,0,0,950,4,0,2.0
1384,6,1384,1.0,0,0,0,3,0,1.0
2030,8,1610,1.75,0,0,420,4,0,1.0
2850,10,1820,3.25,0,3,1030,4,0,2.0
1460,8,1460,3.0,0,0,0,3,0,3.0
1520,7,1520,1.75,0,0,0,4,0,1.0
2490,8,2490,2.5,0,0,0,3,0,2.0
1580,7,1580,1.0,0,0,0,3,0,1.0
1720,8,1720,2.25,0,0,0,3,0,2.0
1620,7,1620,1.0,0,0,0,2,0,1.0
1810,7,1810,1.0,0,0,0,3,0,2.0
1540,8,1540,2.25,0,0,0,3,0,3.0
1860,8,1860,2.25,0,0,0,3,0,3.0
2740,7,1370,2.0,0,0,1370,5,0,1.0
2390,7,2390,2.5,0,0,0,3,0,2.0
1690,7,1690,2.5,0,0,0,3,0,2.0
2690,9,2690,2.5,0,0,0,4,0,2.0
1740,8,1740,2.25,0,0,0,3,0,2.0
2200,7,1130,1.5,0,0,1070,3,0,1.0
2270,8,1290,1.5,0,0,980,4,0,1.0
1740,5,1740,1.0,0,0,0,5,0,1.0
1700,7,1700,1.5,0,0,0,5,0,1.5
4610,8,2790,3.0,0,2,1820,3,0,2.0
2310,8,2310,2.5,0,0,0,4,0,2.0
2400,6,1200,2.0,0,0,1200,6,0,1.0
2600,7,1400,1.5,0,0,1200,3,0,1.0
2270,10,2270,2.5,0,0,0,3,0,1.0
1010,6,1010,1.0,1,0,0,3,0,1.0
750,7,750,1.0,0,0,0,2,0,1.0
1220,7,1220,1.0,0,0,0,3,0,1.0
2030,7,2030,2.0,0,0,0,4,0,2.0
2100,8,1440,1.75,0,0,660,3,0,1.0
3860,8,2660,3.5,0,3,1200,5,0,1.0
2320,8,1160,1.75,0,3,1160,4,0,1.0
1640,7,1090,1.0,0,0,550,3,0,1.0
1560,7,1040,1.5,0,0,520,3,0,1.0
2820,9,2820,2.5,0,0,0,4,0,2.0
2320,8,2320,2.5,0,0,0,3,0,1.0
3690,9,3690,3.25,0,0,0,5,0,2.0
2478,8,2478,2.5,0,0,0,4,0,2.0
1460,5,1460,1.0,0,0,0,4,0,1.5
1440,7,1440,1.0,0,0,0,4,0,1.5
3720,10,3720,3.5,0,3,0,4,0,2.0
1360,7,1360,1.5,1,0,0,3,0,1.0
2330,7,1390,2.0,0,0,940,3,0,1.0
1790,8,1790,2.5,0,0,0,3,0,2.0
2250,8,2250,2.5,1,0,0,4,0,2.0
1820,7,1220,2.5,0,0,600,3,0,1.0
2150,8,1850,1.0,0,3,300,4,0,2.0
1730,7,1730,2.5,0,0,0,3,0,2.0
1150,7,1150,1.5,0,0,0,3,0,1.0
3030,8,3030,2.5,0,0,0,4,0,2.0
820,6,820,1.0,0,0,0,2,0,1.0
1550,7,830,2.0,0,0,720,3,0,1.0
4750,11,4750,3.0,1,0,0,4,0,1.5
3500,10,3500,3.5,0,0,0,3,0,2.0
1530,7,1530,1.0,0,0,0,2,0,1.0
1150,6,800,1.0,0,0,350,3,0,1.0
1720,8,1720,2.25,0,0,0,4,0,1.0
1560,6,1560,2.0,0,0,0,3,0,1.0
1870,7,1870,2.5,0,0,0,3,0,2.0
2810,9,2810,2.5,0,0,0,4,0,2.0
1370,7,1370,1.5,1,0,0,2,0,2.0
1660,7,1080,1.5,0,0,580,3,0,1.0
1640,7,1640,2.25,0,0,0,3,0,2.0
1580,8,1160,2.25,0,0,420,4,0,1.0
4570,12,4570,2.5,0,0,0,3,0,2.0
1270,7,910,1.0,0,0,360,2,0,1.0
1170,8,1170,2.0,0,1,0,2,0,1.5
1240,7,1240,1.0,0,0,0,3,0,1.5
2710,10,2380,4.0,0,0,330,5,0,3.0
2010,8,1570,1.5,0,0,440,3,0,1.0
1450,6,1450,1.5,0,0,0,4,0,1.0
3920,9,2900,4.25,1,0,1020,5,0,2.0
1340,7,1340,1.0,0,0,0,3,0,1.0
1650,7,1650,2.25,0,0,0,3,0,2.0
1170,6,720,1.75,0,0,450,3,0,1.0
1090,6,1090,1.0,0,0,0,3,0,1.0
1390,7,1390,1.75,0,0,0,3,0,1.0
1570,7,1180,2.25,0,0,390,3,0,1.0
2990,9,2990,2.75,0,0,0,4,0,2.0
1130,7,1130,1.0,1,0,0,3,0,1.0
2500,8,2500,2.75,0,3,0,5,0,1.0
950,7,950,1.0,0,0,0,2,0,1.0
1870,8,1870,2.0,0,0,0,2,0,1.0
2250,8,2250,2.5,0,0,0,4,0,2.0
1880,8,1880,2.5,0,0,0,3,0,2.0
1580,7,1580,2.0,0,0,0,3,0,2.0
1610,7,1210,1.75,0,0,400,3,0,1.0
3130,9,3130,2.75,0,0,0,4,0,2.0
1900,8,1900,2.25,0,0,0,4,0,1.0
1760,8,1760,2.0,0,0,0,4,0,1.0
1450,7,1010,1.0,0,0,440,3,0,1.0
2849,10,2849,2.5,0,0,0,3,0,2.0
3060,9,3060,2.5,0,0,0,4,0,2.0
1470,7,1470,2.0,0,0,0,4,0,1.0
4660,9,3020,2.5,0,0,1640,4,0,2.0
3410,9,2470,3.25,0,0,940,4,0,2.0
950,6,810,1.0,0,0,140,2,0,1.0
2130,8,2130,2.5,0,0,0,4,0,2.0
1720,8,1720,1.75,0,0,0,4,0,1.0
1600,7,1600,2.0,0,0,0,5,0,1.5
2650,9,2250,1.75,1,0,400,3,0,2.0
2480,8,1870,2.75,0,0,610,3,0,1.5
2520,8,1680,2.25,0,2,840,4,0,1.0
1830,7,1200,2.25,0,0,630,4,0,1.0
1680,7,930,1.75,0,0,750,3,0,1.0
1050,6,780,1.0,0,0,270,2,0,1.0
3070,8,3070,2.5,0,0,0,5,0,2.0
1340,5,1340,1.0,0,0,0,3,0,1.5
1950,7,1400,2.75,0,0,550,4,0,1.0
2140,7,1070,2.25,0,0,1070,5,0,1.0
2210,7,1760,2.0,0,3,450,4,0,1.5
3370,9,3370,3.75,0,0,0,4,0,2.0
1220,7,1220,1.0,0,0,0,2,0,1.0
1980,7,1980,2.0,0,0,0,4,0,1.0
2440,9,1660,2.5,0,0,780,4,0,1.0
1678,7,1678,2.0,0,0,0,3,0,1.0
1690,7,1690,2.5,0,0,0,3,0,2.0
2460,9,1840,3.0,1,0,620,5,0,1.0
3550,9,3550,2.5,0,0,0,4,0,2.0
1680,8,1340,2.25,0,0,340,3,0,1.0
2660,8,2660,2.5,0,0,0,4,0,2.0
2050,8,2050,2.5,0,0,0,4,0,2.0
1500,8,1300,1.5,0,0,200,3,0,1.0
2150,8,2150,2.5,0,0,0,4,0,2.0
950,7,950,1.0,1,0,0,2,0,1.5
2242,8,2242,2.5,0,0,0,3,0,2.0
1240,7,1240,1.75,0,0,0,3,0,1.0
1160,7,1160,1.5,0,0,0,2,0,2.0
2400,9,2400,2.5,1,0,0,3,0,2.0
3080,7,1580,2.5,0,0,1500,6,0,1.0
2350,10,2350,2.5,0,0,0,4,0,1.0
1410,8,1410,1.75,0,0,0,3,0,3.0
2830,10,2830,2.5,0,0,0,3,0,3.0
1390,7,1390,1.0,0,0,0,4,0,1.0
2360,7,2360,2.0,0,0,0,5,0,1.0
2660,9,2660,2.5,0,0,0,3,0,2.0
1430,7,1010,1.0,0,0,420,2,0,1.0
1760,7,850,1.75,0,0,910,2,0,1.0
1890,7,1890,2.5,0,0,0,3,0,2.0
1350,6,1350,1.75,0,0,0,3,0,1.0
1080,6,1080,1.0,0,0,0,2,0,1.0
2050,9,2050,2.5,0,0,0,4,0,2.0
2780,10,2780,2.5,0,0,0,4,0,2.0
1520,7,1520,1.0,0,0,0,3,0,1.0
1580,9,1580,2.5,0,1,0,3,0,3.0
940,6,940,1.0,0,0,0,2,0,1.0
1050,7,1050,1.75,0,0,0,3,0,1.0
2010,7,2010,2.5,0,0,0,4,0,2.0
2810,10,2810,2.75,1,0,0,4,0,2.0
1410,8,1410,2.25,0,0,0,3,0,3.0
780,6,780,1.0,0,0,0,2,0,1.0
2610,8,2610,2.25,0,0,0,4,0,2.0
2320,8,2320,2.5,0,0,0,3,0,2.0
2990,10,2990,3.0,0,0,0,4,0,2.0
3100,9,3100,2.5,0,0,0,4,0,2.0
2590,10,2590,2.5,0,0,0,3,0,1.0
3480,8,3480,3.25,0,0,0,4,0,3.0
1150,7,1150,1.0,1,0,0,2,0,1.0
2160,7,1460,2.25,0,0,700,4,0,1.0
2230,8,1430,2.5,0,0,800,4,0,1.0
3540,10,3540,2.75,0,0,0,4,0,2.0
6160,11,4040,5.25,0,0,2120,6,0,2.0
2200,7,1100,2.0,0,0,1100,4,0,1.0
1060,6,1060,2.0,0,0,0,3,0,1.0
2120,7,2120,2.5,0,0,0,3,0,2.0
2253,7,2253,3.0,0,0,0,4,0,2.0
1489,7,1489,2.25,0,0,0,3,0,2.0
2020,8,2020,2.0,0,0,0,4,0,1.0
2520,7,1760,2.25,0,0,760,3,0,1.0
1370,7,1370,1.75,0,0,0,3,0,1.0
2590,9,2590,2.5,0,0,0,4,0,2.0
2110,8,1210,1.75,0,0,900,3,0,1.0
2200,8,2200,2.5,0,0,0,4,0,2.0
1650,7,1090,1.5,0,0,560,3,0,1.0
1370,6,1370,1.0,0,0,0,3,0,1.5
960,6,960,2.0,0,0,0,3,0,1.0
1220,7,920,1.0,0,0,300,2,0,1.0
2030,7,2030,2.5,0,0,0,3,0,2.0
1300,8,1300,1.0,1,0,0,2,0,1.0
1580,7,1180,2.25,0,0,400,3,0,1.0
1680,7,1680,1.75,0,0,0,3,0,1.0
1740,7,1740,2.5,0,0,0,3,0,2.0
2050,8,1450,1.75,0,3,600,4,0,1.0
920,7,920,1.0,0,0,0,2,0,1.0
1210,7,1210,1.0,0,0,0,3,0,1.5
2660,8,2660,2.5,0,0,0,4,0,2.0
2370,8,2370,2.5,0,0,0,4,0,2.0
4210,10,4210,3.75,0,3,0,5,0,2.0
5370,10,3500,3.0,0,0,1870,4,0,2.0
1650,7,1650,2.25,0,0,0,3,0,2.0
1930,7,1930,2.25,0,0,0,3,0,2.0
1040,7,1040,1.0,0,0,0,3,0,1.0
1280,5,1280,1.0,0,0,0,3,0,1.5
1610,7,1180,1.75,0,0,430,3,0,1.0
2800,8,2800,3.0,0,0,0,5,0,2.0
3130,9,2060,3.5,0,0,1070,4,0,2.0
1200,7,1200,1.0,0,0,0,2,0,1.0
3670,8,3670,2.5,0,0,0,5,0,1.5
1350,7,1350,1.0,0,0,0,4,0,1.0
1850,8,1850,2.5,0,0,0,3,0,2.0
2040,7,1020,1.75,0,2,1020,5,0,1.0
1050,6,1050,1.0,0,3,0,2,0,1.5
2120,8,1220,1.75,0,0,900,4,0,1.0
3230,8,2100,2.5,0,0,1130,3,0,1.0
1620,8,1620,2.5,0,0,0,2,0,2.0
1640,7,1090,2.0,0,0,550,3,0,1.0
2520,8,2520,2.75,0,0,0,4,0,2.0
1584,7,1584,2.5,0,0,0,3,0,2.0
1360,5,1360,1.0,0,0,0,3,0,1.0
2660,9,2660,2.5,0,2,0,4,0,2.0
1340,7,940,1.0,0,0,400,3,0,1.0
3140,8,2280,2.5,0,0,860,4,0,2.0
2350,9,2350,2.5,0,0,0,4,0,2.0
1180,8,1070,1.5,0,0,110,1,0,2.0
2110,7,2110,2.5,0,0,0,3,0,2.0
2350,7,1550,1.0,0,0,800,7,0,1.0
1740,8,1740,1.0,0,0,0,2,0,1.0
1900,8,1900,2.5,0,0,0,4,0,2.0
2770,10,2770,2.5,0,0,0,4,0,2.0
640,6,640,1.0,0,0,0,2,0,1.0
1950,8,1950,2.25,0,0,0,4,0,2.0
2450,7,2450,1.5,0,0,0,3,0,1.0
2120,7,2120,2.0,0,0,0,4,0,1.5
1680,7,1680,2.5,0,0,0,4,0,2.0
3170,8,2530,3.5,0,0,640,4,0,2.0
3930,9,2820,3.5,0,1,1110,4,0,2.0
1680,8,1680,2.0,0,0,0,2,0,1.0
1630,7,1330,1.75,0,0,300,3,0,1.0
1700,7,850,2.0,0,0,850,4,0,1.0
3620,10,2730,3.25,0,0,890,3,0,2.0
1420,8,1420,2.25,0,0,0,3,0,3.0
1850,7,1850,1.5,0,0,0,4,0,1.5
850,6,850,1.0,0,0,0,2,0,1.0
2100,8,2100,2.5,0,0,0,3,0,2.0
730,6,730,1.0,0,0,0,2,0,1.0
1290,7,1290,2.25,0,0,0,2,0,2.0
2630,8,2630,2.75,0,0,0,4,0,2.0
3730,9,3730,3.25,0,0,0,3,0,2.0
1210,6,1210,1.0,0,0,0,3,0,1.0
1730,7,1730,1.75,0,0,0,3,0,1.0
2360,7,2360,2.5,0,0,0,3,0,2.0
2510,9,2200,2.25,0,0,310,4,0,1.0
3000,7,1500,1.75,0,3,1500,4,0,1.0
1580,7,1580,1.75,0,0,0,4,0,2.0
1540,7,1540,1.75,0,0,0,3,0,1.0
2480,8,2480,2.5,0,0,0,3,0,2.0
1990,7,1990,2.5,0,0,0,3,0,2.0
2320,8,2320,2.5,0,0,0,4,0,2.0
3980,10,3980,3.75,0,0,0,4,0,2.0
4090,10,4090,2.5,0,0,0,4,0,2.0
2070,7,1670,2.0,0,0,400,3,0,1.5
2720,9,2720,3.0,1,0,0,4,0,1.0
1620,8,1620,1.5,0,2,0,3,0,1.0
1390,7,1140,3.0,0,0,250,3,0,2.0
1440,8,1440,1.75,1,0,0,4,0,1.0
2100,8,1470,2.25,0,4,630,3,0,1.0
3340,9,2120,3.0,1,2,1220,5,0,1.0
1850,7,1850,1.75,0,0,0,3,0,1.0
6880,12,4070,6.0,0,3,2810,5,0,2.0
2860,10,1920,2.25,0,4,940,3,0,1.0
1690,7,1690,2.25,0,0,0,3,0,2.0
1790,8,1790,2.5,0,0,0,3,0,2.0
890,7,890,1.0,0,0,0,1,0,1.5
2770,9,2770,2.5,0,0,0,4,0,2.0
2380,8,2380,2.5,0,0,0,4,0,2.0
4270,11,3400,4.5,1,0,870,5,0,2.0
2390,8,2390,1.75,1,0,0,4,0,1.0
2240,7,2240,1.75,0,0,0,4,0,1.5
4330,12,2090,3.5,1,4,2240,5,0,1.0
2510,8,2510,2.5,0,0,0,3,0,2.0
1400,7,1400,2.0,0,0,0,3,0,1.0
2210,7,1710,2.0,0,2,500,3,0,1.5
1180,7,1180,2.25,0,0,0,3,0,2.0
2690,10,2690,2.75,1,4,0,3,1,2.0
1590,9,1320,1.75,0,3,270,2,0,1.5
870,7,870,1.0,0,0,0,2,0,1.0
1750,7,1170,2.75,0,0,580,3,0,1.0
2400,8,1530,2.5,0,0,870,4,0,1.0
1540,7,1540,1.75,0,0,0,3,0,1.5
2030,8,2030,2.0,0,0,0,4,0,1.0
1410,7,940,2.25,0,0,470,3,0,1.0
2612,8,2612,2.5,0,0,0,4,0,2.0
1610,8,1610,2.25,0,0,0,3,0,2.0
4750,8,4750,3.25,0,0,0,6,0,2.0
2370,7,1280,1.75,0,3,1090,3,0,1.0
2600,8,1960,2.75,0,0,640,4,0,2.0
1790,7,1090,1.75,0,0,700,3,0,1.0
4110,7,4110,2.5,1,0,0,3,0,2.0
1780,6,1780,1.75,0,0,0,3,0,1.0
1340,7,1140,2.5,0,0,200,3,0,1.0
1250,8,1040,2.75,0,0,210,3,0,2.0
4120,12,4120,2.75,0,2,0,3,0,1.0
2280,7,1390,2.5,0,3,890,4,0,1.0
3870,8,2700,3.0,0,0,1170,6,0,2.0
1040,7,930,0.75,0,0,110,2,0,1.0
5180,12,3540,3.25,1,3,1640,4,0,2.0
2770,9,2770,2.5,0,0,0,4,0,2.0
2796,8,2796,3.5,0,0,0,4,0,2.5
1270,8,1270,2.0,0,0,0,3,0,3.0
1410,7,1290,2.25,0,0,120,3,0,2.0
1440,7,1440,1.0,0,0,0,4,0,1.0
2120,8,1540,1.75,0,2,580,3,0,1.0
1960,7,1220,2.5,0,0,740,4,0,1.0
3060,9,1810,2.75,0,0,1250,4,0,1.0
1440,8,1440,2.0,0,0,0,3,0,1.0
1460,7,1260,1.0,0,0,200,3,0,1.0
2820,9,2820,2.5,0,0,0,4,0,2.0
2630,9,2630,3.25,0,0,0,4,0,2.0
2303,8,2303,2.5,0,0,0,4,0,2.0
1600,8,1600,2.5,0,0,0,3,0,3.0
2720,10,2720,1.5,0,0,0,4,0,2.0
3350,9,2180,2.5,0,0,1170,3,0,1.0
1980,7,1980,1.5,0,0,0,4,0,1.0
1470,7,1470,1.5,0,0,0,3,0,1.0
1250,7,1250,1.0,0,0,0,3,0,1.5
3500,10,3500,3.5,1,0,0,4,0,2.0
2150,7,2150,2.5,0,0,0,4,0,2.0
1200,6,1200,1.0,0,0,0,3,0,1.0
1210,7,1210,2.0,0,0,0,3,0,1.0
3040,9,2680,3.0,0,0,360,4,0,1.5
2360,8,2360,3.25,0,0,0,4,0,2.0
2030,9,1730,1.75,0,4,300,4,0,2.0
1440,7,1440,1.75,0,0,0,3,0,1.0
2420,9,2420,2.5,0,0,0,3,0,2.0
2630,8,2630,2.0,1,0,0,4,0,2.0
2040,5,2040,2.0,0,0,0,6,0,1.0
1620,7,1620,2.0,0,0,0,4,0,1.5
1840,7,1040,2.0,0,0,800,3,0,1.0
2100,7,2100,2.0,0,0,0,4,0,1.0
1170,7,1170,1.75,0,0,0,3,0,1.0
1820,8,1820,2.5,0,0,0,3,0,2.0
1990,7,1140,1.0,0,0,850,3,0,1.0
980,6,980,1.0,0,0,0,3,0,1.5
1220,7,1220,1.75,0,0,0,3,0,1.0
2220,7,1370,2.0,0,0,850,4,0,1.5
1370,7,1370,1.5,0,0,0,4,0,1.5
1590,7,920,1.5,0,0,670,2,0,1.0
3910,9,3130,3.25,0,0,780,4,0,2.0
990,6,990,1.0,0,0,0,3,0,1.0
1320,7,1120,1.75,0,0,200,5,0,1.0
2880,10,2880,2.5,0,0,0,4,0,2.0
840,6,840,1.0,0,0,0,2,0,1.0
2110,7,2110,1.75,0,0,0,2,0,1.0
1350,7,1350,1.75,0,0,0,3,0,1.0
1680,7,1400,1.0,0,0,280,5,0,1.0
4420,10,3350,3.5,0,0,1070,4,0,2.0
1050,7,850,1.5,0,0,200,3,0,1.0
1460,7,1460,1.75,0,0,0,2,0,1.0
1984,7,1984,3.0,0,0,0,4,0,2.0
1520,7,1520,1.5,0,0,0,3,0,1.0
1200,6,1200,1.0,0,0,0,3,0,1.5
1070,7,1070,1.75,0,0,0,3,0,1.0
5050,11,3610,3.5,1,0,1440,4,0,2.0
2380,8,1610,1.75,0,0,770,4,0,1.0
1320,8,1320,1.5,0,0,0,2,0,1.0
1380,6,1380,1.0,0,0,0,3,0,1.0
2240,8,2240,2.25,0,0,0,3,0,1.0
1710,7,1410,1.0,0,0,300,3,0,1.0
1670,8,1670,2.0,0,0,0,3,0,1.5
2040,7,1020,2.0,0,0,1020,3,0,1.0
1370,6,1370,1.75,0,0,0,3,0,1.0
1900,7,1130,1.5,0,0,770,5,0,1.0
2430,7,1620,1.75,0,1,810,3,0,1.0
1380,7,1080,1.0,0,0,300,2,0,2.0
860,6,860,1.0,0,0,0,1,0,1.0
3250,9,2940,3.75,1,0,310,4,0,2.0
1870,6,1030,1.75,0,1,840,4,0,1.0
3800,8,3210,2.5,0,0,590,3,0,2.0
2450,9,2450,2.5,0,0,0,3,0,2.0
1340,7,1340,1.75,0,0,0,3,0,1.0
2910,8,1910,2.25,0,1,1000,5,0,1.0
2800,8,1730,2.0,0,0,1070,4,0,1.0
2730,9,1560,3.25,0,0,1170,4,0,1.0
3930,10,3310,3.5,0,0,620,4,0,2.0
3276,9,3276,3.25,0,0,0,4,0,2.0
4340,8,4340,6.0,1,0,0,8,0,2.0
1900,7,1150,2.0,0,0,750,2,0,1.0
1560,6,1560,1.0,0,0,0,4,0,1.5
3150,9,3150,3.0,0,0,0,4,0,2.0
3530,10,3530,3.0,0,0,0,3,0,2.0
1430,7,1430,1.0,0,0,0,3,0,1.5
5790,10,4430,3.25,1,3,1360,5,0,2.0
1220,7,1220,2.0,0,0,0,3,0,1.0
1490,7,1210,1.75,0,0,280,3,0,1.0
2910,9,1780,2.75,1,0,1130,5,0,1.0
1560,7,1260,1.0,0,0,300,3,0,1.5
1150,6,1030,1.75,0,0,120,3,0,1.0
1490,8,1220,3.25,0,0,270,3,0,3.0
2730,7,1460,2.25,0,0,1270,4,0,1.0
2020,7,2020,1.0,0,0,0,4,0,1.0
3260,8,3260,2.25,0,0,0,5,0,2.0
2950,7,1720,2.5,0,0,1230,5,0,1.5
2990,9,2990,2.5,0,0,0,4,0,2.0
1030,8,1030,1.0,0,0,0,2,0,1.0
3250,8,3250,2.75,0,0,0,5,0,2.0
1798,7,1798,1.75,0,0,0,5,0,1.0
2160,9,2160,2.25,0,4,0,2,1,2.0
2398,8,2398,2.5,0,0,0,4,0,2.0
2440,8,1440,2.75,0,0,1000,4,0,1.0
1960,7,1360,2.5,0,0,600,5,0,1.0
3480,9,3480,2.5,0,0,0,4,0,2.0
1030,7,1030,1.0,0,0,0,4,0,1.0
2760,7,1680,2.5,0,0,1080,4,0,1.5
2340,8,2340,2.5,0,0,0,4,0,2.0
2460,9,2460,2.5,0,0,0,4,0,2.0
1450,8,1180,3.25,0,0,270,3,0,2.0
1880,7,1380,1.75,0,0,500,3,0,1.0
2560,8,1280,2.0,1,0,1280,5,0,1.0
2340,7,2340,2.5,0,0,0,3,0,2.0
4230,9,3780,3.0,0,3,450,3,0,2.0
4070,10,4070,2.5,0,0,0,4,0,2.0
2270,8,2270,2.5,0,2,0,3,0,2.0
1700,7,1700,1.5,0,0,0,4,0,1.0
1780,7,1300,1.75,0,0,480,3,0,1.0
1430,7,1430,2.0,0,0,0,3,0,1.0
1320,7,1320,1.0,0,0,0,3,0,1.0
1610,7,1160,2.5,1,2,450,3,0,1.0
1290,7,1290,1.0,0,0,0,3,0,1.5
1140,7,1140,1.0,0,0,0,3,0,1.0
2280,9,1890,2.5,1,0,390,3,0,3.0
4100,11,2540,3.75,1,3,1560,4,0,1.5
2890,9,2890,2.5,0,2,0,5,0,2.0
1470,6,1470,2.0,0,0,0,3,0,2.0
2200,7,2060,2.5,0,0,140,4,0,2.0
2040,8,1490,3.0,0,0,550,4,0,1.0
3010,9,3010,3.5,0,0,0,4,0,2.0
1010,7,1010,1.0,0,0,0,3,0,1.0
2630,8,2630,2.75,0,0,0,4,0,2.0
3080,9,3080,2.5,0,0,0,4,0,2.0
1740,7,1290,1.75,0,0,450,3,0,1.0
2930,9,2670,2.25,0,2,260,3,0,3.0
3220,9,3220,2.5,0,0,0,4,0,2.0
1540,7,1490,1.5,0,0,50,3,0,1.5
2120,7,2120,1.5,0,0,0,4,0,2.0
1010,6,1010,1.75,0,0,0,3,0,1.0
1460,7,1460,1.75,0,0,0,3,0,1.0
3460,9,1780,2.75,1,4,1680,4,0,1.0
3880,7,3880,2.75,0,0,0,4,0,2.0
2190,7,1110,2.5,0,0,1080,4,0,1.0
1550,8,1550,2.0,0,0,0,3,0,1.0
1730,8,1730,2.0,0,0,0,3,0,1.0
2040,7,1180,2.5,0,0,860,4,0,1.5
2190,8,2190,1.75,0,2,0,3,0,1.5
1890,7,1090,1.5,0,0,800,3,0,1.0
1280,6,1280,1.5,0,0,0,3,0,2.0
2550,9,2550,2.25,0,2,0,4,0,2.0
1730,7,1030,1.0,0,0,700,3,0,1.0
1120,7,1120,1.0,0,0,0,3,0,1.0
1300,7,1060,1.75,0,0,240,3,0,2.0
1610,7,1610,2.5,0,0,0,4,0,2.0
1300,7,1300,1.0,0,0,0,3,0,1.5
1700,7,1120,2.0,0,0,580,3,0,1.0
1190,7,960,2.25,0,0,230,3,0,2.0
2040,8,2040,2.5,0,0,0,3,0,2.0
3290,7,1870,3.0,0,0,1420,5,0,1.0
1660,8,1660,2.5,0,0,0,5,0,1.5
1780,7,1780,2.25,0,0,0,3,0,2.0
880,6,500,0.5,0,0,380,1,0,1.0
1250,7,1250,1.0,0,0,0,3,0,1.0
1820,8,1820,2.5,0,0,0,3,0,2.0
1120,6,1120,1.0,0,1,0,2,0,1.0
3150,9,3150,3.0,0,0,0,4,0,2.0
2430,8,1900,2.25,0,0,530,3,0,1.5
1700,7,1700,1.75,0,0,0,3,0,1.0
1210,7,1210,1.0,0,0,0,3,0,1.0
1800,8,1800,1.75,0,0,0,3,0,1.0
1830,8,1830,2.5,0,0,0,4,0,2.0
1160,7,920,1.0,0,0,240,3,0,1.0
2100,8,2100,2.25,0,0,0,4,0,2.0
3710,8,2510,3.25,0,0,1200,5,0,2.0
2400,8,2400,2.5,0,0,0,4,0,2.0
1370,7,800,1.75,0,0,570,3,0,1.0
1840,8,1840,1.75,0,0,0,3,0,1.0
1880,7,1100,2.25,0,0,780,4,0,1.0
830,6,830,1.0,0,0,0,3,0,1.0
3680,9,3680,3.5,1,0,0,5,0,2.0
1260,7,1260,1.5,0,0,0,2,0,1.0
1460,7,1460,1.5,0,0,0,3,0,1.0
2510,7,2510,2.5,0,0,0,3,0,2.0
2605,8,1355,1.5,0,0,1250,3,0,1.0
1490,7,1490,2.5,0,0,0,3,0,2.0
3460,9,2560,3.0,0,0,900,3,0,2.0
1252,8,992,2.5,0,0,260,4,0,1.0
4130,10,4130,3.25,0,0,0,5,0,2.0
2820,10,2820,3.0,0,0,0,4,0,2.0
2510,10,2510,2.5,0,4,0,3,0,1.5
1540,7,1080,2.5,0,0,460,3,0,1.0
1934,8,1934,2.5,0,0,0,4,0,2.0
2420,8,1890,2.25,0,0,530,4,0,1.0
2380,8,2380,2.5,0,0,0,4,0,2.0
1000,7,900,1.0,0,0,100,3,0,1.0
1650,8,1650,1.75,0,0,0,3,0,1.0
3900,8,1950,2.25,0,3,1950,2,0,1.0
1450,7,980,2.25,0,0,470,3,0,2.0
1330,7,1330,1.75,0,0,0,3,0,1.0
2260,7,2260,2.25,0,0,0,3,0,2.0
2510,8,2510,2.5,0,0,0,3,0,2.0
1920,7,1920,1.75,0,0,0,4,0,1.0
2140,8,1770,2.5,0,0,370,3,0,2.0
1510,7,1220,1.75,0,0,290,3,0,1.0
1560,7,1360,2.5,0,0,200,3,0,1.5
2070,8,2070,2.5,0,0,0,3,0,2.0
970,6,970,1.0,0,0,0,3,0,1.0
1430,7,1430,2.5,0,0,0,3,0,3.0
4420,10,2740,4.0,0,0,1680,5,0,2.0
2040,8,2040,2.5,0,0,0,4,0,2.0
1150,6,1010,1.0,0,0,140,3,0,1.0
2780,9,2780,2.5,0,0,0,4,0,1.0
1480,7,1480,1.5,0,0,0,3,0,1.0
760,6,760,1.0,0,0,0,2,0,1.0
2330,8,1300,1.75,0,0,1030,4,0,2.0
1200,7,1200,1.0,0,0,0,4,0,1.5
1800,8,1230,2.25,0,0,570,3,0,1.0
1909,8,1766,2.5,0,0,143,3,0,3.0
3056,9,3056,2.5,0,0,0,4,0,2.0
1840,8,1840,1.5,0,0,0,4,0,2.0
720,4,720,0.75,0,0,0,2,0,1.0
3680,9,2840,3.25,0,0,840,4,0,2.0
2550,8,2550,2.5,0,0,0,4,0,2.0
1600,7,1600,2.0,0,0,0,3,0,1.0
3130,7,3130,2.5,0,0,0,4,0,2.0
3064,7,3064,0.0,0,2,0,0,0,3.5
3370,10,3370,2.5,0,0,0,4,0,2.0
3420,9,3420,2.75,0,0,0,4,0,2.0
1763,8,1763,2.25,0,0,0,4,0,2.0
2090,8,2090,2.5,0,0,0,3,0,2.0
1860,9,1860,2.0,0,0,0,3,0,1.0
1590,8,1060,2.5,0,0,530,3,0,2.0
2880,9,2880,2.5,0,0,0,4,0,2.0
1000,6,800,1.0,0,0,200,2,0,1.0
1690,7,1690,2.5,0,0,0,3,0,2.0
2310,7,1780,1.75,0,0,530,4,0,1.0
2550,9,2550,2.75,0,0,0,4,0,2.0
2470,8,1480,2.25,0,0,990,2,0,1.0
2038,8,2038,2.5,0,0,0,4,0,2.0
2520,9,1460,1.75,0,0,1060,3,0,1.0
1380,7,1380,2.0,0,0,0,3,0,2.0
1280,6,1280,1.0,0,0,0,2,0,1.0
930,6,930,1.0,0,0,0,2,0,1.0
1090,6,1090,1.0,0,0,0,3,0,1.0
2000,7,1010,1.75,0,0,990,4,0,1.0
1880,7,1030,2.0,0,0,850,3,0,1.0
1550,7,1550,2.25,0,0,0,3,0,2.0
1480,7,1190,2.25,0,0,290,3,0,1.0
3860,10,3120,3.5,0,0,740,4,0,2.0
1320,7,1320,2.25,0,0,0,2,0,3.0
2680,8,2680,2.5,0,0,0,4,0,2.0
1450,7,1450,1.0,0,0,0,3,0,1.5
3040,9,3040,2.5,0,0,0,3,0,2.0
3570,10,3570,2.5,0,0,0,4,0,2.0
3270,11,3270,2.5,1,0,0,4,0,2.0
1090,6,1090,1.0,0,0,0,3,0,1.0
2030,9,2030,2.5,0,0,0,3,0,1.0
1986,8,1746,3.0,0,2,240,4,0,2.0
3330,10,3330,2.75,1,0,0,4,0,2.0
1120,6,1120,1.0,0,0,0,3,0,1.0
3200,9,3200,2.75,0,0,0,3,0,2.0
1400,7,1300,2.25,0,0,100,4,0,1.0
1060,7,1060,1.5,0,0,0,3,0,1.0
2710,8,1690,2.75,0,0,1020,4,0,1.5
1810,7,1080,2.25,0,0,730,4,0,1.0
2160,8,1620,1.5,0,2,540,3,0,2.0
1570,7,1570,2.0,0,0,0,3,0,1.0
2050,7,2050,2.5,0,0,0,4,0,2.0
600,6,600,1.0,0,0,0,2,0,1.0
1680,7,1180,2.0,0,0,500,3,0,2.0
3010,9,3010,2.75,1,0,0,4,0,2.0
3440,8,3280,5.0,0,0,160,6,0,2.0
3000,9,3000,2.5,0,0,0,4,0,2.0
2270,7,1150,2.25,0,0,1120,4,0,1.0
1670,6,1670,1.0,0,0,0,4,0,1.5
3430,11,3430,2.75,0,4,0,4,0,1.0
1710,7,1330,1.75,0,0,380,2,0,2.0
1350,7,1350,2.0,0,0,0,4,0,3.0
2810,8,1680,3.25,0,0,1130,4,0,1.0
2250,7,1200,2.0,0,0,1050,4,0,1.0
2320,8,2320,3.0,0,2,0,4,0,2.0
1420,7,1420,2.5,0,0,0,2,0,2.0
1790,8,1790,3.0,0,0,0,4,0,1.5
1560,8,1080,2.5,0,0,480,2,0,2.0
1670,8,1670,2.5,0,0,0,3,0,2.0
1690,7,1690,2.5,0,0,0,3,0,1.0
2310,6,2310,2.75,0,0,0,7,0,1.5
1380,7,870,1.0,0,0,510,2,0,1.0
1240,6,1240,1.0,0,0,0,3,0,1.0
2000,8,1000,2.25,0,0,1000,3,0,1.0
3960,9,2690,3.25,0,0,1270,5,0,2.0
2540,7,2540,2.5,0,0,0,3,0,2.0
2300,7,2300,2.5,0,0,0,4,0,2.0
1640,8,1640,2.0,0,0,0,3,0,1.0
2470,7,1570,1.75,0,1,900,3,0,1.0
1820,8,1820,2.5,0,0,0,3,0,2.0
1080,7,1080,2.0,0,0,0,3,0,1.0
1445,7,1300,2.25,0,0,145,3,0,2.0
2770,8,2770,2.5,0,0,0,2,0,2.0
2720,9,2720,2.5,1,0,0,3,0,2.0
3880,10,3880,3.75,0,0,0,4,0,2.5
960,6,960,1.0,0,0,0,2,0,1.0
2360,8,2360,2.5,0,0,0,4,0,2.0
1450,7,1230,1.75,0,4,220,2,1,2.0
3140,10,3140,2.5,0,0,0,4,0,1.5
2040,7,1160,1.75,0,0,880,4,0,1.0
1520,8,1520,2.25,0,0,0,3,0,3.0
5280,11,3220,4.0,1,3,2060,4,0,2.0
2620,7,2620,2.5,0,0,0,4,0,2.0
4470,11,4470,2.25,0,0,0,4,0,2.0
1040,6,1040,1.0,1,0,0,2,0,1.0
3040,8,2280,4.0,0,0,760,5,0,2.0
3160,9,3160,3.25,0,2,0,4,0,2.0
1130,7,880,1.0,0,0,250,2,0,1.0
2340,7,2340,2.5,0,0,0,3,0,2.0
1920,7,1300,2.0,0,0,620,3,0,1.0
1330,7,1330,1.75,0,0,0,3,0,1.0
2200,7,2200,2.5,0,0,0,5,0,2.0
1360,8,1360,2.0,0,0,0,3,0,1.5
2810,9,2810,2.75,0,0,0,4,0,2.0
1330,7,1330,1.5,0,0,0,3,0,1.0
3520,9,3520,3.25,0,0,0,4,0,2.0
1570,8,1270,1.0,0,2,300,3,0,1.0
2090,9,1670,2.25,0,0,420,4,0,1.0
1450,7,1450,2.25,0,0,0,3,0,2.0
1660,7,1660,2.5,0,0,0,3,0,2.0
1690,8,1380,3.25,0,0,310,3,0,2.0
2420,9,2420,2.25,1,0,0,4,0,2.0
5550,12,3350,3.5,1,2,2200,4,0,2.0
4170,11,4170,3.5,0,0,0,4,0,2.0
1330,8,1330,2.5,0,0,0,3,0,3.0
2150,8,1610,1.0,0,0,540,3,0,1.0
1760,7,1180,1.75,0,2,580,4,0,1.0
890,6,890,1.0,0,0,0,2,0,1.0
2890,9,2890,2.5,0,0,0,4,0,2.0
2030,7,2030,2.5,0,0,0,3,0,2.0
2340,9,2340,2.25,1,0,0,4,0,1.0
1010,7,1010,1.5,0,0,0,1,0,1.0
2270,8,2270,2.5,0,0,0,3,0,2.0
1890,7,1890,2.25,0,0,0,4,0,2.0
800,6,800,1.0,0,0,0,4,0,1.0
2970,8,2020,2.5,0,0,950,4,0,1.0
2560,7,1370,2.5,0,0,1190,6,0,1.0
2220,6,1330,3.75,0,0,890,4,0,1.5
2250,8,2250,2.5,1,0,0,4,0,2.0
2030,7,2030,2.0,0,0,0,3,0,1.0
2430,8,1230,1.75,1,1,1200,3,0,1.0
2120,7,2120,2.5,0,0,0,3,0,2.0
1890,8,1520,2.25,0,0,370,3,0,1.0
2270,7,1470,2.5,0,0,800,6,0,1.0
1240,6,1240,1.0,0,0,0,3,0,1.0
1120,7,1120,1.0,1,0,0,3,0,1.0
2640,9,2640,2.75,0,0,0,4,0,2.0
2920,8,1660,2.75,0,0,1260,5,0,1.0
1570,7,1030,1.75,0,2,540,4,0,1.0
1810,7,1810,2.0,0,0,0,3,0,1.0
2150,8,2150,2.5,0,0,0,4,0,2.0
1290,7,1290,1.0,0,0,0,3,0,1.0
1520,7,820,1.75,0,0,700,3,0,1.0
910,6,910,1.75,0,0,0,2,0,1.0
2060,8,2060,2.5,0,0,0,4,0,2.0
1520,8,1520,1.75,0,0,0,3,0,1.0
2330,7,1220,1.75,0,2,1110,2,0,1.0
730,7,730,1.0,0,0,0,2,0,1.0
1310,6,1310,1.0,0,0,0,1,0,1.5
3130,7,1750,3.0,0,0,1380,4,0,1.5
1370,7,1230,1.0,0,0,140,3,0,1.0
2440,9,2440,2.5,0,0,0,4,0,2.0
1220,7,1220,1.75,0,0,0,3,0,1.0
2050,7,1460,1.75,1,0,590,3,0,1.0
2080,8,2080,4.0,0,4,0,3,0,3.0
3400,9,3400,2.5,0,0,0,4,0,2.0
5540,11,4280,4.25,1,1,1260,4,0,2.0
2000,8,2000,2.5,0,0,0,4,0,2.0
860,6,860,1.0,0,0,0,2,0,1.0
1770,7,1240,1.75,0,0,530,3,0,1.0
2220,9,2220,2.5,1,0,0,2,0,2.0
2250,8,2250,2.5,0,0,0,4,0,2.0
1480,6,760,1.0,0,0,720,3,0,1.0
1200,7,1200,1.5,0,0,0,1,0,1.5
1120,6,1120,1.0,0,0,0,4,0,1.0
1380,8,1380,3.25,0,0,0,3,0,3.0
950,7,950,1.5,0,0,0,2,0,1.0
1520,7,1140,1.75,0,0,380,3,0,1.0
3250,10,3250,3.0,0,3,0,3,0,2.0
5110,10,3850,3.5,0,0,1260,5,0,2.0
2310,8,1340,2.5,0,0,970,3,0,1.0
1590,8,1590,1.75,0,0,0,3,0,3.0
2910,9,2910,3.0,0,0,0,4,0,2.0
2090,7,1350,2.25,0,0,740,3,0,1.0
1400,7,1200,2.5,0,0,200,3,0,1.0
2370,8,2370,2.5,0,0,0,3,0,2.0
880,5,880,1.0,0,0,0,2,0,1.0
1980,8,1340,3.25,0,0,640,4,0,1.0
3660,9,2760,3.5,0,0,900,4,0,2.0
1350,8,1350,2.25,0,0,0,3,0,2.0
990,7,990,1.0,0,0,0,3,0,1.0
1920,7,1920,2.25,0,0,0,3,0,2.0
2670,9,2670,2.5,0,0,0,3,0,2.0
4320,10,3280,3.5,0,0,1040,4,0,2.0
1500,7,850,1.75,0,0,650,3,0,1.0
1920,7,1920,1.5,0,0,0,4,0,1.0
1460,7,1460,1.5,0,0,0,3,0,1.0
2100,8,2100,2.0,0,0,0,3,0,1.0
2340,8,1640,2.5,0,0,700,4,0,1.0
3150,9,3150,2.5,0,0,0,3,0,2.0
950,7,950,1.0,0,0,0,3,0,1.0
1310,7,1310,1.5,0,0,0,3,0,2.0
720,6,720,1.0,0,0,0,2,0,1.0
1670,7,1270,1.75,0,0,400,3,0,1.0
2100,6,1400,2.5,0,0,700,4,0,1.5
2170,8,2170,1.75,1,0,0,3,0,1.0
1800,8,1800,1.75,0,0,0,3,0,1.0
1380,7,1380,1.75,0,0,0,3,0,1.0
1910,7,1420,2.75,0,0,490,4,0,1.0
1410,7,1110,1.75,0,0,300,3,0,1.0
980,6,980,1.75,1,0,0,3,0,1.0
890,7,890,1.0,0,0,0,3,0,1.0
3190,9,3190,2.25,0,2,0,3,0,2.0
1140,8,1140,1.0,0,0,0,3,0,1.0
1130,7,1130,2.0,0,0,0,3,0,1.0
1600,8,1600,1.0,0,0,0,3,0,1.0
1720,7,1720,1.5,0,0,0,4,0,1.0
3680,9,3680,2.25,0,0,0,4,0,2.0
1520,7,830,1.0,0,0,690,2,0,1.0
2840,9,2840,2.5,0,0,0,4,0,2.0
1560,7,1560,2.0,0,0,0,3,0,2.0
1110,6,700,1.0,0,0,410,2,0,1.0
2500,7,1250,2.75,0,0,1250,5,0,1.0
1180,7,940,1.75,0,0,240,3,0,1.0
2610,7,1710,2.0,0,0,900,5,0,1.0
3170,8,3170,2.5,0,0,0,4,0,3.0
1550,8,1550,1.0,1,0,0,2,0,1.5
2303,8,2303,2.5,0,0,0,4,0,2.0
1430,7,1430,1.5,0,0,0,3,0,1.0
2080,8,1360,2.5,0,0,720,3,0,1.0
2770,9,2770,2.5,0,0,0,4,0,2.0
1520,5,1520,1.75,0,0,0,3,0,1.0
670,6,670,1.0,0,0,0,3,0,1.0
1680,7,1680,2.0,0,0,0,3,0,1.5
3430,9,3050,2.75,0,0,380,4,0,2.0
4930,11,4160,5.0,1,3,770,5,0,2.0
2180,8,2180,2.75,0,0,0,3,0,2.0
1260,7,1260,1.0,0,0,0,2,0,1.5
1230,7,1230,1.0,0,0,0,3,0,1.5
2230,7,2230,2.5,0,0,0,4,0,2.0
2420,8,2420,2.5,0,0,0,3,0,2.0
2890,8,2890,2.5,0,0,0,3,0,2.0
2150,8,2150,2.5,0,0,0,4,0,2.0
1390,7,1390,1.5,0,0,0,3,0,1.0
1380,8,880,1.0,0,0,500,2,0,1.0
670,5,670,1.0,0,0,0,2,0,1.0
2130,7,1330,2.25,0,0,800,4,0,1.0
1110,7,1110,1.75,1,0,0,3,0,1.0
1330,7,1330,1.75,0,0,0,2,0,1.0
1930,8,1930,1.75,0,0,0,2,0,1.0
1936,7,1936,2.0,0,0,0,3,0,2.0
2340,7,1170,1.75,0,0,1170,3,0,1.0
1240,8,1240,1.5,0,0,0,3,0,3.0
1060,7,1060,1.5,0,0,0,3,0,1.0
1710,7,1710,2.5,0,0,0,3,0,2.0
4168,10,3222,4.0,0,0,946,4,0,2.0
3087,8,3087,2.5,0,0,0,3,0,2.0
1260,7,1260,1.75,0,0,0,3,0,1.0
1320,6,1320,1.0,0,1,0,2,0,1.0
4390,11,2430,4.0,0,0,1960,4,0,1.0
2640,8,2640,2.5,0,0,0,4,0,2.0
1170,7,1170,1.0,0,0,0,2,0,1.0
720,6,720,1.0,0,0,0,2,0,1.0
2980,10,2980,2.5,0,0,0,4,0,2.0
1670,7,1370,1.75,0,0,300,3,0,1.0
1820,7,1420,3.0,0,0,400,4,0,1.0
1570,7,1040,1.75,0,0,530,3,0,1.0
1090,7,1090,1.0,0,0,0,2,0,1.0
1160,7,1160,2.5,0,0,0,4,0,1.0
2560,9,2560,2.5,0,0,0,4,0,2.0
2100,8,2100,2.25,0,0,0,3,0,2.0
2710,9,1430,1.75,1,0,1280,4,0,1.0
2030,7,1130,2.5,0,0,900,4,0,1.0
1250,7,1250,1.0,0,0,0,3,0,1.0
1640,8,1640,2.25,0,0,0,3,0,1.0
1450,7,1450,2.5,0,0,0,3,0,2.0
2150,8,2150,2.5,0,0,0,4,0,2.0
1400,7,1400,1.75,0,0,0,4,0,1.0
4250,10,3350,3.25,1,3,900,4,0,2.0
2500,9,2500,3.0,0,0,0,4,0,2.0
2060,6,1190,1.5,0,0,870,2,0,1.0
1600,7,1600,1.75,0,0,0,3,0,1.0
2210,8,1630,2.25,0,0,580,4,0,1.0
1050,6,1050,1.0,0,0,0,3,0,1.0
2630,8,2630,2.5,0,0,0,3,0,2.0
1520,6,1520,1.0,0,0,0,3,0,1.0
3080,9,3080,2.75,1,0,0,4,0,2.0
520,4,520,0.75,0,0,0,2,0,1.0
3200,9,3200,3.25,0,0,0,4,0,2.0
1570,7,1570,2.5,0,0,0,3,0,2.0
1070,7,1070,1.0,0,0,0,2,0,1.0
1240,6,790,1.5,0,0,450,3,0,1.0
2320,7,2320,2.5,0,0,0,4,0,2.0
2420,7,1550,2.5,0,2,870,4,0,1.5
4300,11,3580,3.5,1,1,720,4,0,2.0
1250,6,1250,1.0,0,0,0,3,0,1.0
2420,7,1620,2.5,0,2,800,5,0,1.0
910,7,910,1.0,0,0,0,2,0,1.0
1450,8,1160,2.25,0,0,290,3,0,2.0
1190,7,990,1.5,0,0,200,2,0,1.0
2660,7,2660,2.5,0,0,0,4,0,1.0
1530,8,1200,1.5,0,0,330,2,0,2.0
1310,7,940,1.0,0,0,370,2,0,1.0
3760,9,2550,3.25,1,0,1210,5,0,2.0
1910,7,1910,2.0,0,0,0,3,0,1.0
2220,7,2220,2.5,0,0,0,4,0,2.0
2050,7,1230,2.25,0,0,820,3,0,1.0
910,7,780,1.0,0,0,130,3,0,1.0
1360,7,1060,1.0,0,0,300,2,0,1.0
3500,11,3500,3.25,0,0,0,5,0,2.0
1250,7,980,2.0,0,0,270,2,0,2.0
1620,7,1620,1.75,0,0,0,3,0,1.0
2470,8,1860,3.0,0,0,610,3,0,2.0
2500,8,2500,2.5,0,0,0,4,0,2.0
2900,7,1950,4.0,0,0,950,5,0,2.0
2100,7,1500,1.75,0,0,600,4,0,1.5
2800,8,2800,3.0,0,0,0,4,0,2.0
2870,8,2870,2.5,0,0,0,4,0,2.0
1860,8,1710,3.0,0,0,150,3,0,2.0
2810,9,2810,2.5,0,0,0,3,0,2.0
2300,6,1220,1.0,0,0,1080,4,0,1.0
2260,8,1780,2.0,0,0,480,3,0,1.0
2963,9,2963,2.5,0,0,0,4,0,2.0
2180,7,1090,1.0,0,0,1090,2,0,1.0
1080,5,1080,1.0,0,0,0,4,0,1.5
2360,9,1920,2.5,0,0,440,4,0,1.0
4420,10,3410,4.0,0,0,1010,4,0,2.0
1460,7,1460,1.0,0,0,0,3,0,1.0
2230,7,1410,3.0,0,0,820,4,0,1.0
1740,7,990,1.75,0,0,750,2,0,1.0
900,6,900,1.0,0,0,0,2,0,1.0
2890,10,2150,2.75,1,0,740,5,0,1.0
1440,5,1440,2.0,0,0,0,4,0,1.0
1560,7,1560,1.0,1,0,0,3,0,1.0
1900,8,1370,2.25,0,0,530,4,0,1.0
3070,10,2110,2.25,1,0,960,3,0,2.0
1040,7,1040,1.0,0,0,0,3,0,1.0
2600,8,2600,3.5,1,0,0,3,0,2.0
1689,8,1689,3.25,0,0,0,3,0,3.0
1660,7,1660,2.25,0,0,0,3,0,2.0
2820,8,2820,3.25,0,0,0,4,0,2.0
3010,10,3010,2.75,0,2,0,3,0,2.0
1220,7,980,1.0,0,0,240,2,0,1.0
1360,6,910,2.0,0,0,450,3,0,1.5
1560,7,1560,2.0,0,0,0,4,0,1.5
3010,9,3010,3.0,0,0,0,5,0,2.0
1860,7,1080,1.75,0,0,780,4,0,1.0
1320,7,1320,2.0,0,0,0,3,0,1.0
1520,7,1170,1.75,0,0,350,3,0,1.0
1530,6,1530,1.75,0,0,0,4,0,1.5
1300,6,1300,1.0,0,0,0,3,0,1.0
2658,9,2658,2.5,0,0,0,4,0,2.0
1470,7,1470,1.5,0,0,0,3,0,2.0
1550,6,830,1.75,0,0,720,3,0,1.0
1860,7,1860,2.25,0,0,0,3,0,2.0
1580,7,1200,1.75,0,0,380,3,0,1.0
2870,8,1480,2.25,1,0,1390,4,0,1.0
1250,6,900,1.0,0,0,350,2,0,1.0
3340,9,2500,3.25,0,2,840,5,0,2.0
3320,8,3320,2.75,0,0,0,4,0,2.0
940,7,940,1.0,0,0,0,2,0,1.0
1110,7,1110,1.0,0,0,0,3,0,1.0
1280,6,1280,1.0,0,0,0,2,0,1.5
1450,7,1450,1.0,0,4,0,2,0,1.0
2790,7,1500,3.0,0,3,1290,5,0,1.0
970,7,970,2.0,0,0,0,3,0,1.0
1920,7,1300,2.25,0,0,620,4,0,1.5
3160,9,3160,3.5,0,0,0,5,0,2.0
2540,9,2540,2.5,0,0,0,3,0,2.0
2300,8,1420,2.5,0,0,880,4,0,1.0
2689,9,2689,2.5,0,0,0,4,0,2.0
1670,7,1670,1.5,0,0,0,2,0,1.0
2120,8,2120,1.75,0,0,0,4,0,2.0
2530,8,1350,2.0,1,0,1180,4,0,1.0
2450,9,2450,2.5,1,0,0,5,0,2.0
1740,7,1140,2.75,0,0,600,3,0,1.0
2375,9,2375,2.5,0,0,0,3,0,2.0
1820,8,1820,2.75,0,0,0,3,0,2.0
750,6,750,1.0,0,0,0,2,0,1.0
1250,7,1250,1.0,0,0,0,3,0,1.0
2340,7,2340,2.0,0,0,0,4,0,1.0
1260,7,960,1.0,0,2,300,3,0,1.0
1410,8,1370,2.25,0,0,40,3,0,2.0
1690,8,1380,1.75,0,0,310,3,0,2.0
1280,7,1280,1.0,0,0,0,5,0,1.5
4030,10,4030,2.75,0,0,0,4,0,2.0
1060,6,1060,1.0,0,0,0,2,0,1.0
1090,7,1090,1.5,0,0,0,3,0,1.0
1460,7,1460,2.0,0,0,0,3,0,2.0
2630,8,2630,2.5,0,0,0,4,0,2.0
2770,10,2770,2.5,1,0,0,4,0,2.0
3600,8,3600,3.5,0,0,0,3,0,2.0
1830,7,1830,2.0,1,0,0,4,0,1.0
3510,10,3510,2.5,0,0,0,4,0,2.0
840,6,840,1.0,0,0,0,2,0,1.0
2000,8,1480,1.0,0,0,520,3,0,1.0
1140,6,760,1.0,0,0,380,2,0,1.0
1280,7,850,1.0,0,0,430,2,0,1.0
2710,8,2710,2.75,0,0,0,5,0,2.0
3080,9,3080,2.25,1,0,0,4,0,2.0
2830,10,2830,2.75,0,0,0,4,0,2.0
1160,7,1160,2.0,0,0,0,3,0,1.0
1640,7,1110,1.75,0,0,530,3,0,1.0
1990,7,1990,1.0,0,0,0,3,0,1.0
2500,7,1800,2.25,0,0,700,4,0,1.0
2960,10,2960,2.5,0,4,0,4,0,2.0
1680,9,1120,2.5,0,0,560,3,0,2.0
2510,8,2510,2.25,1,0,0,4,0,2.0
2200,7,2200,2.5,0,0,0,3,0,2.0
2070,7,1420,1.75,0,0,650,3,0,1.0
1990,7,1190,1.75,0,0,800,4,0,1.5
1750,8,1750,2.25,0,0,0,3,0,3.0
1880,7,1880,1.75,0,0,0,3,0,1.0
1600,7,1600,1.5,0,0,0,3,0,1.0
2060,8,1120,2.0,0,0,940,3,0,1.0
1300,7,1300,1.75,0,0,0,3,0,1.0
1960,8,1960,2.5,0,0,0,3,0,2.0
3220,9,3220,2.75,0,0,0,5,0,2.0
1170,7,1170,1.75,0,0,0,3,0,1.0
1020,7,720,2.5,0,0,300,3,0,2.0
1470,6,1470,1.75,0,0,0,3,0,1.0
3070,8,2510,2.5,0,0,560,3,0,3.0
2440,8,2440,2.5,0,0,0,4,0,2.0
2520,8,1520,2.5,0,0,1000,4,0,1.0
2230,7,1730,3.0,0,0,500,5,0,2.0
1140,6,1140,1.0,0,0,0,2,0,1.5
998,7,798,2.25,0,0,200,3,0,2.0
910,7,910,1.0,0,0,0,3,0,1.0
3360,10,2770,2.25,1,0,590,3,0,2.0
1600,7,800,2.0,0,0,800,2,0,1.0
2070,8,1780,2.5,0,0,290,3,0,1.5
1700,7,1700,2.5,0,0,0,3,0,2.0
1480,6,1100,1.75,0,0,380,3,0,1.0
2300,8,2300,2.5,0,0,0,4,0,2.0
3560,7,1780,3.0,0,0,1780,6,0,1.0
1170,6,800,1.0,0,0,370,5,0,1.0
1940,8,1460,1.75,0,0,480,3,0,1.0
2300,8,1800,2.5,0,0,500,3,0,1.0
1930,7,1170,2.75,0,0,760,4,0,1.0
1240,8,1240,2.5,0,0,0,2,0,3.0
1690,7,1090,2.25,0,0,600,3,0,1.0
1340,7,1340,2.0,0,0,0,3,0,2.0
2380,6,1470,2.0,0,0,910,4,0,1.5
2650,8,2650,2.5,0,0,0,4,0,2.0
1230,7,1230,1.75,0,0,0,3,0,1.0
2010,7,1340,1.75,0,0,670,4,0,1.0
1140,7,850,2.25,0,0,290,3,0,2.0
4180,11,4180,3.5,1,0,0,5,0,2.0
2610,10,2610,2.5,0,0,0,4,0,2.0
2240,10,2240,2.25,1,0,0,4,0,2.0
2550,7,2550,2.5,0,0,0,3,0,2.0
2490,8,1610,2.5,1,0,880,5,0,1.0
1430,8,1430,3.25,0,0,0,3,0,3.0
1150,6,1060,1.0,0,0,90,2,0,1.0
2280,8,1520,2.5,0,0,760,4,0,2.0
2280,7,1280,1.75,0,0,1000,4,0,1.0
1790,8,1340,1.75,1,0,450,4,0,1.0
1320,7,1320,1.75,0,0,0,3,0,1.0
4350,10,2950,3.0,0,0,1400,5,0,2.0
1060,7,1060,1.5,0,2,0,3,0,1.0
2090,7,1200,2.5,0,0,890,4,0,1.0
2040,8,1610,2.5,0,0,430,4,0,1.0
2250,8,2250,1.75,0,1,0,3,0,1.0
1510,7,860,1.75,0,2,650,3,0,1.0
2330,7,1630,1.75,0,0,700,3,0,1.5
3870,11,2760,3.5,0,0,1110,3,0,2.0
2370,7,1280,1.75,0,0,1090,3,0,1.0
2340,9,2340,2.5,0,0,0,4,0,2.0
2470,8,1470,2.25,0,0,1000,4,0,1.0
1570,8,1570,2.25,0,0,0,3,0,2.0
3840,11,3840,2.5,0,0,0,5,0,2.0
3230,9,3230,2.25,0,0,0,3,0,2.0
1960,7,1170,3.0,0,0,790,4,0,1.0
2820,9,1820,2.5,0,2,1000,4,0,1.0
1330,7,930,0.75,0,0,400,2,0,1.0
2640,9,2640,3.0,0,0,0,3,0,2.0
1140,6,1140,1.0,0,0,0,3,0,1.0
2060,7,1580,1.5,0,2,480,4,0,1.5
1250,7,1250,1.75,0,0,0,3,0,1.0
1010,7,1010,1.0,0,0,0,2,0,1.0
1780,7,870,2.0,0,0,910,4,0,1.0
2540,9,2540,2.75,0,0,0,3,0,2.0
1020,7,1020,1.0,0,0,0,2,0,1.0
820,5,820,1.0,0,0,0,2,0,1.0
1760,7,1160,2.25,0,0,600,3,0,1.0
1340,7,1340,1.75,0,0,0,3,0,1.0
720,6,720,1.0,0,0,0,2,0,1.0
1090,7,1090,1.0,0,0,0,2,0,1.0
2030,8,2030,2.25,0,0,0,3,0,2.0
2350,7,2350,2.25,0,0,0,5,0,1.0
2920,9,2920,2.5,0,0,0,4,0,2.0
1700,7,850,2.0,0,0,850,3,0,1.0
1960,7,1960,2.25,0,0,0,3,0,1.0
3070,9,3070,2.5,1,0,0,4,0,2.0
1820,7,1820,2.5,0,0,0,3,0,2.0
1370,8,1180,3.5,0,0,190,3,0,2.0
5050,10,3260,4.0,0,0,1790,4,0,2.0
1750,5,1750,2.0,0,0,0,5,0,1.0
1110,7,1110,1.0,0,0,0,3,0,1.0
1880,8,1880,1.75,0,0,0,3,0,1.0
1850,7,1850,2.25,0,0,0,3,0,2.0
3680,10,1840,3.25,0,3,1840,4,0,1.0
1460,6,1460,2.0,1,2,0,2,0,1.0
1670,8,1220,2.25,0,0,450,3,0,2.0
2840,9,2840,2.5,0,0,0,4,0,2.0
1380,9,1160,2.5,0,0,220,3,0,2.0
900,6,900,1.0,0,0,0,3,0,1.0
1890,7,1890,2.0,0,0,0,4,0,2.0
1160,6,1160,1.0,0,0,0,3,0,1.0
3340,10,3340,2.5,0,0,0,4,0,2.0
1820,8,1430,3.5,0,0,390,3,0,2.0
2770,8,2770,2.25,0,0,0,4,0,2.0
1470,7,1470,2.0,0,0,0,3,0,1.0
3070,9,3070,3.0,0,0,0,4,0,2.0
1200,7,1200,1.0,1,0,0,3,0,1.0
2520,9,1550,2.25,1,0,970,3,0,2.0
1280,7,1080,2.25,0,0,200,2,0,2.0
1830,7,1080,1.5,0,0,750,4,0,1.0
2080,7,1040,2.0,0,0,1040,3,0,1.0
2680,8,1460,2.0,0,0,1220,4,0,1.0
1740,7,1740,2.5,0,0,0,3,0,2.0
4590,10,4590,4.5,1,0,0,5,0,2.0
2400,8,2400,2.25,0,0,0,4,0,2.0
4090,11,3590,2.5,0,2,500,3,0,2.0
870,7,870,1.0,0,0,0,2,0,1.0
4430,10,4430,2.75,0,0,0,4,0,2.0
2660,8,2660,2.5,0,0,0,4,0,2.0
1330,7,1330,1.75,1,0,0,3,0,1.0
1880,7,1880,1.75,0,0,0,4,0,1.5
1270,7,1270,1.0,0,0,0,3,0,1.0
2180,9,2180,2.5,0,0,0,3,0,2.0
1830,8,1200,1.0,0,0,630,3,0,1.0
1090,8,1090,1.75,0,0,0,3,0,1.5
1060,7,1060,1.75,0,0,0,3,0,1.0
2950,10,2210,3.25,0,0,740,4,0,2.0
3150,9,2250,2.75,0,0,900,4,0,1.0
1920,7,1920,2.5,0,0,0,3,0,2.0
2500,7,1460,3.0,0,0,1040,4,0,1.5
880,7,880,1.5,0,0,0,2,0,1.5
1890,7,1490,2.0,0,0,400,4,0,1.5
840,6,840,1.0,0,0,0,2,0,1.0
1100,6,1100,1.5,1,0,0,4,0,1.0
720,6,720,1.0,0,0,0,2,0,1.0
1800,7,1800,2.5,0,0,0,4,0,2.0
2040,8,2040,1.75,0,0,0,3,0,1.0
2140,9,2140,3.5,0,0,0,4,0,3.0
1850,7,1600,2.5,0,0,250,4,0,2.0
1430,7,1430,1.0,0,0,0,3,0,1.0
2740,9,2740,2.5,0,0,0,4,0,2.0
1460,8,1460,1.75,0,0,0,3,0,1.0
2250,9,2010,2.25,0,0,240,4,0,2.0
2370,7,2370,2.5,0,0,0,3,0,2.0
1540,7,1540,1.0,0,0,0,4,0,1.5
1230,7,1230,2.0,0,0,0,2,0,2.0
2160,8,2160,2.0,0,0,0,3,0,1.5
2090,7,1140,2.5,0,0,950,4,0,1.0
1100,6,1100,1.75,0,0,0,2,0,1.0
4250,11,2490,2.5,1,1,1760,5,0,1.0
1170,7,1170,2.0,0,0,0,3,0,1.5
1830,7,1830,2.5,0,0,0,4,0,2.0
1810,7,1810,2.25,0,0,0,4,0,2.0
2330,9,2330,2.5,0,0,0,4,0,2.0
2190,8,2190,2.75,0,0,0,4,0,2.0
960,8,920,1.5,0,0,40,2,0,2.0
3150,8,1640,2.5,0,0,1510,5,0,1.0
4230,10,4230,4.5,1,0,0,5,0,2.0
3110,8,3110,2.75,0,0,0,4,0,2.0
2180,8,1230,2.5,0,0,950,3,0,1.0
1390,8,1390,2.25,0,0,0,3,0,2.0
2500,7,1540,2.0,0,0,960,4,0,1.0
740,6,740,1.0,0,0,0,2,0,1.0
2420,8,1530,2.75,0,0,890,4,0,1.0
2440,8,1610,1.75,0,0,830,4,0,1.0
1520,6,1520,1.0,1,0,0,3,0,1.0
1610,8,1090,1.75,1,0,520,3,0,1.0
1210,7,1210,1.0,0,0,0,3,0,1.5
1290,7,1290,1.0,0,0,0,2,0,2.0
1290,7,1290,1.0,0,0,0,3,0,1.0
830,6,830,1.0,0,0,0,2,0,1.0
3370,10,3370,3.0,0,0,0,4,0,2.0
1590,6,1590,2.0,0,0,0,3,0,2.0
2080,9,2080,2.5,0,0,0,3,0,2.0
2680,7,2680,2.25,0,0,0,4,0,2.0
1670,7,1670,2.5,0,0,0,3,0,2.0
1530,7,1530,1.0,0,0,0,4,0,1.5
2330,8,2330,2.25,0,0,0,4,0,1.0
2280,7,1140,2.0,0,0,1140,4,0,1.0
840,7,840,1.0,0,0,0,2,0,1.0
1040,7,1040,1.0,0,0,0,3,0,1.0
2080,8,2080,1.75,0,0,0,3,0,1.0
1320,8,990,2.5,0,0,330,2,0,2.0
1910,8,1910,2.5,0,0,0,3,0,1.5
1040,7,1040,1.0,0,0,0,3,0,1.0
1960,7,1960,2.5,0,0,0,4,0,2.0
1880,8,1420,2.25,0,0,460,3,0,1.0
1770,8,1770,2.5,0,0,0,3,0,2.0
1750,8,1270,2.25,0,0,480,3,0,1.0
1650,7,1650,2.5,0,0,0,3,0,2.0
1310,6,1110,1.5,0,0,200,5,0,1.5
1420,7,1130,2.25,0,0,290,3,0,1.0
1470,7,1470,2.25,0,0,0,3,0,2.0
1180,10,780,1.75,0,0,400,2,0,2.0
1090,7,1090,1.0,0,0,0,3,0,1.0
4110,11,4110,5.0,0,0,0,4,0,2.0
2110,7,1210,1.5,0,0,900,3,0,1.0
1260,7,1260,1.0,0,0,0,4,0,1.0
2380,8,1310,2.0,0,2,1070,4,0,1.0
1440,7,1440,2.25,0,0,0,3,0,3.0
1710,7,1030,2.0,1,0,680,3,0,1.0
3400,9,3400,2.5,0,0,0,3,0,2.0
1650,6,1650,2.0,0,0,0,2,0,1.0
2440,7,1200,2.75,0,0,1240,4,0,1.0
1210,7,1210,1.0,0,0,0,3,0,1.0
1540,8,1540,2.25,0,0,0,3,0,3.0
2790,9,2790,2.5,0,0,0,4,0,2.0
2300,8,2300,2.5,0,0,0,4,0,2.0
1060,7,1060,1.0,0,0,0,3,0,1.0
1400,7,1400,1.5,0,0,0,3,0,1.0
900,6,900,1.0,0,0,0,2,0,1.0
1610,7,1610,2.25,0,0,0,3,0,2.0
1950,8,1950,2.25,0,0,0,3,0,1.0
1580,7,1290,1.5,0,0,290,4,0,1.5
1290,7,1290,1.0,0,0,0,2,0,2.0
1720,7,1460,1.75,0,0,260,4,0,1.5
690,7,690,1.5,0,0,0,2,0,2.0
2040,10,2040,1.75,0,2,0,3,0,1.0
1610,8,1610,1.75,0,0,0,3,0,1.0
3370,9,3370,2.5,0,0,0,3,0,2.0
2060,8,2060,2.25,0,0,0,4,0,2.0
2360,7,1460,2.5,0,0,900,4,0,1.0
1980,7,1140,1.75,0,0,840,3,0,1.5
1710,9,1440,2.5,1,0,270,4,0,1.0
2370,9,2370,2.5,0,0,0,3,0,2.0
1960,7,980,1.75,0,0,980,3,0,1.0
760,6,760,1.5,0,0,0,3,0,1.0
1650,7,1650,2.25,0,0,0,3,0,1.5
2770,8,2770,3.5,1,0,0,4,0,2.0
1900,7,1400,2.25,0,0,500,4,0,1.0
1830,8,1830,2.75,0,0,0,3,0,2.0
2040,9,2040,1.75,0,0,0,4,0,2.0
1560,6,770,1.75,0,0,790,3,0,1.0
1200,7,1200,2.0,0,0,0,4,0,1.0
1300,6,1300,1.0,0,0,0,2,0,1.5
1950,7,1950,2.5,0,0,0,3,0,2.0
2200,7,1300,2.25,1,0,900,4,0,1.5
1810,8,1810,2.5,0,0,0,3,0,2.0
2090,7,2090,2.0,0,0,0,4,0,1.0
1300,7,1300,2.0,0,0,0,3,0,1.0
2200,8,2200,2.25,0,0,0,3,0,2.0
2230,7,2230,2.5,0,0,0,4,0,2.0
2150,7,1090,2.25,0,0,1060,4,0,1.0
1010,6,1010,1.0,0,0,0,2,0,1.5
3040,8,3040,2.5,0,0,0,4,0,2.0
1940,8,1940,2.0,1,0,0,4,0,1.0
1500,7,1500,2.25,0,0,0,3,0,2.0
1350,8,1350,1.75,0,0,0,3,0,1.0
2570,7,2570,2.5,0,0,0,4,0,2.0
1670,9,1670,2.0,0,0,0,2,0,1.0
1800,7,1080,2.5,0,0,720,4,0,1.0
1370,8,1370,2.5,0,0,0,3,0,1.0
1200,6,1200,1.0,0,0,0,2,0,1.0
3010,9,3010,2.5,0,0,0,4,0,2.0
1090,7,850,1.75,0,0,240,3,0,1.0
2120,9,2120,2.5,0,0,0,3,0,2.0
1200,7,1200,2.25,0,0,0,2,0,3.0
3380,8,2330,3.0,0,1,1050,4,0,1.0
2530,9,2530,2.25,0,0,0,3,0,2.0
1800,7,1320,2.75,1,0,480,3,0,1.0
1860,8,1260,2.0,0,0,600,2,0,1.0
1100,7,780,2.75,0,0,320,3,0,2.0
3900,8,2870,4.5,0,0,1030,6,0,2.0
3770,9,1940,4.0,0,0,1830,4,0,1.0
2400,7,1200,3.0,0,0,1200,4,0,1.0
1650,7,1650,2.0,0,0,0,3,0,1.0
5067,9,3154,2.5,0,2,1913,5,0,1.0
1560,7,1260,2.25,0,0,300,3,0,1.0
1140,7,850,1.0,0,0,290,2,0,1.0
1680,8,1150,1.75,0,0,530,3,0,1.0
1320,7,1320,1.0,0,0,0,3,0,1.0
1090,6,1090,1.0,0,0,0,3,0,1.0
1300,7,900,1.5,0,0,400,3,0,1.0
960,5,960,1.0,0,0,0,2,0,1.0
1330,6,850,1.0,0,0,480,2,0,1.0
2020,7,2020,2.5,0,0,0,4,0,2.0
1200,6,1200,1.0,0,0,0,3,0,1.0
2500,8,2500,2.75,0,0,0,4,0,2.0
1360,8,1360,1.5,0,0,0,3,0,3.0
1380,7,1080,1.5,0,0,300,4,0,1.0
2060,7,1560,2.5,0,0,500,4,0,2.0
1030,7,1030,1.0,0,0,0,2,0,1.0
3390,8,1740,2.75,0,3,1650,3,0,1.0
1900,8,1390,2.25,0,0,510,3,0,1.0
2620,9,2620,2.5,1,0,0,3,0,2.0
1880,7,1880,2.5,0,0,0,4,0,2.0
2670,8,2670,2.5,0,0,0,4,0,2.0
1220,7,1220,1.5,0,0,0,4,0,1.0
1520,7,1520,1.0,0,0,0,3,0,1.0
920,6,920,1.0,0,0,0,3,0,1.0
3400,9,3400,2.5,0,0,0,4,0,2.0
1970,7,1970,2.5,0,0,0,3,0,2.0
1300,7,1300,1.0,0,0,0,3,0,1.0
2240,8,2240,2.0,1,0,0,4,0,1.0
740,6,740,1.0,0,0,0,2,0,1.0
2450,9,2450,2.75,0,0,0,4,0,2.0
1540,7,1540,1.75,0,0,0,3,0,1.0
3740,11,3740,3.5,0,2,0,4,0,2.0
1260,6,1260,2.0,0,0,0,4,0,1.0
2820,7,1450,2.75,0,0,1370,5,0,1.0
860,6,860,1.0,0,0,0,3,0,1.0
2720,7,2720,2.5,0,0,0,3,0,2.0
990,6,990,1.0,0,0,0,3,0,1.0
2460,8,2460,2.5,0,0,0,5,0,2.0
1220,7,790,2.25,0,0,430,3,0,1.0
1180,7,1180,1.0,0,0,0,3,0,1.0
2560,7,2560,1.75,0,0,0,4,0,2.0
1850,7,1850,2.5,0,0,0,4,0,2.0
2560,8,1330,2.0,0,0,1230,3,0,1.0
810,7,810,1.0,0,0,0,2,0,1.0
1530,7,1530,1.0,1,0,0,2,0,1.5
1000,7,840,1.5,0,0,160,2,0,2.0
3860,11,2940,4.5,1,4,920,4,0,2.0
1420,8,1420,2.25,0,0,0,3,0,3.0
2460,8,2460,2.5,0,0,0,4,0,2.0
2010,8,1390,2.5,0,0,620,3,0,2.0
780,5,780,1.0,0,0,0,2,0,1.0
2660,8,1330,2.75,0,4,1330,3,0,1.0
1210,6,1210,1.0,0,0,0,3,0,1.0
3110,9,3110,2.5,0,2,0,3,0,2.0
2120,6,1130,1.75,0,0,990,2,0,1.0
1200,7,1200,1.0,0,0,0,3,0,1.0
3030,8,3030,2.75,0,0,0,4,0,2.0
1900,8,1900,2.5,1,0,0,3,0,2.0
1040,7,1040,1.0,0,0,0,3,0,1.5
1270,8,1060,2.25,0,0,210,3,0,2.0
2820,7,1720,2.25,0,0,1100,3,0,1.0
1140,6,1140,1.0,0,0,0,2,0,1.0
840,6,840,1.0,0,0,0,2,0,1.0
2610,8,2610,2.5,0,0,0,4,0,2.0
2070,7,2070,2.5,0,0,0,4,0,2.0
1020,7,920,1.5,0,0,100,3,0,1.0
1690,7,1690,2.0,0,0,0,3,0,1.0
1220,7,1220,2.0,0,0,0,4,0,1.5
1380,7,980,1.0,0,0,400,3,0,1.0
2340,8,2340,1.75,1,0,0,3,0,1.5
1390,8,1390,2.0,0,0,0,3,0,1.0
2210,8,1440,2.5,1,0,770,2,0,2.0
3020,8,1710,2.5,0,0,1310,4,0,1.0
2420,8,1480,1.75,0,0,940,4,0,1.0
1440,7,1440,2.0,0,0,0,2,0,2.0
3670,9,2870,3.5,0,0,800,4,0,2.0
2580,7,2130,3.0,0,0,450,4,0,2.0
1030,7,920,1.0,0,0,110,2,0,1.0
3240,7,3240,2.5,0,0,0,3,0,2.0
1780,7,1780,2.25,0,0,0,3,0,2.0
2230,8,1180,1.75,0,4,1050,4,0,1.0
2210,8,1710,2.25,0,0,500,4,0,1.0
2010,8,2010,2.5,0,0,0,3,0,2.0
2140,8,1320,2.5,1,0,820,3,0,1.0
1010,6,1010,1.0,0,0,0,3,0,1.0
1820,8,1820,1.75,0,0,0,3,0,1.0
998,7,798,2.25,0,0,200,3,0,2.0
1090,7,1090,1.5,0,0,0,3,0,1.0
1940,8,1440,2.25,0,0,500,3,0,1.0
1120,7,1120,1.0,0,0,0,3,0,1.0
3040,9,1940,2.25,0,0,1100,4,0,1.0
1900,7,1640,1.5,0,0,260,3,0,1.5
2630,8,2630,2.5,0,0,0,4,0,2.0
3830,11,2370,2.5,0,4,1460,4,1,1.0
1690,8,1690,2.5,0,0,0,3,0,2.0
1450,8,1100,3.25,0,0,350,3,0,2.0
1480,6,740,2.0,0,0,740,4,0,1.0
1540,7,1540,2.0,0,0,0,4,0,1.5
2610,9,2610,2.25,0,0,0,3,0,2.0
1530,8,1280,2.25,0,0,250,2,0,2.0
1880,7,1880,2.5,0,0,0,3,0,2.0
560,4,560,1.0,0,0,0,1,0,1.0
930,7,930,1.0,0,0,0,2,0,1.0
2690,8,1750,2.75,0,0,940,4,0,1.0
820,5,820,1.0,0,0,0,2,0,1.0
3320,10,3320,2.5,1,3,0,4,0,2.0
1710,8,1030,2.0,0,0,680,4,0,1.0
1890,8,1890,2.25,0,0,0,4,0,1.0
1730,8,1730,3.0,0,0,0,3,0,3.0
2200,9,1760,2.25,1,0,440,2,0,2.0
1900,7,1200,1.5,0,0,700,3,0,1.0
900,6,900,0.75,0,0,0,2,0,1.0
1450,8,1450,1.75,0,0,0,3,0,1.0
3760,9,3230,2.5,0,0,530,3,0,2.0
1120,7,820,1.0,0,0,300,3,0,1.0
2540,8,1500,1.5,0,0,1040,3,0,1.0
1360,6,760,1.0,0,0,600,3,0,1.5
1580,8,1580,2.25,0,0,0,3,0,2.0
2550,8,2550,2.25,0,0,0,4,0,1.0
1010,7,860,1.5,0,0,150,2,0,2.0
1410,8,1410,1.75,0,0,0,3,0,2.0
1900,7,1900,2.5,0,0,0,4,0,1.0
1220,6,880,1.0,0,0,340,2,0,1.0
3760,9,2860,3.5,0,0,900,4,0,2.0
2660,9,2210,2.0,0,0,450,3,0,1.0
1830,7,1010,1.75,1,0,820,4,0,1.0
2740,9,2740,2.5,0,0,0,4,0,2.0
2410,8,2410,2.25,1,0,0,5,0,2.0
2500,8,2500,2.5,0,0,0,4,0,2.0
2040,7,2040,1.75,0,3,0,2,1,1.5
1160,7,1160,1.0,0,0,0,1,0,2.0
1620,7,1620,2.5,0,0,0,4,0,2.0
3310,9,3310,2.5,0,0,0,4,0,2.0
2570,8,2570,2.25,0,0,0,3,0,2.0
1150,7,1150,1.0,0,0,0,2,0,1.0
1360,7,1360,1.0,0,0,0,4,0,1.5
1610,7,1280,2.5,0,0,330,3,0,2.0
2880,8,2050,2.5,0,4,830,4,0,2.0
1590,9,1590,2.5,1,0,0,2,0,2.0
2000,7,1280,2.0,1,2,720,5,0,1.5
1250,6,1250,1.5,0,0,0,3,0,1.0
2480,7,1560,3.0,0,0,920,5,0,1.0
1530,8,1530,1.75,0,0,0,3,0,1.0
1820,7,1450,2.25,0,0,370,3,0,1.0
770,5,770,1.0,0,0,0,2,0,1.0
1260,6,1100,1.0,0,0,160,2,0,1.0
1920,8,1260,1.75,1,0,660,3,0,1.0
1670,8,1670,1.5,0,3,0,3,0,2.0
700,6,700,1.0,0,0,0,2,0,1.0
2490,7,1490,2.5,0,0,1000,5,0,1.0
2440,8,1710,3.25,0,0,730,3,0,2.0
2860,8,1980,2.5,0,2,880,3,0,2.0
3130,10,3130,2.5,1,0,0,4,0,2.0
1220,6,1220,1.0,0,0,0,4,0,1.5
2360,7,1460,3.0,0,2,900,4,0,1.0
960,7,960,1.0,0,0,0,3,0,1.0
3940,9,2140,2.75,1,4,1800,3,0,1.0
1260,7,1260,1.0,0,0,0,3,0,1.0
900,7,900,1.0,0,0,0,3,0,1.5
2040,8,2040,2.5,0,0,0,3,0,2.0
1990,7,1990,2.5,0,0,0,4,0,2.0
1500,7,1000,1.0,0,0,500,3,0,1.0
890,6,890,1.0,0,0,0,2,0,1.0
1400,7,1400,1.0,0,0,0,4,0,1.5
1900,8,1560,3.5,0,0,340,3,0,2.0
2640,8,1960,3.25,1,2,680,3,0,1.0
3732,10,2932,4.5,1,0,800,5,0,2.5
1220,6,1220,1.0,0,4,0,1,0,1.0
1800,7,1800,1.5,0,0,0,4,0,1.0
1190,7,1190,1.0,0,0,0,3,0,1.0
1470,7,1470,1.75,0,0,0,3,0,1.0
2200,7,1120,2.75,0,0,1080,4,0,1.0
3690,9,2540,3.5,0,0,1150,5,0,2.0
3000,8,3000,2.75,0,0,0,4,0,2.0
2632,8,2632,2.5,0,0,0,4,0,2.0
1490,7,1060,1.75,0,0,430,3,0,1.0
1520,6,800,2.0,0,0,720,3,0,1.0
1820,7,910,1.75,0,0,910,2,0,1.0
1310,7,960,1.0,0,0,350,3,0,1.0
3150,9,3150,4.0,0,0,0,7,0,1.0
3810,10,3810,2.5,0,0,0,4,0,2.0
1080,7,1080,1.0,0,0,0,3,0,1.0
1390,7,1390,2.0,0,0,0,3,0,1.0
2240,8,2240,2.25,0,0,0,4,0,2.0
1070,7,1070,1.0,0,0,0,2,0,1.0
2430,8,2020,2.5,0,0,410,4,0,2.0
1790,7,1790,1.5,1,0,0,3,0,1.0
2790,7,2790,2.75,0,0,0,5,0,1.5
2300,6,1340,2.75,0,0,960,4,0,1.5
2700,8,1750,2.5,0,0,950,5,0,1.0
900,7,900,1.0,0,0,0,2,0,1.0
3720,10,2880,3.5,1,0,840,4,0,2.0
1710,8,1710,2.25,0,0,0,3,0,2.0
2620,7,1330,1.75,0,0,1290,3,0,1.0
1970,8,1170,2.75,0,0,800,4,0,1.0
2410,9,1600,2.5,0,2,810,3,0,1.0
1670,9,1350,2.75,0,0,320,3,0,3.0
890,7,890,1.0,0,0,0,2,0,1.0
1860,7,1220,2.5,0,0,640,4,0,1.0
1150,7,1050,1.0,0,0,100,2,0,1.0
1480,7,1480,1.75,0,0,0,3,0,1.0
1960,8,1960,1.75,0,0,0,4,0,1.0
1480,8,1480,1.75,0,0,0,3,0,1.0
1200,6,1200,1.0,0,0,0,3,0,1.0
1050,7,1050,1.5,0,0,0,2,0,2.0
1820,8,1820,2.5,0,0,0,3,0,2.0
1090,8,1090,1.0,0,0,0,3,0,1.5
1420,7,1420,1.75,0,0,0,3,0,1.0
2110,8,1590,2.5,0,0,520,2,0,1.0
1770,8,1770,1.75,0,0,0,3,0,1.0
1850,7,1850,1.75,0,0,0,4,0,1.5
1650,7,1650,2.0,0,0,0,4,0,2.0
2050,7,1070,1.75,0,0,980,3,0,1.0
1990,7,1100,1.75,0,0,890,3,0,1.0
2860,8,1510,1.75,0,4,1350,2,1,1.0
3020,7,3020,2.5,0,0,0,3,0,2.0
2080,7,2080,1.5,0,0,0,4,0,1.5
2730,8,1470,3.0,0,0,1260,5,0,1.0
2990,9,2210,2.5,0,0,780,4,0,2.0
1820,8,1540,3.0,0,0,280,3,0,3.0
3240,8,3240,2.5,0,0,0,4,0,2.0
1270,7,1270,1.0,0,0,0,3,0,1.5
1660,7,1100,1.75,0,0,560,3,0,1.0
1820,7,1340,1.75,0,0,480,3,0,1.0
2910,9,2910,2.25,1,0,0,5,0,2.0
1785,7,1595,2.5,1,0,190,2,0,2.0
2820,9,1780,2.5,0,3,1040,3,0,1.0
2550,10,1720,2.25,0,0,830,2,0,1.0
3820,10,3820,2.75,1,0,0,4,0,2.0
1850,7,1100,1.75,0,0,750,4,0,1.0
2490,9,2490,2.5,0,0,0,3,0,2.0
1650,8,1650,2.5,0,0,0,3,0,3.0
1690,8,1690,1.5,0,0,0,4,0,1.5
2010,8,2010,2.5,0,0,0,3,0,2.0
3110,7,1810,3.0,0,0,1300,6,0,1.5
2920,8,2140,3.0,0,0,780,5,0,2.0
2040,8,1540,1.75,0,0,500,3,0,1.5
1430,7,1430,1.75,0,0,0,4,0,2.0
1810,7,1240,2.25,0,0,570,3,0,1.0
1820,7,1320,2.25,0,0,500,4,0,1.5
2730,8,2730,2.25,0,0,0,4,0,2.0
4170,9,3500,3.5,0,0,670,4,0,2.0
1860,8,1860,1.75,0,2,0,3,0,2.0
2970,8,2260,3.5,0,0,710,4,0,2.0
800,6,800,1.0,0,0,0,2,0,1.0
1880,6,980,2.0,0,0,900,4,0,1.0
2650,9,2060,3.5,0,0,590,4,0,2.0
1320,6,1320,1.0,0,0,0,2,0,1.0
4040,11,4040,3.5,0,0,0,4,0,2.0
2093,7,2093,2.5,0,0,0,5,0,1.5
1830,7,1830,1.0,0,0,0,3,0,1.0
3070,8,2740,2.25,0,0,330,4,0,2.0
1600,8,1600,2.5,0,0,0,3,0,2.0
1870,7,1480,1.75,0,0,390,4,0,1.0
1430,7,1430,1.0,0,0,0,4,0,1.5
1830,7,1030,1.5,0,2,800,5,0,1.0
3410,10,3410,3.25,1,0,0,4,0,2.0
3420,9,3420,2.5,0,0,0,4,0,2.0
1490,7,1490,2.0,0,0,0,3,0,1.0
1640,7,1040,1.0,0,0,600,3,0,1.0
2780,8,2780,2.5,0,0,0,4,0,2.0
2040,8,1480,2.25,0,0,560,4,0,1.0
3440,10,3440,2.25,0,0,0,4,0,2.0
1440,6,1440,2.0,0,0,0,2,0,1.0
1370,7,1370,2.25,0,0,0,3,0,2.0
2170,8,1710,3.0,0,0,460,4,0,2.0
1921,7,1921,2.5,0,0,0,4,0,2.0
1340,7,1340,1.0,0,0,0,3,0,1.0
2400,8,1590,1.75,0,0,810,4,0,1.0
2680,8,1340,2.25,0,0,1340,5,0,1.0
1720,7,1720,1.75,0,0,0,3,0,1.0
1060,7,1060,1.0,0,0,0,2,0,1.0
1500,7,1150,2.25,0,0,350,3,0,1.0
2080,7,1260,1.0,0,0,820,4,0,1.5
1740,7,1390,2.25,0,0,350,3,0,1.0
1020,7,1020,1.0,0,0,0,3,0,1.0
1610,8,1610,2.5,0,0,0,3,0,2.0
2220,8,2220,2.25,0,0,0,4,0,2.0
1150,7,1150,1.0,1,0,0,3,0,1.0
1300,8,1300,2.0,0,0,0,2,0,1.0
2120,7,1320,1.75,0,0,800,5,0,1.0
2030,8,1330,2.5,0,0,700,4,0,1.0
4240,9,4240,3.25,0,0,0,5,0,2.0
3970,9,3970,3.5,0,0,0,4,0,2.0
1640,7,1640,1.75,0,0,0,3,0,1.0
1220,7,1220,1.5,1,0,0,3,0,1.0
2320,7,1160,1.75,0,0,1160,4,0,1.0
1630,7,1630,2.25,0,0,0,3,0,2.0
1510,7,1210,1.75,0,0,300,3,0,1.0
2120,9,2120,2.0,1,0,0,4,0,2.0
1200,6,1200,1.75,0,0,0,3,0,1.0
2260,7,2260,2.75,0,0,0,4,0,2.0
3990,9,3990,3.0,0,0,0,4,0,2.0
1100,8,940,1.5,0,0,160,3,0,2.0
1470,7,1160,2.25,0,0,310,3,0,1.0
3220,9,3220,2.5,0,0,0,3,0,2.0
1060,7,1060,1.0,0,0,0,3,0,1.0
1510,8,1060,2.5,0,0,450,3,0,2.0
2020,7,1180,1.75,0,0,840,3,0,1.0
1300,7,800,2.0,0,0,500,2,0,1.0
2340,9,2340,2.5,0,0,0,3,0,2.0
1480,7,1480,2.0,0,0,0,3,0,1.0
2240,7,1120,1.75,0,0,1120,4,0,1.0
1590,7,1140,1.0,0,0,450,3,0,1.0
960,7,960,1.0,1,0,0,3,0,1.0
2640,9,1840,2.75,0,0,800,4,0,2.0
2380,8,2110,2.0,0,0,270,3,0,2.0
3500,9,1830,2.25,0,4,1670,4,0,1.0
1390,8,970,1.5,0,0,420,2,0,1.0
1660,6,830,1.5,0,0,830,2,0,1.0
1360,8,1360,2.0,0,0,0,3,0,1.5
2100,8,1330,2.25,0,0,770,3,0,1.0
1680,7,1680,2.25,0,0,0,3,0,2.0
1255,7,1255,1.5,0,0,0,3,0,3.0
2050,7,1180,2.75,0,0,870,4,0,1.0
1850,8,1850,2.75,0,2,0,3,0,1.0
2720,7,2720,2.5,0,4,0,2,1,2.0
2720,7,1360,2.5,0,0,1360,4,0,1.0
2180,8,2180,2.5,0,0,0,4,0,2.0
3840,10,3840,2.5,1,1,0,4,0,2.0
1680,7,1150,3.0,0,0,530,4,0,1.0
2130,8,2130,2.5,0,0,0,3,0,2.0
1600,7,1600,2.25,0,0,0,4,0,2.0
1050,5,1050,1.0,0,0,0,3,0,1.0
4480,12,3420,3.0,1,0,1060,5,0,2.5
2580,10,2090,2.5,0,0,490,3,0,1.0
2660,8,2660,1.75,0,0,0,4,0,2.0
1110,7,1110,1.0,0,0,0,3,0,1.0
820,6,820,1.0,0,0,0,2,0,1.0
2240,7,1830,3.0,0,0,410,4,0,2.0
1360,8,1360,2.0,0,0,0,3,0,2.0
1600,8,1600,1.75,1,0,0,3,0,1.0
690,6,690,1.0,0,0,0,2,0,1.0
1760,8,1130,2.5,0,0,630,2,0,1.0
1770,8,1770,2.0,0,0,0,2,0,1.0
1650,7,1250,2.0,0,0,400,3,0,1.0
1410,7,1410,1.0,0,0,0,3,0,1.0
2040,7,1020,2.0,0,0,1020,3,0,1.0
910,6,910,1.0,0,0,0,2,0,1.0
1230,7,1230,1.0,0,0,0,3,0,1.5
1740,8,1330,1.75,0,0,410,3,0,1.0
1090,6,1090,1.0,0,0,0,3,0,1.0
1920,7,1920,2.5,0,0,0,3,0,2.0
1370,7,1370,2.0,0,0,0,3,0,1.0
3370,9,3370,2.5,0,0,0,5,0,2.0
4150,11,4150,3.5,0,0,0,4,0,2.0
720,6,720,1.0,0,0,0,2,0,1.0
2790,9,2790,2.5,0,0,0,4,0,2.0
870,6,870,1.0,0,0,0,2,0,1.0
1740,8,1740,1.0,0,0,0,3,0,1.0
1110,6,1110,1.5,1,0,0,3,0,1.0
1450,7,1450,1.5,0,0,0,3,0,2.0
2700,9,2700,2.5,0,0,0,4,0,2.0
2040,7,2040,2.25,0,2,0,3,0,2.0
2410,7,2410,3.0,0,2,0,3,0,2.0
1470,8,1470,1.75,0,0,0,3,0,1.0
2860,9,2860,2.5,0,0,0,3,0,2.0
1260,7,1260,2.25,0,0,0,3,0,2.0
2020,7,1270,2.75,0,0,750,3,0,1.0
1240,7,1240,1.0,0,0,0,3,0,1.0
1650,7,1220,2.25,0,0,430,3,0,1.0
1950,7,1330,1.75,0,0,620,4,0,1.0
2700,9,2700,2.5,0,0,0,4,0,2.0
1150,7,1150,2.5,0,0,0,2,0,2.0
3180,9,1990,4.5,0,3,1190,4,0,2.0
1680,7,1680,2.5,0,0,0,3,0,2.0
1940,7,1940,1.5,0,0,0,5,0,1.5
1130,7,1130,1.5,0,0,0,3,0,1.0
1790,7,1020,1.5,0,0,770,4,0,1.0
1400,7,1400,1.75,0,0,0,3,0,1.0
1020,7,880,1.0,0,0,140,3,0,1.0
1320,7,1320,1.5,0,0,0,3,0,1.0
2560,7,1280,2.5,0,0,1280,4,0,1.0
1900,7,1500,1.5,0,0,400,3,0,1.0
1720,7,1720,2.5,0,0,0,5,0,1.5
1510,7,1510,2.25,0,0,0,2,0,2.0
2580,9,1390,1.75,0,0,1190,3,0,1.0
1190,7,1190,2.25,0,0,0,3,0,1.0
3920,10,3120,2.25,0,0,800,4,0,2.0
1300,7,1300,1.75,0,0,0,2,0,1.0
2680,7,1340,2.75,0,0,1340,4,0,1.0
3320,9,3320,2.5,0,0,0,4,0,2.0
1220,6,1220,1.0,0,0,0,3,0,1.0
2800,8,2800,3.0,0,0,0,4,0,2.0
2980,9,2340,3.5,0,0,640,4,0,2.0
1140,8,1140,2.5,0,0,0,2,0,3.0
1420,7,1420,1.5,0,0,0,3,0,1.0
1270,7,1270,1.75,0,0,0,3,0,1.0
3120,7,2090,4.0,0,2,1030,6,0,2.0
1710,7,1710,1.75,0,0,0,2,0,1.0
2670,8,2670,2.5,0,0,0,4,0,2.0
2240,9,1540,3.25,0,0,700,3,0,2.0
1960,7,980,2.0,0,0,980,2,0,1.0
2830,8,2830,1.5,0,0,0,5,0,2.5
1010,7,1010,1.0,0,0,0,3,0,1.0
2850,9,2850,2.5,0,0,0,4,0,2.0
2500,8,1770,2.0,0,0,730,3,0,1.0
2420,8,2420,2.5,0,0,0,3,0,2.0
1420,8,1420,2.5,0,0,0,3,0,3.0
2570,8,1510,2.5,0,4,1060,4,0,1.0
1570,8,1570,2.0,0,0,0,3,0,1.0
950,8,950,2.5,0,0,0,3,0,2.0
2940,9,2340,2.0,0,0,600,5,0,2.0
2330,7,1580,2.0,0,0,750,3,0,1.5
1320,7,1080,3.0,0,0,240,3,0,2.0
1780,8,1780,3.0,0,0,0,4,0,1.0
1720,8,1320,2.25,0,0,400,3,0,1.0
3300,8,3300,2.75,1,0,0,4,0,2.0
1820,7,1820,2.25,0,0,0,3,0,1.0
1930,7,1330,1.75,0,0,600,3,0,1.0
3650,8,2530,4.5,0,0,1120,9,0,2.0
2290,7,2290,2.0,0,0,0,4,0,1.5
2660,9,2660,2.5,0,0,0,4,0,2.0
1530,7,1530,1.5,0,0,0,3,0,1.5
1320,7,1320,2.5,0,0,0,3,0,2.0
1530,7,1530,2.0,0,0,0,3,0,1.0
2310,8,1760,1.75,0,0,550,3,0,1.0
2820,9,2820,2.5,0,0,0,4,0,2.0
990,6,990,1.0,0,0,0,3,0,1.0
2050,7,1350,1.5,0,0,700,3,0,1.0
1530,7,1130,1.0,0,0,400,2,0,1.0
5180,12,4280,4.25,1,3,900,4,0,2.0
1890,7,1030,1.0,0,0,860,2,0,1.0
2340,7,1310,2.75,0,0,1030,4,0,1.0
1540,7,1010,1.5,0,0,530,3,0,1.0
1950,7,1950,2.5,0,0,0,3,0,2.0
1680,7,1680,1.0,0,0,0,3,0,1.0
1780,7,1280,1.75,0,0,500,3,0,1.0
1600,7,1600,1.0,0,0,0,4,0,1.5
1960,7,1410,2.75,0,0,550,3,0,1.5
2230,8,1530,1.75,0,0,700,2,0,1.0
2830,10,1980,2.5,1,0,850,4,0,2.0
1240,6,1240,1.5,0,0,0,3,0,1.0
1710,7,1710,1.0,0,0,0,3,0,1.5
3300,9,1720,2.5,0,0,1580,4,0,1.0
2850,7,2850,3.0,0,0,0,8,0,1.0
1990,8,1390,2.5,0,0,600,3,0,1.5
880,6,880,1.5,0,0,0,3,0,1.0
1630,7,1130,2.25,0,0,500,3,0,1.0
3360,9,3360,2.5,1,0,0,4,0,2.0
2840,10,2840,3.0,0,0,0,3,0,2.0
810,7,810,1.0,0,0,0,2,0,1.0
2390,7,2390,2.5,0,0,0,4,0,2.0
1570,7,1070,1.0,0,0,500,3,0,1.0
1740,7,1740,1.0,0,0,0,4,0,1.5
1490,7,1170,2.25,0,0,320,3,0,1.0
1510,7,1510,1.5,0,0,0,2,0,1.0
1780,6,1050,1.0,0,0,730,3,0,1.5
3770,10,3770,3.25,0,0,0,4,0,2.0
2230,9,2230,1.75,1,0,0,3,0,1.0
2290,9,2290,2.5,1,0,0,3,0,2.0
2310,8,2310,2.5,0,0,0,4,0,2.0
3870,10,3870,3.75,0,0,0,5,0,2.0
1970,8,1970,2.75,0,3,0,3,0,1.5
2390,9,2390,2.25,1,0,0,4,0,1.0
1960,7,1960,1.5,0,0,0,3,0,1.5
2990,8,2990,2.5,0,0,0,5,0,2.0
1480,7,930,1.5,0,0,550,2,0,1.0
900,6,900,1.0,0,0,0,3,0,1.0
1390,7,1390,1.75,0,0,0,3,0,1.0
2920,9,2260,3.5,0,0,660,5,0,2.0
2420,8,2420,3.0,0,0,0,5,0,2.0
1950,7,1130,2.25,0,0,820,5,0,1.0
2440,9,2440,3.0,0,0,0,3,0,2.0
880,7,880,1.0,0,0,0,2,0,1.0
860,6,860,1.0,0,0,0,2,0,1.0
2100,8,1720,2.75,1,0,380,4,0,1.0
2050,8,1400,1.75,0,0,650,3,0,1.0
1070,7,1070,1.0,0,0,0,3,0,1.0
3090,7,3090,2.0,0,0,0,4,0,1.0
3470,8,2790,2.25,0,0,680,5,0,1.5
1610,8,1240,2.5,0,0,370,3,0,2.0
1270,8,1060,2.5,0,0,210,3,0,2.0
1010,7,1010,1.0,0,0,0,2,0,1.0
1890,7,1890,1.75,0,0,0,5,0,1.0
1340,7,1340,1.0,1,0,0,3,0,1.0
1660,7,1260,1.0,0,0,400,4,0,1.5
2730,8,1530,3.5,0,0,1200,5,0,1.0
2680,8,1810,3.0,0,0,870,5,0,2.0
2030,7,1230,2.25,0,0,800,4,0,1.0
1630,8,1100,2.25,0,0,530,3,0,1.0
1660,8,1380,1.75,0,0,280,3,0,1.0
1760,7,1760,2.0,0,0,0,3,0,1.0
1300,8,850,2.0,0,0,450,3,0,2.0
1100,6,1100,1.0,0,0,0,3,0,1.5
1920,7,1130,2.75,0,0,790,4,0,1.0
1630,7,1330,1.75,0,0,300,3,0,1.0
890,6,890,1.0,0,0,0,2,0,1.0
860,6,860,1.0,0,0,0,2,0,1.0
1150,8,1150,2.5,0,0,0,2,0,3.0
2660,7,2660,2.25,0,0,0,6,0,2.0
2344,8,1560,2.5,0,0,784,5,0,1.0
420,5,420,0.75,0,0,0,1,0,1.0
1300,7,1300,1.0,0,0,0,3,0,1.0
2560,8,2560,2.5,0,0,0,4,0,2.0
1580,7,1580,1.75,0,0,0,3,0,1.0
1670,7,1170,2.5,0,0,500,3,0,1.0
2440,7,2440,1.5,0,0,0,3,0,1.0
1370,7,1370,2.25,0,0,0,3,0,2.0
1850,6,1850,1.75,0,0,0,3,0,1.5
1120,7,1120,1.0,0,2,0,2,0,1.0
3160,9,3160,2.5,0,0,0,4,0,2.0
2760,10,2760,2.5,0,0,0,4,0,2.0
1160,7,1160,1.0,0,0,0,3,0,1.0
1020,7,1020,1.0,0,0,0,3,0,1.0
1500,6,1500,1.0,0,0,0,5,0,1.5
1900,8,1900,1.75,0,0,0,4,0,1.0
2430,8,1470,2.5,0,0,960,4,0,1.0
1300,7,1300,1.0,0,0,0,3,0,1.0
2550,8,1720,3.0,0,0,830,4,0,2.0
1490,7,1490,1.5,0,0,0,3,0,1.0
2560,9,2560,2.5,0,0,0,4,0,2.0
1370,7,1070,1.5,0,0,300,4,0,1.0
1460,6,1460,2.0,0,0,0,4,0,1.0
2550,7,2550,2.5,0,0,0,3,0,2.0
1940,7,1940,2.25,0,0,0,3,0,2.0
2100,7,1500,2.5,0,0,600,3,0,2.0
1430,7,1430,1.0,0,0,0,2,0,1.5
1490,10,1300,2.5,0,0,190,3,0,2.0
3990,9,2820,3.5,0,0,1170,5,0,2.0
1870,8,1870,2.5,0,0,0,4,0,2.0
3320,8,1660,2.25,1,0,1660,5,0,1.0
1730,6,1730,3.0,0,0,0,4,0,2.0
2000,8,2000,1.75,0,0,0,3,0,2.0
810,6,810,1.0,0,0,0,2,0,1.0
1580,9,1580,2.5,0,0,0,3,0,3.0
1400,7,1400,1.0,0,0,0,3,0,1.5
3890,12,2890,3.25,0,0,1000,3,0,2.0
2110,7,2110,1.75,0,0,0,3,0,2.0
1720,7,1140,1.75,0,0,580,3,0,1.0
2010,7,2010,2.0,0,3,0,3,0,2.0
2910,10,2910,2.5,0,0,0,4,0,2.0
1450,8,940,2.5,0,0,510,3,0,2.0
3860,10,3860,2.75,1,0,0,3,0,2.0
2060,9,2060,2.5,0,0,0,3,0,2.0
1240,6,1090,1.0,0,0,150,3,0,1.0
2920,8,1470,2.5,0,3,1450,4,0,1.0
980,6,830,1.0,0,0,150,3,0,1.0
1278,7,1002,2.5,0,0,276,2,0,2.0
910,6,910,1.0,0,0,0,3,0,1.0
2380,7,2380,2.25,0,0,0,4,0,1.0
2850,10,2850,2.5,0,0,0,3,0,2.0
2250,8,2250,2.5,0,0,0,3,0,2.0
1300,7,1300,2.0,0,0,0,4,0,1.0
2530,9,2530,2.5,0,4,0,3,0,2.5
1852,7,1852,2.5,0,0,0,3,0,2.0
1010,6,1010,1.5,0,0,0,3,0,1.0
1510,8,1510,1.5,0,0,0,3,0,1.0
2400,8,1590,2.0,0,0,810,3,0,2.0
2160,9,2160,2.5,0,0,0,4,0,2.0
1790,7,1220,2.75,0,0,570,4,0,1.0
2290,7,1340,1.75,0,0,950,4,0,1.0
2180,7,1100,2.25,0,0,1080,4,0,1.0
1360,5,1360,1.0,0,0,0,2,0,1.0
2990,9,2990,2.5,0,0,0,4,0,2.0
1250,7,1250,1.0,0,0,0,3,0,1.0
1490,7,960,3.0,0,0,530,3,0,2.0
2500,8,1600,1.75,0,2,900,4,0,1.0
2480,9,2480,2.5,0,0,0,3,0,2.0
1160,7,910,1.0,0,0,250,2,0,1.0
2568,9,2568,2.5,0,0,0,4,0,2.0
2670,9,2670,2.5,0,0,0,4,0,2.0
2650,8,2650,2.0,0,0,0,6,0,1.5
1140,6,1140,1.0,0,0,0,3,0,1.5
1990,8,1990,2.5,0,0,0,3,0,2.0
3080,8,2080,3.25,0,0,1000,3,0,2.0
1980,8,1980,2.0,0,0,0,4,0,2.0
2580,8,2580,2.25,0,0,0,3,0,1.0
1170,6,980,1.0,0,0,190,2,0,1.0
3440,10,2520,3.25,0,4,920,4,0,2.0
1850,6,1850,1.75,0,4,0,3,0,1.5
2960,8,1640,2.5,0,0,1320,5,0,1.0
2270,8,2270,1.75,0,0,0,4,0,1.0
1680,7,1180,1.5,0,0,500,4,0,1.0
1270,6,1270,1.5,0,0,0,3,0,1.0
1410,7,1410,1.0,0,0,0,3,0,1.0
2170,10,1130,1.5,0,2,1040,3,1,1.0
2600,8,1810,2.25,0,2,790,5,0,1.0
1890,7,1290,1.75,0,0,600,3,0,1.0
2140,8,2140,2.5,0,0,0,3,0,2.0
700,6,700,1.0,0,0,0,2,0,1.0
1900,7,1440,2.25,0,0,460,3,0,1.5
3080,9,2380,3.25,0,0,700,4,0,2.0
1150,7,1150,1.0,0,0,0,3,0,1.0
880,6,880,1.0,0,0,0,2,0,1.0
680,5,480,1.0,0,0,200,1,0,1.0
1580,7,1050,2.0,0,0,530,4,0,1.0
2250,8,1320,2.75,0,0,930,4,0,1.0
1810,8,1810,2.25,1,0,0,3,0,1.0
2260,7,1330,3.0,0,0,930,5,0,1.0
920,7,920,1.0,0,0,0,2,0,1.0
3410,8,1870,3.0,0,0,1540,5,0,1.0
370,5,370,0.75,0,0,0,1,0,1.0
3290,8,2330,3.0,0,2,960,3,0,2.0
1000,6,1000,1.75,0,0,0,4,0,1.5
1760,8,1760,1.75,0,0,0,3,0,1.0
3700,9,2900,3.75,0,4,800,5,0,3.0
1700,7,1010,1.5,0,0,690,3,0,1.0
790,7,790,1.0,1,2,0,2,0,1.0
3600,9,3400,2.5,0,0,200,4,0,2.0
1510,7,1510,2.0,0,0,0,3,0,1.0
2110,8,2110,2.5,1,2,0,4,0,1.0
3140,7,2320,1.75,1,0,820,4,0,1.0
3090,9,2020,3.5,0,2,1070,3,0,2.0
2130,7,2130,1.0,0,0,0,3,0,1.5
1110,7,1110,2.0,0,0,0,3,0,1.0
1660,7,1000,1.5,0,0,660,2,0,1.0
1970,7,1970,2.5,0,0,0,3,0,2.0
1610,7,1610,2.5,0,0,0,3,0,2.0
3200,9,3200,2.25,1,0,0,4,0,2.0
1410,7,1410,1.5,0,0,0,4,0,1.0
2160,7,1360,1.0,0,0,800,2,0,1.0
1290,8,1000,2.25,0,0,290,3,0,2.0
1540,6,1040,1.75,0,0,500,3,0,1.0
1720,7,1420,2.0,0,0,300,4,0,1.0
2500,7,1300,2.5,0,0,1200,5,0,1.0
3560,8,2060,2.5,1,1,1500,4,0,1.0
2070,8,1540,2.5,0,0,530,3,0,1.0
1640,7,930,1.75,0,0,710,3,0,1.0
1530,7,1120,1.75,0,0,410,3,0,1.0
2820,8,2820,2.5,0,0,0,5,0,2.0
2000,7,1360,1.75,0,0,640,3,0,1.0
920,6,920,1.0,0,0,0,3,0,1.0
1860,7,1860,2.5,0,0,0,3,0,2.0
2410,7,1260,2.0,0,0,1150,4,0,1.0
2170,7,1230,1.5,0,0,940,5,0,1.0
1400,7,1400,1.5,0,0,0,3,0,1.0
1540,8,1540,2.0,0,0,0,2,0,2.0
3120,8,3120,3.0,0,0,0,4,0,2.0
1720,7,860,1.75,0,0,860,3,0,1.0
1360,8,1360,2.5,0,0,0,3,0,2.0
1850,7,1020,1.75,0,0,830,3,0,1.0
3020,9,2360,2.5,0,0,660,3,0,2.0
2830,9,2830,2.5,0,0,0,4,0,2.0
2910,9,2910,2.5,0,0,0,4,0,2.0
3530,11,3530,3.25,0,0,0,4,0,2.0
2320,8,2320,2.0,0,0,0,3,0,1.0
3130,8,2180,3.25,0,0,950,5,0,2.0
1540,6,770,1.75,0,0,770,4,0,1.0
2305,8,2305,2.5,0,0,0,2,0,1.0
1620,7,1620,2.5,0,0,0,4,0,2.0
1830,8,1830,2.25,0,0,0,3,0,1.0
2090,8,2090,2.5,0,0,0,4,0,2.0
2060,7,1320,2.25,0,0,740,5,0,1.0
1350,7,930,2.25,0,0,420,3,0,1.0
840,6,840,1.0,0,0,0,3,0,1.0
2200,7,2200,2.5,0,0,0,4,0,2.0
1940,8,1940,2.5,0,0,0,4,0,2.0
2110,8,2110,2.25,0,0,0,3,0,3.0
900,6,780,1.0,0,0,120,2,0,1.0
1510,7,1510,1.5,0,0,0,5,0,1.0
7420,12,7420,3.25,0,3,0,4,0,2.0
2080,8,2080,3.5,0,0,0,3,0,2.0
3500,9,3500,2.75,0,0,0,4,0,2.0
1150,8,1020,2.5,0,0,130,3,0,2.0
1608,8,1608,2.5,0,0,0,3,0,2.0
1320,8,1320,1.75,0,0,0,3,0,1.0
1260,7,1260,1.75,1,0,0,3,0,1.0
1030,7,1030,1.0,0,0,0,2,0,1.0
1200,7,1200,1.75,0,0,0,4,0,1.0
2008,7,1216,3.0,0,0,792,5,0,1.0
1840,7,920,2.5,0,0,920,3,0,1.0
4420,11,4420,3.5,1,0,0,4,0,2.0
1870,7,1170,2.25,0,0,700,4,0,1.0
2900,8,2900,2.5,0,0,0,4,0,2.0
1010,6,1010,1.0,0,0,0,3,0,1.0
3650,9,3330,4.0,1,3,320,4,0,2.0
2740,8,2740,2.5,0,0,0,5,0,2.0
1060,7,1060,1.0,0,0,0,3,0,1.0
3120,10,3120,2.75,0,0,0,4,0,2.0
1070,6,1070,1.0,0,0,0,2,0,1.0
950,7,950,1.0,1,0,0,3,0,1.0
1330,7,1330,1.75,0,0,0,3,0,1.0
1350,8,1350,2.5,0,0,0,3,0,3.0
1200,7,1200,1.5,0,0,0,2,0,2.0
1210,7,1210,1.0,0,0,0,2,0,1.0
2550,8,2550,2.5,0,0,0,4,0,2.0
1050,7,1050,1.0,0,0,0,2,0,1.5
2980,8,1930,2.5,0,0,1050,3,0,1.0
2810,8,2040,2.75,0,0,770,3,0,2.0
3004,9,3004,2.5,0,0,0,5,0,2.0
1640,7,1090,1.75,0,0,550,3,0,1.0
2260,8,1130,2.0,0,0,1130,5,0,1.0
1470,7,1470,2.5,0,0,0,3,0,2.0
3910,9,1970,2.75,1,0,1940,3,0,1.0
2200,7,1100,1.75,0,0,1100,4,0,1.0
1320,8,1320,3.5,0,0,0,3,0,3.0
1060,6,1060,1.0,0,0,0,3,0,1.0
3510,10,3510,2.5,0,0,0,4,0,2.0
1520,6,1520,1.75,0,0,0,3,0,1.0
1720,8,1720,2.5,0,0,0,4,0,2.0
3720,10,3720,2.5,0,0,0,4,0,2.0
2330,7,1550,2.75,0,0,780,5,0,1.0
1410,7,980,1.0,0,0,430,3,0,1.0
2210,8,1390,1.75,0,0,820,3,0,1.0
2120,7,1370,1.75,0,0,750,4,0,1.0
2590,7,1340,2.5,0,0,1250,6,0,1.0
1700,6,1700,2.0,0,0,0,4,0,1.0
1160,6,1160,1.0,0,0,0,3,0,1.0
1290,8,660,1.5,0,0,630,2,0,1.0
3670,8,2060,3.0,0,0,1610,5,0,1.0
2220,8,2220,2.5,0,0,0,4,0,2.0
1810,7,1810,1.5,0,0,0,4,0,1.0
2340,7,1300,2.5,0,0,1040,5,0,1.0
940,7,940,1.0,0,0,0,3,0,1.5
1230,7,1230,1.0,0,0,0,2,0,1.0
1680,7,1680,1.0,0,0,0,4,0,1.5
1890,7,1890,2.0,0,0,0,3,0,2.0
2560,7,1790,2.25,0,0,770,4,0,1.0
1550,7,830,1.75,0,3,720,2,0,1.0
1770,7,1770,1.75,0,0,0,3,0,1.0
2880,8,2880,2.5,0,0,0,5,0,2.0
1410,7,1410,1.0,0,0,0,3,0,1.0
4650,11,3640,4.5,1,0,1010,4,0,2.0
1610,7,1610,1.0,0,0,0,4,0,1.5
1480,7,1480,2.5,0,0,0,3,0,2.0
670,6,670,1.0,0,0,0,2,0,1.0
2010,8,1010,2.25,0,1,1000,4,0,1.0
2540,9,2540,2.5,0,0,0,2,0,2.0
1680,7,1680,2.75,0,0,0,4,0,1.0
2930,8,2440,1.75,0,0,490,3,0,2.0
2800,7,2800,2.5,0,0,0,4,0,2.0
2500,7,1250,2.5,1,0,1250,4,0,1.0
2190,7,2190,2.5,0,0,0,4,0,2.0
1680,7,1680,1.75,0,0,0,3,0,1.0
2400,11,2400,1.25,0,2,0,3,0,3.0
1720,7,1140,1.75,0,0,580,3,0,1.0
1220,7,1220,2.0,0,0,0,3,0,1.0
1570,7,1570,1.75,0,0,0,3,0,1.0
2020,8,1550,1.75,0,0,470,4,0,1.0
2360,8,1360,1.75,0,0,1000,3,0,1.0
3400,8,2000,3.25,0,0,1400,4,0,1.0
2510,8,1590,3.0,0,3,920,5,0,1.5
2490,8,1720,3.5,0,0,770,3,0,2.0
1870,7,960,1.75,0,0,910,2,0,1.0
2390,7,1720,2.0,0,0,670,4,0,2.0
4160,11,3040,3.0,0,0,1120,4,0,2.0
2870,8,2220,2.25,0,1,650,4,0,2.0
1850,7,1180,2.0,0,0,670,3,0,1.0
1370,9,1370,2.5,0,0,0,3,0,2.0
2480,8,2480,2.5,0,0,0,4,0,2.0
3240,10,3240,3.0,0,0,0,4,0,2.0
1390,7,1390,1.0,1,0,0,3,0,1.0
2210,8,1650,1.5,0,0,560,4,0,1.0
2270,8,1540,2.5,0,0,730,4,0,1.0
1950,7,1950,1.75,0,0,0,3,0,1.0
990,7,990,1.0,0,0,0,3,0,1.0
1260,7,1260,1.75,0,0,0,3,0,1.0
1610,7,1010,1.0,0,0,600,3,0,1.0
2495,8,2495,2.5,0,0,0,3,0,2.0
2190,9,2190,2.0,0,0,0,3,0,1.0
1600,7,1600,2.5,0,0,0,3,0,2.0
3600,9,2610,2.75,0,0,990,4,0,2.0
1510,6,1510,1.0,0,0,0,3,0,1.0
2210,8,2210,2.0,0,0,0,3,0,1.0
3270,10,3270,2.25,0,0,0,3,0,2.0
2270,8,1880,3.5,0,0,390,3,0,2.0
1690,7,1180,2.75,0,0,510,3,0,1.0
720,6,720,1.0,0,0,0,2,0,1.0
1140,7,1140,1.75,0,0,0,3,0,1.0
3160,6,1840,1.5,0,0,1320,4,0,1.5
2370,9,1630,2.5,0,0,740,4,0,1.0
1810,5,1050,1.5,0,0,760,6,0,1.5
2870,9,2870,2.5,0,0,0,3,0,2.0
1070,6,1070,1.0,0,0,0,2,0,1.0
2630,9,2630,3.0,0,0,0,3,0,2.0
1840,7,920,1.0,0,0,920,3,0,1.0
1870,6,1090,1.0,0,0,780,4,0,1.5
1740,7,1740,3.0,0,0,0,3,0,1.0
3270,9,3110,3.25,0,0,160,4,0,2.0
1770,8,1770,2.0,0,0,0,3,0,1.0
2660,8,2660,2.25,0,0,0,4,0,2.0
1660,7,1380,1.75,0,0,280,3,0,1.0
2680,8,1590,1.75,0,0,1090,3,0,1.0
1350,7,1350,1.0,0,0,0,4,0,1.5
2100,7,1290,2.25,0,0,810,4,0,1.0
1580,7,1580,1.75,0,0,0,3,0,1.0
5300,11,5300,3.75,0,0,0,4,0,2.0
820,7,820,1.0,1,0,0,2,0,1.0
1500,6,1500,1.75,0,0,0,3,0,1.0
2850,10,2850,2.5,0,0,0,3,0,2.0
2440,7,1480,2.25,0,0,960,3,0,1.0
3440,8,1720,2.5,0,2,1720,5,0,1.0
1660,7,1660,2.5,0,0,0,3,0,1.0
1250,7,1250,1.75,0,2,0,3,0,1.0
1300,6,1300,1.0,0,0,0,3,0,1.0
1430,7,820,1.5,0,0,610,3,0,1.0
3190,10,3190,2.75,0,0,0,4,0,2.0
2840,9,2840,2.5,0,0,0,4,0,2.0
3650,10,3650,2.5,0,0,0,4,0,2.0
2910,8,2040,3.25,0,0,870,5,0,2.0
930,6,930,1.0,0,0,0,2,0,1.0
1120,7,1120,1.75,0,0,0,3,0,1.0
1068,7,1068,1.5,0,0,0,2,0,2.0
1940,8,1310,1.5,1,0,630,3,0,1.5
1760,8,1760,1.0,1,0,0,5,0,2.0
1070,7,1070,1.0,0,0,0,3,0,1.0
1850,8,1850,2.5,0,0,0,4,0,2.0
1610,8,1610,2.5,0,0,0,3,0,2.0
2260,7,1250,2.0,0,0,1010,5,0,1.0
2590,8,1510,2.25,0,0,1080,5,0,1.0
2000,8,1120,1.75,0,0,880,4,0,1.0
1660,7,1260,1.0,0,0,400,3,0,1.0
4740,11,4740,3.25,0,0,0,4,0,2.0
1500,7,1220,1.75,0,0,280,2,0,1.0
1640,7,1640,1.0,0,0,0,3,0,1.0
1940,7,1420,2.5,0,0,520,3,0,1.0
3200,9,3200,2.25,0,0,0,4,0,2.0
1400,7,1400,1.5,0,0,0,2,0,3.0
1490,7,1150,1.0,1,0,340,3,0,1.0
2980,10,2490,3.5,0,0,490,4,0,2.5
1000,7,1000,1.0,0,0,0,3,0,1.0
1410,7,1410,1.75,0,0,0,3,0,1.5
2320,8,1380,2.5,0,0,940,3,0,1.0
1680,8,1680,2.0,0,0,0,3,0,1.0
2080,8,2080,2.5,0,0,0,4,0,2.0
1830,7,1350,1.5,0,0,480,3,0,1.0
1060,5,1060,1.0,0,4,0,1,1,1.0
1700,8,1460,1.75,0,0,240,3,0,1.0
3150,9,3150,2.5,0,0,0,5,0,2.0
1690,7,1210,1.0,0,0,480,3,0,1.0
3230,9,1870,2.5,1,0,1360,4,0,1.0
3050,8,2240,3.25,0,0,810,3,0,2.0
930,6,930,1.75,0,0,0,2,0,1.0
2560,7,1760,2.5,0,0,800,4,0,1.0
1960,8,1960,2.5,0,0,0,3,0,2.0
1900,7,1420,2.5,0,0,480,4,0,1.0
1020,7,920,1.0,0,4,100,2,0,1.0
2840,9,2840,2.5,0,0,0,4,0,2.0
2230,8,1630,1.0,0,2,600,3,0,2.0
3370,10,2250,3.5,0,0,1120,4,0,2.0
3400,9,2550,3.5,0,0,850,5,0,2.0
3950,10,3950,3.25,1,0,0,4,0,2.0
1220,7,1220,1.0,0,0,0,3,0,1.0
1770,7,1140,1.0,0,0,630,3,0,1.5
2930,8,2930,3.75,0,0,0,3,0,2.0
1850,7,1150,2.25,1,0,700,3,0,1.0
2720,10,2720,2.5,1,0,0,4,0,2.0
3580,9,3580,2.25,1,0,0,5,0,2.0
1400,6,1400,2.0,0,0,0,4,0,1.5
1300,7,900,1.5,0,0,400,3,0,1.0
1170,6,1170,1.0,0,0,0,3,0,1.0
1810,8,1810,2.75,0,0,0,3,0,2.0
1800,8,1800,2.0,0,0,0,3,0,1.0
2330,8,2330,2.5,0,0,0,3,0,2.0
3240,9,3240,2.5,0,2,0,4,0,2.0
1160,7,1160,1.0,0,0,0,3,0,1.0
4560,10,4040,3.0,0,2,520,3,0,2.0
2750,7,1750,3.0,0,0,1000,5,0,1.5
1560,7,1560,1.75,0,0,0,4,0,1.0
1010,6,1010,1.0,0,0,0,3,0,1.0
2020,7,1170,1.0,0,0,850,3,0,1.0
990,6,990,1.0,0,0,0,2,0,1.0
2430,7,1760,1.75,0,0,670,3,0,2.0
1060,7,1060,1.0,0,0,0,3,0,1.0
2240,8,2240,2.5,0,0,0,4,0,2.0
1330,6,720,1.75,0,0,610,3,0,1.0
2920,9,1800,2.5,0,4,1120,3,0,1.0
1510,7,1510,3.25,0,0,0,3,0,3.0
3010,9,1890,2.0,0,2,1120,3,0,2.0
2090,8,2090,2.25,1,0,0,4,0,2.0
2990,9,2990,2.5,0,3,0,4,0,2.0
2040,7,1240,2.5,0,0,800,5,0,1.0
820,7,820,1.0,0,0,0,2,0,1.0
1510,7,1060,1.75,0,0,450,3,0,1.0
3370,10,1860,3.0,0,3,1510,4,0,1.0
1060,7,1060,1.0,0,0,0,3,0,1.0
1490,7,1490,1.75,0,0,0,3,0,1.0
2650,9,2650,2.5,1,0,0,4,0,2.0
2580,8,1780,2.25,0,0,800,3,0,2.0
810,7,810,1.0,0,0,0,2,0,1.0
1820,7,1820,1.75,0,0,0,3,0,1.0
1814,7,944,1.75,0,0,870,4,0,1.0
3110,8,2430,2.5,0,0,680,3,0,2.0
2100,8,2100,1.5,0,0,0,4,0,1.5
2270,7,1370,1.75,0,0,900,3,0,1.0
810,7,590,1.0,0,1,220,1,0,1.0
3690,9,2690,3.0,0,2,1000,5,0,1.0
920,6,920,1.0,0,0,0,3,0,1.0
1690,8,1410,2.5,0,0,280,3,0,2.0
1360,7,1020,1.0,0,0,340,3,0,1.0
1550,7,1550,1.0,0,0,0,4,0,1.5
2092,7,2092,1.75,0,0,0,3,0,1.0
2630,9,2630,2.5,0,0,0,3,0,2.0
3930,9,2910,3.25,1,0,1020,5,0,2.0
2920,8,1460,3.0,0,3,1460,4,0,1.0
1230,7,1230,2.0,0,0,0,3,0,1.5
1270,7,1270,1.75,0,0,0,3,0,1.0
2700,10,2700,2.5,1,0,0,3,0,2.0
1810,8,1700,2.0,0,0,110,4,0,2.0
1230,8,1230,2.25,0,0,0,3,0,3.0
1300,7,1300,1.5,0,0,0,4,0,1.0
1350,7,1350,2.5,0,0,0,3,0,1.0
2360,7,1180,1.75,0,0,1180,3,0,1.0
1740,9,1740,1.5,0,0,0,3,0,2.0
2580,8,2580,2.5,0,0,0,4,0,2.0
1290,6,1290,2.0,0,1,0,3,0,1.0
970,7,970,1.0,0,0,0,3,0,1.0
1220,6,620,1.75,0,0,600,3,0,1.0
1600,8,1310,2.5,0,0,290,4,0,1.0
1720,8,1720,2.75,0,0,0,4,0,2.0
3001,8,3001,2.5,0,0,0,5,0,2.0
2196,8,2196,2.5,0,0,0,3,0,2.0
2300,8,1520,1.75,0,0,780,3,0,1.0
2860,8,1530,2.5,1,0,1330,4,0,1.0
3160,10,3160,2.5,0,0,0,4,0,2.0
2220,8,1970,1.5,0,0,250,4,0,1.5
1490,7,1490,2.0,0,0,0,3,0,1.0
3420,8,2430,3.0,0,0,990,3,0,2.0
3060,8,3060,1.0,0,0,0,3,0,1.0
2160,8,2160,2.5,0,0,0,4,0,2.0
1660,9,1530,2.5,0,1,130,3,0,3.0
1660,7,1660,2.5,0,0,0,3,0,2.0
1620,7,1620,2.25,0,0,0,3,0,2.0
700,6,700,1.0,0,0,0,2,0,1.0
1670,7,1100,1.75,0,0,570,4,0,1.0
1330,7,930,1.0,0,0,400,2,0,1.0
1460,8,950,2.0,1,0,510,2,0,2.0
1060,6,880,1.0,0,1,180,4,0,1.0
1460,8,1140,3.0,0,0,320,2,0,2.0
1780,7,1160,2.0,0,0,620,4,0,1.0
750,6,750,1.0,0,0,0,2,0,1.0
1800,8,1360,2.25,1,0,440,4,0,1.0
1980,7,990,1.75,0,0,990,4,0,1.0
2170,8,2170,2.5,0,2,0,2,0,1.0
6070,11,6070,4.5,0,0,0,5,0,2.0
2990,10,2990,3.0,0,0,0,3,0,2.0
1480,7,740,1.75,1,0,740,3,0,1.0
1090,6,1090,1.5,0,0,0,3,0,1.0
2340,8,2340,2.5,0,0,0,4,0,2.0
3140,8,1570,2.75,1,2,1570,4,0,1.0
2744,7,2744,3.0,0,0,0,6,0,2.0
2380,9,2380,2.5,0,0,0,4,0,1.0
1730,8,1220,1.75,0,0,510,3,0,1.0
1170,7,800,2.0,0,0,370,3,0,1.0
2876,8,2360,3.5,0,0,516,3,0,2.0
4180,10,3160,3.5,0,2,1020,5,0,2.0
4360,10,2320,3.25,0,0,2040,4,0,1.0
1340,7,1040,1.0,0,0,300,3,0,1.0
2450,8,2450,2.25,0,0,0,4,0,2.0
1060,7,960,1.75,0,0,100,2,0,2.0
1140,7,1140,1.0,0,2,0,4,0,1.0
2940,9,2940,2.5,0,0,0,4,0,2.0
2680,9,1880,2.0,0,0,800,3,0,1.0
1790,7,1360,1.75,0,0,430,3,0,1.0
2790,9,2790,2.5,0,0,0,4,0,2.0
1010,7,1010,1.5,0,0,0,2,0,1.0
3370,8,2110,2.75,0,2,1260,4,0,1.0
2350,8,1570,2.5,0,0,780,3,0,1.0
1150,6,1150,1.0,0,0,0,3,0,1.0
1560,7,1160,1.75,1,0,400,3,0,1.0
1880,7,1280,2.25,0,0,600,3,0,1.0
3170,7,2570,2.5,0,0,600,4,0,2.0
1170,6,1170,1.0,0,0,0,4,0,1.5
2990,8,2450,3.5,0,0,540,5,0,2.0
3560,9,3560,3.5,0,0,0,4,0,2.0
2540,9,2540,2.5,0,0,0,3,0,2.0
1360,7,1360,1.5,0,0,0,3,0,1.0
1740,8,1740,2.5,0,0,0,3,0,3.0
2240,8,2240,2.5,0,0,0,4,0,2.0
1300,7,1300,1.75,0,0,0,3,0,1.0
4260,10,4260,3.75,1,0,0,4,0,2.0
3190,9,3190,2.5,0,0,0,4,0,2.0
1030,7,1030,1.0,0,0,0,3,0,1.0
1820,7,1120,1.75,0,0,700,4,0,1.5
2500,8,2500,2.0,0,4,0,5,1,2.0
3210,8,1830,2.5,0,0,1380,5,0,1.0
3280,11,3280,2.5,0,3,0,4,0,2.0
2260,8,1620,1.75,0,0,640,4,0,1.0
1650,7,1650,2.25,0,0,0,3,0,2.0
3206,7,3206,2.25,0,0,0,6,0,2.0
1770,8,1770,1.75,0,0,0,3,0,1.0
1720,8,1720,1.75,0,0,0,3,0,1.0
2160,9,1540,2.5,0,0,620,3,0,1.0
1660,7,1000,1.75,0,0,660,4,0,1.0
3320,9,3320,2.5,0,0,0,5,0,2.0
2060,8,1460,2.75,0,0,600,4,0,1.0
2080,7,1040,3.0,0,0,1040,5,0,1.0
990,8,840,1.5,1,0,150,3,0,2.0
5770,9,3160,4.5,0,3,2610,4,0,1.0
1120,7,1120,1.75,0,0,0,3,0,1.0
1080,7,1080,1.0,0,0,0,3,0,1.0
2330,7,1510,1.75,0,0,820,4,0,1.5
1322,8,1087,2.25,0,0,235,3,0,2.0
2140,8,1960,2.5,0,0,180,3,0,2.0
2440,7,2440,2.5,0,0,0,4,0,2.0
1480,7,1480,2.0,0,0,0,4,0,1.0
1720,8,1460,3.0,0,0,260,3,0,3.0
2500,8,2500,2.75,0,0,0,4,0,2.0
3250,8,3250,3.25,0,4,0,5,0,2.0
1870,7,1870,1.75,0,0,0,3,0,2.0
1140,6,1140,1.5,0,0,0,3,0,1.0
880,6,880,1.0,0,0,0,3,0,1.0
2540,9,1620,3.0,0,1,920,4,0,1.0
1050,6,1050,1.0,0,0,0,3,0,1.0
1910,8,1910,2.5,0,0,0,3,0,2.0
3160,8,3160,2.5,0,0,0,3,0,2.0
1400,6,1400,1.75,0,0,0,3,0,1.5
1210,6,1210,1.75,0,0,0,2,0,1.0
1830,7,1070,1.75,0,2,760,2,0,1.0
2800,9,1400,1.75,0,0,1400,4,0,1.0
2210,8,1480,2.5,0,0,730,4,0,1.5
2450,9,2450,2.5,0,0,0,4,0,2.0
2210,8,1460,2.5,0,0,750,5,0,1.0
1510,8,1510,1.75,0,0,0,2,0,2.0
2160,9,2160,2.5,0,0,0,4,0,2.0
1760,8,1640,2.5,0,0,120,3,0,3.0
2700,7,1350,4.0,0,0,1350,6,0,1.0
1850,8,1850,2.5,0,0,0,4,0,2.0
1250,6,1250,1.0,0,0,0,3,0,1.5
3150,8,3150,4.0,0,0,0,7,0,2.0
2160,9,2160,2.5,0,0,0,3,0,2.0
2800,7,1400,2.0,0,0,1400,6,0,1.0
2670,9,2670,2.5,0,0,0,3,0,2.0
1400,7,1400,1.0,0,0,0,3,0,1.0
3340,10,2550,2.75,0,0,790,3,0,1.0
2870,8,1860,2.75,0,1,1010,4,0,1.0
2090,7,1220,2.5,0,0,870,4,0,1.0
3690,10,2190,2.5,0,3,1500,4,0,1.0
760,5,760,1.0,0,0,0,2,0,1.5
2860,9,1980,3.25,0,0,880,4,0,2.0
1651,6,1651,2.0,0,0,0,2,0,1.0
1550,7,1050,1.75,0,0,500,3,0,1.0
1920,6,920,2.0,0,0,1000,4,0,1.0
2010,7,1090,3.0,0,0,920,4,0,1.0
1350,7,1350,1.75,0,0,0,3,0,1.5
1010,6,1010,1.0,0,0,0,2,0,1.0
2990,7,1960,2.0,0,2,1030,4,0,1.5
3030,8,2830,3.25,0,0,200,4,0,2.0
1130,7,1130,1.0,0,0,0,3,0,1.5
1840,7,1220,1.75,0,0,620,3,0,1.0
980,6,980,1.0,0,0,0,3,0,1.0
1640,7,1640,2.5,0,0,0,3,0,2.0
3200,8,2700,3.5,0,0,500,4,0,1.0
2730,8,1530,2.75,0,2,1200,3,0,2.0
4270,11,4270,3.0,0,0,0,4,0,2.0
1500,7,1500,1.0,0,0,0,5,0,2.0
1020,7,1020,0.75,0,0,0,2,0,2.0
1740,8,1740,1.75,0,0,0,4,0,1.0
2480,7,1240,1.0,0,0,1240,3,0,1.0
4600,9,3200,4.5,0,0,1400,5,0,2.0
2730,9,2730,2.5,0,2,0,4,0,2.0
1540,7,1540,2.5,0,0,0,3,0,2.0
1510,7,1150,2.25,0,0,360,3,0,1.0
2050,7,1520,1.75,0,0,530,3,0,1.0
2150,9,2150,2.75,0,0,0,3,0,2.0
1050,7,1050,1.0,0,0,0,2,0,1.0
1030,6,1030,2.0,0,0,0,3,0,1.0
2240,7,1140,2.5,0,0,1100,4,0,1.0
2830,9,2830,2.5,0,0,0,3,0,2.0
2500,8,2500,2.5,0,0,0,4,0,2.0
1730,8,1730,2.5,0,0,0,3,0,2.0
1230,8,870,2.5,1,0,360,2,0,2.0
1440,8,1440,1.5,0,0,0,2,0,1.0
1270,7,1270,2.0,0,0,0,3,0,1.0
1440,7,1440,1.0,0,0,0,3,0,1.5
1310,7,1310,1.0,0,0,0,3,0,1.5
1510,7,1510,2.0,0,0,0,4,0,1.0
3990,9,2930,3.5,0,3,1060,4,0,2.0
770,6,770,1.0,0,0,0,2,0,1.0
1220,6,1220,1.0,0,0,0,4,0,1.5
1210,7,1210,1.75,0,0,0,3,0,1.0
3430,10,3430,2.5,1,0,0,3,0,1.5
1920,7,1920,2.5,0,0,0,3,0,2.0
3840,11,3840,3.5,0,0,0,4,0,2.0
2440,9,2440,2.5,0,0,0,4,0,2.0
3250,8,3250,2.5,0,0,0,4,0,2.0
2430,8,1340,1.75,1,2,1090,3,0,1.0
880,7,880,1.0,0,0,0,3,0,1.0
1950,8,1950,2.0,0,0,0,3,0,1.0
1960,8,960,2.0,0,0,1000,4,0,1.0
1690,8,1690,2.5,0,0,0,3,0,2.0
1460,7,1100,1.5,0,0,360,3,0,1.0
1480,6,1480,1.5,0,0,0,4,0,1.0
800,6,800,1.0,0,0,0,2,0,1.0
1390,7,910,1.0,0,0,480,3,0,1.0
3200,8,3200,2.5,0,0,0,4,0,2.0
2010,7,2010,2.5,0,0,0,3,0,2.0
1960,7,1960,3.25,0,0,0,4,0,2.0
1900,7,1290,1.0,0,0,610,4,0,1.0
2440,8,2440,2.5,0,0,0,4,0,2.0
1440,7,1440,2.5,0,0,0,3,0,2.0
1510,7,1150,2.5,0,0,360,3,0,1.0
930,6,930,1.0,0,0,0,2,0,1.0
2560,8,2560,2.5,0,0,0,3,0,2.0
1700,6,850,2.0,0,0,850,4,0,1.0
3210,10,2530,2.5,1,0,680,3,0,2.0
2961,9,2961,2.5,0,0,0,4,0,2.0
2300,8,2300,2.5,0,0,0,4,0,2.0
2430,8,2430,2.5,0,0,0,3,0,2.0
3490,9,2570,3.5,1,0,920,3,0,2.0
3060,7,1530,2.25,0,0,1530,4,0,1.0
1340,5,920,2.0,0,0,420,3,0,1.0
2320,9,1790,2.5,0,0,530,3,0,1.0
1200,7,1200,1.0,0,0,0,3,0,1.0
1430,7,1130,1.5,0,0,300,4,0,1.5
1650,8,1650,2.5,0,0,0,3,0,3.0
1690,7,1690,1.75,0,0,0,3,0,1.0
2270,6,1270,2.0,0,0,1000,3,0,1.0
3140,9,3140,2.75,0,0,0,4,0,2.0
1500,5,880,1.0,0,0,620,2,0,1.5
4780,11,4780,4.0,0,0,0,5,0,2.0
2570,8,2570,2.5,0,0,0,4,0,2.0
2380,9,2240,2.25,0,0,140,4,0,2.0
940,7,940,1.0,0,0,0,2,0,1.0
1210,7,1210,1.0,0,0,0,3,0,1.0
1390,7,1390,2.0,0,0,0,3,0,1.0
2430,8,1630,2.25,0,0,800,4,0,1.5
3680,8,2320,3.0,0,0,1360,4,0,1.5
2120,7,1600,1.75,0,0,520,4,0,1.0
3250,8,2030,2.5,0,2,1220,4,0,1.0
2580,9,1300,2.0,0,0,1280,4,0,1.0
1590,8,1590,2.0,0,0,0,4,0,1.0
2920,8,1520,2.0,0,0,1400,4,0,1.0
1880,7,880,1.75,0,0,1000,3,0,1.0
1020,7,1020,1.0,0,0,0,3,0,1.0
1830,8,1830,2.5,0,0,0,3,0,2.0
2360,7,1180,1.75,0,0,1180,4,0,1.0
3410,8,3410,2.75,0,0,0,3,0,1.5
1350,8,1350,1.75,0,0,0,2,0,1.0
2130,8,2130,2.25,1,0,0,4,0,2.0
2500,7,1420,2.75,0,0,1080,4,0,1.5
2580,7,1710,2.75,0,0,870,4,0,1.5
2740,8,1370,1.5,0,0,1370,4,0,1.0
3380,8,2200,2.5,0,0,1180,3,0,2.0
1000,7,1000,1.0,0,0,0,2,0,1.0
3960,10,2600,3.25,0,3,1360,3,0,2.0
1010,8,1010,1.5,0,0,0,2,0,3.0
2660,9,2660,2.5,0,0,0,4,0,2.0
1380,7,1380,2.0,0,0,0,3,0,1.0
4460,9,2550,3.5,1,0,1910,4,0,1.0
2410,9,1930,1.0,0,0,480,2,0,2.0
1580,7,1580,1.75,0,0,0,3,0,1.0
1646,7,1646,2.25,0,0,0,3,0,2.0
1060,7,1060,1.75,0,0,0,2,0,1.0
1260,7,1260,1.75,0,0,0,3,0,1.0
6930,11,4310,5.5,1,0,2620,4,0,1.0
1010,7,1010,1.5,0,0,0,2,0,3.0
2150,8,1610,1.75,0,0,540,3,0,1.0
880,7,880,1.0,0,0,0,2,0,1.0
2780,10,2780,3.75,0,0,0,3,0,2.0
3680,10,3680,3.25,0,0,0,5,0,1.5
1380,5,1380,1.75,0,0,0,3,0,1.0
2460,7,1410,1.75,0,4,1050,4,1,1.0
5774,11,4490,5.0,0,2,1284,5,0,1.0
2140,8,1290,2.5,0,0,850,3,0,1.0
1940,8,1940,2.5,0,0,0,4,0,2.0
2730,7,1390,2.25,0,0,1340,3,0,1.0
3250,9,3250,2.25,0,0,0,4,0,2.0
1800,8,1800,2.25,0,0,0,4,0,2.0
1570,7,1570,1.5,0,0,0,3,0,2.0
1060,7,1060,2.0,0,0,0,3,0,1.0
1250,7,1250,1.5,0,0,0,3,0,1.0
1660,7,1660,2.0,0,0,0,4,0,1.5
3450,10,2570,3.75,0,0,880,4,0,2.0
1550,7,1550,1.0,0,0,0,4,0,1.5
3240,10,3240,2.5,0,0,0,4,0,2.0
3450,9,3450,2.5,0,0,0,4,0,2.0
1990,8,1210,2.25,0,0,780,4,0,1.0
1750,8,1010,2.0,0,0,740,3,0,1.0
1430,7,1430,1.75,0,0,0,3,0,1.0
5220,11,3550,3.5,0,3,1670,4,0,2.0
2120,9,1420,2.25,1,1,700,3,0,2.0
1660,7,1660,1.75,0,0,0,4,0,1.5
2120,8,2120,2.5,0,0,0,4,0,2.0
1880,8,1040,2.0,0,0,840,3,0,1.0
1560,6,780,1.75,0,0,780,3,0,1.0
1490,7,1190,1.5,0,0,300,2,0,1.5
3080,10,3080,3.0,0,1,0,4,0,2.0
1800,7,1800,1.5,0,0,0,4,0,1.5
3240,9,2730,2.25,1,0,510,4,0,2.0
1020,7,720,2.5,0,0,300,3,0,2.0
2350,8,2350,2.25,0,0,0,4,0,2.0
1620,7,1220,2.25,0,0,400,3,0,1.0
3920,10,3920,3.5,0,0,0,4,0,2.0
1190,6,1190,1.0,0,0,0,3,0,1.0
2190,8,2190,2.5,0,0,0,4,0,2.0
1970,8,1390,2.25,0,0,580,4,0,1.0
2500,8,1380,2.75,0,0,1120,4,0,1.0
950,6,950,1.0,0,0,0,3,0,1.0
2100,8,2100,2.5,0,0,0,4,0,2.0
2290,9,2290,2.5,0,0,0,4,0,2.0
1570,7,1570,1.0,0,0,0,4,0,1.5
2410,9,2410,2.0,0,0,0,4,0,2.0
1850,7,1120,1.75,0,0,730,4,0,1.0
2020,7,2020,2.5,0,0,0,4,0,2.0
950,7,950,1.0,0,0,0,2,0,1.0
1180,7,1180,2.25,0,0,0,2,0,2.0
2640,9,1320,1.75,1,3,1320,3,0,1.0
1260,7,810,2.0,0,0,450,3,0,2.0
2530,7,1690,2.25,0,0,840,4,0,1.5
1090,7,1090,1.0,0,0,0,2,0,1.0
2780,9,2780,2.5,0,3,0,4,0,2.0
1200,6,1200,1.0,0,3,0,4,1,1.0
1640,8,1640,2.25,0,0,0,3,0,2.0
1060,7,1060,1.0,0,0,0,3,0,1.0
2390,7,2390,2.0,0,0,0,6,0,1.5
960,7,960,1.0,0,0,0,2,0,1.0
2800,9,2800,2.5,0,0,0,4,0,2.0
4490,10,3090,3.75,1,0,1400,4,0,2.0
2560,8,1380,2.0,0,1,1180,3,0,1.0
4400,9,2250,2.75,0,3,2150,5,0,1.0
3330,10,3330,4.0,1,0,0,4,0,1.0
2330,10,1730,3.25,0,2,600,3,0,1.0
920,6,920,1.0,0,0,0,2,0,1.0
2260,8,2260,2.5,0,0,0,4,0,2.0
4300,8,2800,3.25,0,0,1500,8,0,2.0
1560,6,860,1.75,0,0,700,4,0,1.0
1370,6,1370,1.75,0,0,0,4,0,1.0
1700,7,850,2.0,1,0,850,4,0,1.0
2010,7,2010,1.5,0,0,0,2,0,2.0
3280,9,2440,2.5,0,1,840,3,0,2.0
1530,7,1070,2.25,0,0,460,3,0,1.0
1810,7,1810,3.0,0,0,0,4,0,2.0
2420,9,2000,2.25,0,4,420,4,0,1.0
4520,10,3270,3.75,1,2,1250,4,0,1.5
1720,7,1720,1.0,0,2,0,4,0,1.5
3530,10,3530,3.5,1,0,0,4,0,2.0
1590,8,1310,1.5,0,2,280,3,0,1.0
2770,7,1770,2.75,0,0,1000,3,0,1.5
2120,9,2120,2.5,0,0,0,4,0,2.0
2710,10,2710,2.5,0,0,0,3,0,1.0
1550,8,1550,2.25,1,0,0,3,0,2.0
1040,7,1040,1.0,0,0,0,2,0,1.0
940,7,940,1.0,0,0,0,2,0,1.0
2400,9,2400,2.5,0,0,0,3,0,1.0
2140,9,2140,2.25,0,0,0,3,0,2.0
1880,7,1880,1.75,0,0,0,3,0,1.0
1370,6,1370,1.75,0,0,0,3,0,1.0
3020,9,2020,2.5,1,0,1000,4,0,1.5
800,6,670,1.0,0,0,130,2,0,1.0
1250,7,1150,1.0,0,0,100,3,0,1.5
1910,8,1110,1.75,0,3,800,3,0,1.0
1889,7,1889,2.5,0,0,0,4,0,2.0
1140,7,1140,1.5,0,0,0,3,0,1.0
2350,9,2350,2.5,1,0,0,5,0,2.0
1560,8,1390,1.0,0,0,170,3,0,1.5
1122,5,1122,1.0,0,0,0,3,0,1.5
1700,7,1250,2.25,0,0,450,3,0,1.0
1900,7,1250,2.25,0,0,650,3,0,1.0
3650,10,2360,2.75,1,0,1290,5,0,1.0
1390,6,1390,1.0,0,0,0,3,0,1.5
2010,7,1210,2.0,0,0,800,3,0,1.0
2720,8,2720,3.0,0,0,0,5,0,2.0
1780,7,1780,2.5,0,0,0,3,0,2.0
1690,7,1690,2.0,0,0,0,4,0,1.0
1430,7,1430,1.75,0,0,0,2,0,1.0
1530,7,1150,2.25,0,0,380,3,0,1.0
1920,8,1920,1.5,0,0,0,4,0,1.0
1300,7,1300,1.5,0,0,0,3,0,1.0
2510,8,2510,2.5,0,0,0,3,0,2.0
1760,7,1070,1.75,0,2,690,4,0,1.0
1290,7,1290,1.0,0,0,0,3,0,1.0
3110,9,3110,2.75,0,0,0,4,0,2.0
1460,7,1460,2.0,0,0,0,3,0,2.0
3130,9,3130,2.5,0,0,0,4,0,2.0
3130,7,3130,1.75,0,0,0,4,0,2.0
1640,7,1290,1.5,0,0,350,3,0,1.0
1480,7,1100,1.5,0,0,380,3,0,1.0
1180,6,590,2.0,0,1,590,2,0,1.0
1160,8,1160,1.0,0,0,0,3,0,1.0
2240,9,2240,2.5,0,0,0,4,0,2.0
3510,9,1930,2.5,0,0,1580,4,0,1.0
2210,8,2210,2.5,0,0,0,4,0,2.0
2260,9,2260,2.25,0,0,0,3,0,1.0
1100,7,1100,1.75,0,0,0,3,0,1.0
3200,7,3200,2.5,0,0,0,4,0,2.0
1370,8,1080,2.5,0,0,290,2,0,2.0
2380,7,1300,2.75,0,0,1080,5,0,1.0
3130,10,3130,3.5,0,0,0,4,0,3.0
1890,7,1890,1.75,0,0,0,3,0,1.0
1460,6,1290,1.0,0,0,170,5,0,1.5
3030,8,1670,3.0,0,0,1360,6,0,1.0
960,7,960,1.0,0,0,0,3,0,1.0
1320,8,660,2.5,0,0,660,2,0,1.0
4040,11,4040,3.0,0,0,0,4,0,2.0
1190,8,920,1.5,0,0,270,3,0,2.0
2040,7,1120,2.0,0,1,920,3,0,1.0
2280,8,2280,2.5,0,0,0,4,0,2.0
2260,8,1660,1.75,0,0,600,4,0,1.0
1480,8,1000,2.0,0,0,480,3,0,2.0
2670,8,2670,2.75,0,0,0,5,0,2.0
1570,8,1570,2.0,0,0,0,3,0,1.5
2040,8,2040,2.5,0,0,0,4,0,2.0
3700,9,3700,2.5,0,0,0,4,0,2.0
2300,7,1380,2.25,0,0,920,4,0,1.0
2250,8,2250,1.75,0,0,0,3,0,1.0
4020,8,2170,3.25,0,0,1850,5,0,1.0
2820,9,2820,2.5,0,0,0,3,0,2.0
1250,7,1250,1.0,0,0,0,3,0,1.0
2790,9,2790,2.5,0,0,0,4,0,2.0
1500,7,1170,2.25,0,0,330,3,0,1.0
1610,7,1610,1.75,0,0,0,3,0,1.0
3420,8,2700,3.5,0,2,720,5,0,2.0
1730,8,1270,1.5,0,0,460,3,0,2.0
2090,8,1230,1.75,0,0,860,3,0,1.0
3500,10,2560,3.5,1,0,940,4,0,2.0
1610,7,1610,2.25,0,0,0,2,0,2.0
2060,7,1350,1.75,0,0,710,3,0,1.0
1740,7,990,2.0,0,0,750,3,0,1.0
1150,5,1150,1.0,0,0,0,3,0,1.0
2570,9,2570,2.5,0,0,0,4,0,2.0
1580,7,1180,2.25,0,0,400,3,0,1.0
2050,7,2050,2.5,0,0,0,4,0,2.0
2070,7,1270,2.5,0,0,800,5,0,1.0
3170,9,3170,2.75,1,0,0,3,0,1.0
2110,7,1360,2.25,0,0,750,3,0,1.0
2470,8,1540,2.25,0,2,930,3,0,2.0
1250,7,1250,1.0,0,0,0,3,0,1.0
710,5,710,1.0,0,0,0,2,0,1.0
2210,8,1410,2.5,0,2,800,4,0,1.0
1150,7,1150,1.75,0,0,0,2,0,2.0
3130,9,3130,2.75,0,0,0,4,0,2.0
2811,9,2811,2.5,0,0,0,4,0,2.0
2605,9,2090,2.5,1,2,515,3,0,2.0
1430,7,1250,1.5,0,3,180,3,0,1.0
1030,7,1030,1.0,0,0,0,3,0,1.0
1520,7,1520,2.0,0,0,0,4,0,1.0
2100,7,1050,1.0,0,0,1050,4,0,1.0
1380,8,1030,1.0,0,0,350,2,0,1.0
1030,6,1030,1.0,0,0,0,4,0,1.0
1720,7,1720,1.0,0,0,0,3,0,1.0
920,6,920,1.0,0,0,0,1,0,1.5
2410,8,2060,1.75,0,3,350,4,0,2.0
980,7,980,1.0,0,0,0,2,0,1.0
2420,8,1690,2.5,0,4,730,3,0,2.0
1590,7,1060,2.25,0,0,530,3,0,1.0
2860,10,2130,2.25,0,3,730,4,0,2.0
1750,7,1750,1.0,0,0,0,3,0,1.0
1370,7,970,1.75,0,0,400,3,0,1.0
710,6,710,1.0,0,0,0,2,0,1.0
1100,7,1100,1.0,0,0,0,2,0,1.0
2780,8,1190,2.0,0,3,1590,4,0,1.0
770,7,770,1.0,0,0,0,2,0,1.0
1280,7,1280,1.5,0,0,0,3,0,1.0
1480,8,1480,2.5,0,0,0,3,0,2.0
1920,8,1920,2.5,0,0,0,4,0,2.0
1730,7,1230,1.75,0,0,500,4,0,1.0
2090,7,1090,1.75,0,0,1000,2,0,1.0
1250,7,1250,1.5,0,0,0,3,0,1.0
2790,9,1680,2.75,0,0,1110,5,0,1.0
1870,7,1870,2.0,0,0,0,6,0,1.0
1320,7,1320,2.0,0,0,0,3,0,1.0
1510,7,1510,1.5,0,0,0,3,0,1.0
1890,8,1890,2.25,0,0,0,4,0,1.0
1710,7,1710,2.0,0,0,0,4,0,1.5
1070,6,1070,1.75,0,0,0,3,0,1.0
1730,7,1060,2.0,0,0,670,4,0,1.0
3880,7,3880,3.0,0,0,0,5,0,2.0
1890,8,1890,2.0,0,3,0,3,0,1.0
3010,10,3010,2.75,0,0,0,5,0,2.0
1860,7,1860,2.0,0,0,0,3,0,2.0
1240,8,1000,2.25,0,0,240,2,0,2.0
2000,9,2000,2.5,0,0,0,3,0,2.0
5480,9,4430,4.5,0,3,1050,6,0,2.0
2930,8,1680,2.0,0,2,1250,2,0,1.0
1450,7,1450,1.0,0,0,0,3,0,1.0
2560,7,1970,1.75,0,0,590,3,0,1.0
1150,7,1150,1.5,0,0,0,3,0,1.0
2590,9,2590,2.5,0,0,0,4,0,2.0
3488,10,3488,2.75,0,0,0,4,0,2.0
1930,8,1930,2.25,0,0,0,4,0,1.0
2810,8,1610,2.25,0,0,1200,4,0,1.0
1980,8,1980,2.5,0,0,0,4,0,2.0
1640,7,1640,1.0,0,0,0,4,0,1.5
1980,6,990,1.75,1,0,990,4,0,1.0
1220,6,1220,1.0,0,0,0,3,0,1.5
3050,8,3050,2.5,0,0,0,4,0,2.0
2200,6,1400,1.75,0,0,800,4,0,1.5
2460,8,1940,3.75,0,0,520,3,0,1.0
1320,7,1320,2.5,0,0,0,3,0,2.0
2310,8,2310,2.5,0,0,0,4,0,2.0
700,6,700,1.0,0,0,0,2,0,1.0
1590,8,1590,2.75,1,0,0,4,0,1.5
1080,7,880,1.75,0,0,200,3,0,1.0
2520,8,1560,3.0,0,0,960,3,0,1.5
1570,7,1570,2.5,0,0,0,3,0,2.0
1270,8,1270,1.75,0,0,0,2,0,2.0
3020,7,3020,3.5,0,0,0,6,0,2.0
1260,7,1260,1.5,0,0,0,4,0,1.5
1820,7,1300,2.0,0,0,520,4,0,1.0
1140,7,840,1.5,0,0,300,3,0,1.0
2040,8,2040,2.5,0,0,0,3,0,2.0
1050,7,1050,1.5,0,0,0,3,0,1.0
980,7,980,1.0,0,0,0,3,0,1.0
1240,8,1240,1.0,0,0,0,3,0,1.5
1200,5,1200,1.0,0,0,0,4,0,1.0
1450,7,1180,1.75,0,0,270,4,0,1.5
2990,9,1800,2.5,0,2,1190,5,0,1.0
2710,8,1650,3.5,0,0,1060,3,0,2.0
1180,7,1120,1.5,0,0,60,2,0,2.0
1950,7,1950,2.5,0,0,0,3,0,2.0
2150,7,1240,2.25,0,0,910,4,0,1.0
1050,8,1050,1.75,0,0,0,2,0,1.0
1090,6,890,1.0,0,0,200,3,0,1.0
1570,8,1570,1.0,0,1,0,2,0,1.5
2980,8,1730,2.75,0,0,1250,5,0,1.0
2620,7,1310,2.5,0,3,1310,3,0,1.0
3130,8,1690,2.75,0,4,1440,3,1,1.0
1860,7,1240,1.5,0,0,620,3,0,1.0
1470,6,1470,2.0,0,0,0,3,0,1.0
820,5,820,0.75,0,0,0,1,0,1.0
1250,7,1250,1.5,0,0,0,3,0,1.0
2480,10,2480,3.5,0,0,0,3,0,2.0
2040,7,2040,2.5,0,0,0,4,0,2.0
1210,8,1210,1.75,0,0,0,2,0,2.0
1780,7,1320,1.5,0,0,460,4,0,1.0
2630,9,2630,2.5,0,0,0,3,0,2.0
1720,9,1720,1.75,0,0,0,3,0,1.0
1240,8,1240,2.5,0,0,0,3,0,3.0
1800,7,1800,2.5,0,0,0,3,0,2.0
1380,7,1380,1.0,0,0,0,3,0,1.0
4370,11,3270,3.5,1,0,1100,5,0,2.0
2310,9,2310,2.5,0,0,0,4,0,2.0
2400,8,2400,3.0,0,3,0,5,0,2.0
2280,7,1210,2.5,0,0,1070,8,0,1.5
1830,7,1830,2.5,0,0,0,4,0,2.0
2230,8,1850,3.0,0,0,380,3,0,2.5
1530,7,1030,2.25,0,0,500,4,0,1.0
1590,7,1040,2.0,0,0,550,4,0,1.0
1520,7,1520,3.0,0,0,0,3,0,2.0
2580,8,1780,2.75,1,1,800,4,0,2.0
2044,9,2044,2.5,1,0,0,3,0,2.0
2230,8,1630,2.5,1,0,600,4,0,2.0
790,7,790,1.0,0,0,0,2,0,1.0
1040,7,940,1.0,0,0,100,2,0,1.0
1970,7,1130,2.0,0,0,840,4,0,1.5
2320,8,2320,2.5,0,0,0,2,0,1.0
2370,8,1770,1.75,0,2,600,4,0,1.5
2590,8,2590,3.0,0,0,0,4,0,2.0
1430,7,1430,2.0,0,0,0,3,0,1.0
1450,7,1450,2.0,0,0,0,4,0,1.0
1690,7,1690,1.75,0,0,0,4,0,1.0
1405,8,1140,2.0,0,0,265,2,0,2.0
1280,7,850,1.5,0,0,430,3,0,1.0
840,7,840,1.5,0,0,0,2,0,2.0
1960,8,1960,2.25,0,0,0,3,0,1.0
1050,7,1050,1.0,0,0,0,3,0,1.5
1790,8,1350,1.75,0,2,440,3,0,1.0
900,5,900,1.0,0,0,0,1,0,1.0
2480,7,2050,3.0,0,0,430,4,0,1.0
1830,7,1830,2.25,0,0,0,4,0,2.0
1770,8,1770,2.5,0,0,0,3,0,2.0
2720,8,1650,2.75,0,0,1070,4,0,1.0
2190,9,2190,2.5,1,3,0,3,0,2.0
1140,7,1010,1.0,0,0,130,3,0,1.0
1140,7,1140,1.75,0,0,0,3,0,1.0
1350,7,1080,2.5,0,0,270,3,0,2.0
2320,9,1920,2.25,0,4,400,2,0,1.5
1750,7,1230,1.75,0,0,520,3,0,1.5
2240,7,1440,2.25,0,0,800,3,0,1.0
2860,8,1710,1.75,0,0,1150,4,0,1.0
2080,8,2080,2.5,0,0,0,3,0,2.0
2557,7,2557,3.25,0,2,0,4,0,2.0
3080,9,2230,3.25,1,2,850,5,0,1.0
1660,7,1100,1.0,0,0,560,3,0,1.0
1910,8,1910,1.75,0,0,0,3,0,1.0
1580,7,1580,1.75,0,0,0,3,0,1.0
1580,7,1580,1.5,0,0,0,3,0,1.0
1740,6,870,2.0,0,0,870,4,0,1.0
3190,9,3190,2.75,0,0,0,5,0,2.0
2990,9,1560,2.5,0,4,1430,3,1,1.0
1964,9,1964,2.25,0,0,0,4,0,2.0
1580,7,1080,2.75,0,0,500,4,0,1.0
1920,7,1060,2.25,0,0,860,3,0,1.0
1560,8,1560,1.75,0,3,0,3,0,1.0
1122,6,1122,1.0,0,0,0,2,0,1.0
3110,9,3110,2.5,0,0,0,4,0,2.0
1770,8,1770,1.75,0,0,0,4,0,1.0
2620,7,1820,2.25,0,0,800,4,0,1.0
1750,8,1750,2.25,0,0,0,3,0,2.0
750,4,550,1.75,0,0,200,1,0,1.0
2290,8,2290,2.75,0,0,0,4,0,2.0
1580,8,1580,1.0,0,0,0,3,0,1.0
1240,7,1240,1.75,0,0,0,3,0,1.0
1710,7,1030,2.0,0,0,680,4,0,1.0
1150,7,1150,1.75,0,0,0,3,0,1.0
2180,8,1090,1.75,0,3,1090,3,0,1.0
1300,7,820,1.75,0,0,480,3,0,1.0
1250,7,1250,1.75,0,0,0,4,0,1.0
2180,8,2180,2.25,0,0,0,3,0,2.0
2130,7,2130,2.0,0,0,0,3,0,2.0
1910,8,1160,2.5,0,0,750,4,0,1.0
3080,7,1540,2.5,0,0,1540,4,0,1.0
1180,7,880,1.75,0,0,300,2,0,1.0
1480,7,1480,2.25,0,0,0,3,0,1.5
2260,7,2260,3.0,0,0,0,4,0,2.0
1380,7,940,1.75,0,0,440,3,0,1.0
3640,11,3640,2.5,0,0,0,4,0,2.0
1760,6,1040,1.75,0,0,720,2,0,1.5
1900,8,1900,2.0,0,0,0,4,0,1.0
1980,8,1980,2.5,0,0,0,4,0,2.0
1610,7,1610,2.5,0,0,0,3,0,2.0
1320,7,1320,1.0,0,0,0,3,0,1.0
1180,6,820,1.0,0,0,360,3,0,1.0
1700,6,850,1.75,0,0,850,2,0,1.0
860,6,860,1.0,0,0,0,2,0,1.0
1440,7,1440,1.75,0,0,0,3,0,1.0
3230,9,3230,2.5,0,0,0,4,0,2.0
2370,9,2080,2.5,0,2,290,4,0,2.0
2870,8,2870,2.5,1,0,0,5,0,2.0
2588,8,2588,2.5,0,0,0,3,0,2.0
2190,8,2190,2.25,0,0,0,3,0,1.0
1890,7,1890,2.5,0,0,0,3,0,2.0
3060,8,3060,2.5,0,0,0,4,0,1.5
2570,8,2570,2.25,0,0,0,4,0,2.0
2550,8,1750,1.5,0,0,800,6,0,1.0
2820,8,1930,3.25,0,0,890,6,0,2.0
1470,7,1160,2.25,0,0,310,3,0,1.0
1150,7,1150,1.0,0,0,0,2,0,1.0
3400,8,2500,3.5,0,0,900,4,0,2.0
1290,7,1290,1.0,0,0,0,2,0,2.0
1780,7,1780,2.5,0,0,0,4,0,2.0
1520,5,1520,1.0,0,0,0,4,0,1.0
1380,7,790,1.5,0,0,590,3,0,1.0
1650,8,1650,1.75,0,0,0,3,0,1.0
1520,7,1040,1.5,0,0,480,3,0,1.0
2980,8,2980,2.5,0,0,0,4,0,2.0
1140,7,1140,1.5,0,0,0,3,0,1.0
1550,7,1210,1.75,0,0,340,3,0,1.0
1740,8,1740,2.25,0,0,0,4,0,2.0
1890,7,1090,1.5,0,0,800,3,0,1.0
3090,10,3090,2.5,0,0,0,3,0,2.0
1580,7,1180,1.0,0,0,400,3,0,1.0
2000,7,2000,1.75,0,0,0,5,0,2.0
680,6,680,1.0,0,0,0,2,0,1.0
1850,6,1270,1.75,0,0,580,4,0,1.0
3560,10,3560,2.5,0,0,0,3,0,2.0
1590,8,1590,2.5,0,0,0,2,0,2.0
3340,9,2470,2.5,0,1,870,4,0,2.0
3360,10,3360,2.5,0,0,0,4,0,2.0
2640,8,2640,2.5,0,0,0,4,0,2.0
1770,7,1770,2.5,0,0,0,3,0,2.0
2430,7,2430,1.0,0,0,0,3,0,1.0
1430,7,1300,1.0,1,0,130,2,0,1.5
2720,8,1710,2.75,0,0,1010,5,0,1.5
1350,7,1070,1.5,0,0,280,2,0,1.0
1830,7,1830,2.5,0,0,0,4,0,2.0
1800,7,1800,1.75,0,0,0,3,0,1.0
810,6,810,1.0,0,0,0,2,0,1.0
1930,8,1930,2.0,0,0,0,2,0,1.0
2050,7,1300,2.0,0,0,750,4,0,1.0
1660,7,1260,1.0,0,0,400,3,0,1.0
2150,8,2150,2.5,0,0,0,4,0,2.0
410,4,410,0.75,0,0,0,1,0,1.0
3770,9,2710,3.25,0,0,1060,4,0,2.0
2330,7,1260,1.75,0,2,1070,4,0,1.0
1440,7,1440,2.5,0,0,0,3,0,2.0
2050,8,1770,2.25,0,2,280,4,0,2.0
1840,6,1080,2.0,0,0,760,4,0,1.5
2500,8,1300,1.75,0,0,1200,3,0,1.0
2050,8,2050,2.5,0,0,0,3,0,2.0
1270,7,1270,1.0,0,0,0,3,0,1.0
1480,7,1480,1.75,0,0,0,3,0,2.0
1570,7,1080,1.75,0,0,490,3,0,1.0
1900,7,950,2.0,0,0,950,3,0,1.0
1260,7,1260,1.75,0,0,0,3,0,1.0
1470,7,1280,1.5,0,0,190,3,0,1.0
1560,6,960,2.0,0,0,600,4,0,1.0
3330,8,3330,3.25,0,0,0,4,0,2.0
1820,7,1130,1.75,0,0,690,6,0,1.0
3830,9,2630,3.0,0,1,1200,5,0,2.0
2150,8,2150,2.5,0,0,0,3,0,2.0
3870,10,3870,2.5,0,0,0,4,0,2.0
1480,8,1480,2.5,0,0,0,3,0,3.0
2000,6,1000,1.0,0,0,1000,3,0,1.0
1740,7,1110,2.25,0,0,630,3,0,1.0
1300,8,1300,2.5,0,0,0,3,0,2.0
2290,9,2290,2.5,0,0,0,3,0,2.0
1610,7,1610,2.0,0,0,0,4,0,1.0
2130,7,1420,3.25,0,1,710,3,0,2.0
2300,8,1550,2.75,0,3,750,4,0,1.0
3360,9,3360,2.5,0,0,0,4,0,2.0
1900,8,1900,1.75,0,0,0,3,0,1.0
1130,7,1130,1.0,0,0,0,3,0,1.0
2150,9,2150,2.5,1,0,0,3,0,2.0
1830,7,1830,1.75,0,0,0,3,0,2.0
2300,8,2300,2.25,0,0,0,3,0,2.0
1680,7,1680,2.5,0,0,0,4,0,2.0
1420,5,1040,1.75,0,0,380,4,0,1.0
3310,9,2290,3.5,0,0,1020,4,0,2.0
1170,6,1170,1.0,0,0,0,4,0,1.0
2110,8,2110,2.5,0,0,0,3,0,2.0
1190,7,1190,1.0,0,0,0,2,0,1.0
1460,7,1460,1.0,0,0,0,3,0,1.0
1280,7,1280,1.0,0,0,0,3,0,1.0
1390,7,1390,1.75,0,0,0,3,0,1.0
960,7,960,1.5,0,0,0,3,0,1.0
2740,8,1370,1.75,0,2,1370,4,0,1.0
3390,8,1640,2.25,0,0,1750,4,0,1.0
1190,6,890,1.0,0,0,300,4,0,1.0
2460,9,2460,2.75,0,0,0,3,0,2.0
2380,8,2040,2.25,0,0,340,3,0,1.0
1860,6,1300,1.75,0,0,560,3,0,1.5
1140,7,1140,1.0,0,0,0,3,0,1.5
3140,7,2300,3.25,0,0,840,4,0,2.0
1480,7,1480,1.75,0,0,0,3,0,1.0
3650,7,2940,2.75,0,0,710,4,0,2.0
3650,10,3370,2.5,0,4,280,5,0,2.0
2670,8,2670,2.5,0,0,0,3,0,2.0
4120,11,4120,3.0,0,0,0,4,0,2.0
1870,8,1870,2.0,0,0,0,2,0,1.0
2540,7,2540,2.5,0,0,0,4,0,1.0
1300,7,1300,2.0,0,0,0,3,0,1.0
2390,9,2390,2.5,0,0,0,3,0,2.0
4410,9,3400,3.0,0,0,1010,4,0,2.0
1460,7,1460,2.0,0,0,0,3,0,1.0
5030,11,3250,4.5,1,2,1780,4,0,2.0
720,6,720,1.0,0,0,0,1,0,1.0
1850,7,1850,2.0,0,0,0,4,0,1.0
2360,6,1180,1.0,0,2,1180,2,0,1.0
700,5,700,1.0,0,0,0,2,0,1.0
1420,7,980,1.75,0,0,440,3,0,1.0
1960,7,1960,2.5,0,0,0,3,0,2.0
1680,8,1680,1.75,0,0,0,3,0,1.0
1700,7,1700,2.5,0,0,0,3,0,2.0
1540,8,1540,2.0,0,0,0,2,0,1.5
2040,7,2040,2.5,0,0,0,4,0,2.0
2290,9,2290,2.5,0,0,0,2,0,2.0
1200,7,1200,1.0,0,0,0,3,0,1.5
1050,8,720,2.0,0,0,330,2,0,2.0
1397,7,1397,1.75,0,0,0,3,0,1.0
1830,7,1830,2.5,0,0,0,3,0,2.0
1870,7,1120,1.0,0,0,750,3,0,1.0
4870,10,3470,2.5,0,0,1400,5,0,2.0
2710,7,1410,2.25,0,0,1300,5,0,1.0
1070,7,880,1.0,0,0,190,2,0,1.0
1290,7,970,1.0,0,0,320,3,0,1.0
3220,9,2420,2.5,0,0,800,4,0,2.0
2560,7,1350,2.0,0,0,1210,4,0,1.0
1870,7,1870,2.5,0,0,0,3,0,2.0
1610,7,1110,2.25,0,0,500,3,0,1.0
1260,7,1260,1.0,0,0,0,4,0,1.5
2260,8,1430,2.0,0,0,830,4,0,1.0
1630,7,1100,1.75,0,0,530,3,0,1.0
2210,7,1400,1.75,0,0,810,3,0,1.0
1040,7,1040,1.0,0,0,0,3,0,1.0
1570,8,1570,1.75,0,0,0,3,0,1.0
2400,8,2400,2.5,0,0,0,3,0,2.0
880,6,760,1.0,0,0,120,2,0,1.0
1660,8,1660,2.0,0,0,0,4,0,1.0
1570,7,1570,1.0,0,3,0,2,0,1.0
3270,9,3270,2.75,1,0,0,4,0,2.0
2170,8,2170,2.5,0,0,0,3,0,2.5
1930,8,1930,2.5,0,0,0,3,0,2.0
3600,9,3600,2.5,0,0,0,4,0,2.0
1900,8,1450,1.75,0,2,450,3,0,1.0
1710,7,1160,1.5,0,1,550,2,0,1.0
1020,7,1020,1.0,0,0,0,3,0,1.0
1150,6,1150,1.0,0,0,0,3,0,1.0
2200,8,1100,2.75,1,0,1100,4,0,1.0
1450,7,1450,2.25,0,0,0,3,0,2.0
1300,7,1300,1.5,0,0,0,3,0,1.0
1980,7,1980,2.5,0,0,0,4,0,2.0
3070,10,3070,2.5,0,0,0,4,0,2.0
1070,7,1070,1.0,0,0,0,3,0,1.0
3180,9,3180,4.0,0,0,0,6,0,2.0
1650,7,1650,1.75,0,0,0,3,0,1.0
2220,7,2220,2.5,0,0,0,4,0,2.0
2940,10,2440,3.25,0,3,500,3,0,3.0
1310,8,1310,1.5,0,0,0,3,0,1.0
2120,9,1720,1.75,0,1,400,3,0,1.0
2830,8,2830,2.75,0,0,0,4,0,2.0
2020,7,1220,2.0,0,0,800,3,0,1.0
3670,10,3670,2.5,0,0,0,4,0,2.0
1870,7,1350,2.25,0,0,520,3,0,1.0
1800,7,1800,1.0,0,0,0,2,0,1.0
1150,6,1150,1.0,0,0,0,2,0,1.0
750,6,750,1.0,0,0,0,2,0,1.0
2170,8,1650,2.5,1,0,520,4,0,1.0
1520,7,1520,1.75,0,0,0,4,0,1.0
2480,8,2480,2.5,0,0,0,3,0,2.0
3090,10,3090,2.5,1,2,0,3,0,2.0
2380,8,2380,2.0,0,2,0,4,0,2.0
1720,7,1720,2.5,0,0,0,3,0,2.0
1540,8,1540,2.5,0,0,0,3,0,2.0
2240,7,2240,2.25,0,0,0,4,0,2.0
3020,8,1540,2.75,0,0,1480,4,0,1.0
3820,9,2870,3.5,0,3,950,3,0,2.0
3140,9,2140,3.0,1,0,1000,4,0,1.0
910,6,910,1.5,0,0,0,3,0,1.0
2920,8,2920,3.0,0,0,0,5,0,2.0
3410,11,3410,2.5,0,0,0,3,0,2.0
2370,9,1590,2.25,0,0,780,3,0,1.0
1782,7,1782,2.5,0,0,0,3,0,3.0
2250,8,2250,2.5,0,0,0,3,0,2.0
1610,8,1610,2.0,1,0,0,4,0,1.0
1780,7,1340,2.25,0,2,440,3,0,1.0
1740,7,1740,1.5,0,0,0,3,0,1.0
2070,9,2070,2.5,1,0,0,3,0,2.0
1970,8,1970,3.0,0,0,0,3,0,1.0
2240,7,2240,2.25,0,0,0,5,0,2.0
2000,8,2000,2.5,0,0,0,4,0,2.0
1770,7,1770,2.5,0,0,0,4,0,2.0
2030,7,2030,2.0,0,0,0,4,0,1.0
2460,9,2460,2.5,0,0,0,4,0,2.0
910,7,910,1.0,0,0,0,2,0,1.0
2260,8,1690,1.75,0,0,570,4,0,1.0
2120,7,1490,2.25,0,0,630,4,0,1.0
1780,7,1210,1.75,0,0,570,3,0,1.0
4020,8,2010,4.0,0,0,2010,8,0,1.0
2090,7,1390,1.75,0,0,700,3,0,1.0
2870,10,2870,2.5,0,0,0,3,0,2.0
1760,7,1060,2.0,0,0,700,4,0,1.0
1750,7,1050,2.0,0,0,700,4,0,1.0
2310,8,2310,2.5,0,0,0,4,0,2.0
2770,9,2770,2.5,0,0,0,3,0,2.0
1250,7,1250,1.0,0,0,0,3,0,1.0
2980,9,2980,2.5,0,0,0,4,0,2.0
2940,9,2940,2.25,0,0,0,3,0,3.0
4120,9,3180,3.0,0,2,940,3,0,2.0
3160,6,2410,2.0,0,0,750,4,0,1.0
1520,7,1000,1.5,1,0,520,3,0,1.0
3620,10,2730,3.25,1,0,890,3,0,2.0
1850,9,1850,3.0,0,0,0,3,0,2.0
2090,7,1250,1.75,0,0,840,4,0,1.5
1100,7,1100,1.0,0,0,0,3,0,1.0
3070,9,3070,2.5,0,0,0,4,0,2.0
2950,8,1560,2.25,1,0,1390,2,0,1.0
3220,8,2010,1.75,0,0,1210,4,0,1.0
2100,8,2100,2.25,0,0,0,3,0,2.0
2300,7,1350,1.75,0,0,950,3,0,1.0
3180,10,3180,2.25,1,0,0,4,0,2.0
1150,7,1150,1.0,0,0,0,3,0,1.0
3130,10,3130,2.5,0,0,0,3,0,2.0
1340,7,1340,1.0,0,0,0,3,0,1.0
470,5,470,1.0,0,2,0,1,0,1.0
950,6,950,1.0,0,0,0,2,0,1.0
2060,7,2060,2.75,0,3,0,5,0,1.5
1480,7,1480,1.5,0,0,0,2,0,1.0
2430,8,2430,1.5,1,0,0,4,0,2.5
2040,8,2040,1.75,0,0,0,3,0,1.0
1800,7,1800,2.5,0,0,0,3,0,2.0
2780,8,1960,2.75,0,2,820,3,0,2.0
1940,8,1940,2.5,0,0,0,3,0,2.0
2040,7,2040,2.5,0,0,0,3,0,2.0
980,7,980,2.0,0,0,0,4,0,1.0
2870,9,2870,2.75,0,0,0,5,0,2.0
2310,7,1300,2.5,0,0,1010,5,0,1.0
1910,7,1390,1.75,1,0,520,5,0,1.0
2640,8,2640,2.5,0,0,0,4,0,2.0
2230,7,2230,2.5,0,0,0,3,0,2.0
2190,7,2190,2.75,0,0,0,4,0,2.0
1550,7,1550,1.5,1,0,0,5,0,1.0
2940,10,2940,2.5,1,0,0,3,0,2.0
3710,10,2130,2.5,0,0,1580,4,0,1.0
2660,8,1330,2.75,0,0,1330,3,0,1.0
1520,8,1520,1.75,0,0,0,3,0,1.0
1980,8,1980,2.5,0,0,0,3,0,2.0
1670,8,1670,2.0,0,0,0,3,0,1.0
2460,8,2460,2.0,0,0,0,3,0,1.0
1660,7,1110,2.25,0,0,550,3,0,1.0
2060,7,2060,2.25,0,0,0,4,0,2.0
1480,7,1480,1.0,0,0,0,4,0,1.5
2500,7,1450,1.5,0,2,1050,3,0,1.5
2520,8,1690,2.25,0,0,830,4,0,2.0
3720,9,2960,4.25,0,2,760,4,0,2.0
2413,8,2413,2.5,0,0,0,4,0,2.0
3320,10,3320,2.5,1,0,0,4,0,2.5
1320,6,1320,2.0,0,0,0,2,0,1.5
1140,6,1140,1.0,0,0,0,2,0,1.0
3540,10,3000,3.0,1,0,540,4,0,2.0
1080,7,1080,1.75,0,0,0,3,0,1.0
2400,8,2400,2.5,0,0,0,3,0,2.0
2590,7,1390,1.75,0,0,1200,5,0,1.0
2310,8,2310,2.5,0,0,0,4,0,2.0
2200,8,1860,2.75,0,0,340,4,0,1.0
2620,7,2620,2.5,0,0,0,3,0,2.0
1830,7,1830,2.5,0,0,0,4,0,2.0
2320,7,1160,2.0,0,0,1160,3,0,1.0
2570,8,1710,2.5,0,2,860,4,0,1.0
1670,8,1670,1.75,0,0,0,2,0,1.0
4083,10,4083,3.5,0,0,0,4,0,2.0
2150,8,1450,3.0,0,0,700,4,0,1.0
1200,6,1200,1.0,0,0,0,3,0,1.0
2653,8,2653,2.5,0,0,0,3,0,2.0
1400,6,700,2.0,0,0,700,3,0,1.0
1830,8,1590,1.75,0,0,240,3,0,1.0
3110,8,3110,2.5,0,0,0,4,0,2.0
3260,8,1960,2.5,0,0,1300,4,0,1.0
1160,7,1160,1.0,0,0,0,3,0,1.5
3030,9,3030,2.5,1,0,0,4,0,2.0
1110,6,890,1.0,0,0,220,2,0,1.0
1420,6,1420,1.0,0,0,0,3,0,1.0
1260,7,1260,1.0,0,0,0,3,0,1.0
1850,9,1850,2.25,0,0,0,3,0,2.0
2140,7,1070,1.75,0,0,1070,3,0,1.0
1570,8,1050,2.0,0,2,520,3,0,2.0
1590,7,1060,2.0,0,0,530,5,0,1.0
1780,7,1050,1.0,0,0,730,3,0,1.0
1470,6,1470,2.0,0,0,0,2,0,2.0
2210,7,1370,2.5,0,0,840,4,0,1.0
1190,6,830,1.0,0,0,360,2,0,1.0
1510,8,1510,2.25,0,0,0,3,0,2.0
1190,7,1190,1.0,0,0,0,2,0,1.0
1150,6,1000,1.0,0,0,150,3,0,1.0
2260,10,2260,2.25,1,0,0,4,0,1.0
1460,7,1460,2.25,0,0,0,3,0,1.0
1250,7,1250,1.0,0,0,0,2,0,1.0
1300,7,1300,2.5,0,0,0,3,0,1.5
1460,7,730,1.0,0,0,730,4,0,1.0
1260,7,1260,1.0,0,3,0,3,0,1.0
2550,9,2550,2.5,0,0,0,4,0,2.0
2320,7,1620,2.0,0,0,700,4,0,1.5
2240,9,2240,2.5,0,0,0,4,0,1.0
3040,9,3040,2.25,0,0,0,3,0,1.0
4040,10,3030,3.0,0,0,1010,3,0,2.0
1410,7,1410,1.75,1,0,0,3,0,1.0
1170,6,690,1.75,0,0,480,2,0,1.0
2880,9,2880,2.5,0,0,0,4,0,2.0
2095,7,2095,2.5,0,0,0,3,0,2.0
1830,8,1830,1.75,0,0,0,3,0,1.0
2542,8,2542,2.5,0,0,0,4,0,2.0
3220,10,2760,3.5,0,4,460,3,0,2.0
1390,7,1390,1.0,0,0,0,4,0,1.5
1500,7,1500,1.0,0,2,0,3,0,2.0
2070,7,2070,2.5,0,0,0,3,0,2.0
2880,8,2180,3.0,0,0,700,6,0,2.0
2730,7,1660,2.5,0,0,1070,5,0,1.0
940,7,940,1.0,0,0,0,2,0,1.0
4230,10,4230,3.5,1,0,0,5,0,2.0
2910,9,2910,2.25,0,2,0,2,0,2.0
1300,7,1300,1.75,0,0,0,3,0,1.0
1320,6,1320,1.0,0,0,0,3,0,1.5
2250,9,1830,2.75,0,0,420,3,0,2.5
1010,7,1010,1.75,1,0,0,3,0,1.0
2750,9,2750,2.5,0,0,0,4,0,2.0
2150,7,2150,1.75,1,0,0,4,0,1.0
1480,7,1480,1.75,0,0,0,3,0,1.0
1400,8,1400,1.0,1,0,0,3,0,1.5
1460,7,1460,1.0,0,0,0,3,0,1.0
1910,7,1110,1.75,0,0,800,4,0,1.0
2150,8,1590,2.25,0,3,560,3,0,1.0
1810,8,1810,2.5,0,0,0,3,0,2.0
1820,8,1390,2.5,0,0,430,4,0,1.0
1220,7,1220,1.0,1,0,0,3,0,1.0
900,6,900,1.0,0,0,0,3,0,1.0
3860,12,3860,4.0,0,2,0,4,0,2.0
1510,6,930,1.0,0,0,580,2,0,1.0
2060,8,1560,2.25,0,0,500,3,0,1.0
2530,8,1910,2.0,0,0,620,4,0,1.5
1780,7,1780,2.5,0,0,0,4,0,2.0
1500,7,1210,2.25,0,0,290,3,0,1.0
2570,7,1300,2.5,0,0,1270,5,0,1.0
1850,7,880,1.75,1,0,970,3,0,1.0
3000,8,1500,2.75,0,0,1500,5,0,1.0
2390,9,2390,2.25,0,0,0,4,0,2.0
1080,6,1080,1.0,0,0,0,2,0,1.0
1200,7,1200,2.0,0,0,0,3,0,1.0
3010,10,3010,3.5,0,0,0,3,0,2.0
3470,9,3470,2.5,0,0,0,4,0,2.0
1510,8,1510,2.0,0,0,0,2,0,1.0
1900,8,1900,2.5,0,0,0,3,0,2.0
1510,6,1510,1.5,0,0,0,3,0,1.0
1990,7,1990,2.5,0,0,0,3,0,2.0
3280,10,3280,4.0,0,0,0,4,0,2.0
1720,7,1270,1.75,0,0,450,3,0,1.5
920,6,920,1.0,1,0,0,2,0,1.0
840,6,840,1.0,0,0,0,3,0,1.0
3550,9,3550,2.5,0,0,0,3,0,2.0
1400,6,1400,1.0,0,0,0,3,0,1.0
5370,11,5370,3.25,0,4,0,4,0,2.0
1580,8,1290,1.5,0,0,290,3,0,1.0
2990,8,2990,2.5,0,0,0,4,0,2.0
960,7,960,1.0,0,0,0,2,0,1.0
1500,7,1500,2.25,0,0,0,3,0,1.0
1530,7,1530,1.75,0,0,0,3,0,1.0
2400,8,2400,2.5,0,0,0,4,0,2.0
2460,7,1230,1.75,0,0,1230,3,0,1.0
2420,8,2420,2.0,1,0,0,5,0,1.5
1240,7,1240,1.75,0,0,0,3,0,1.0
1580,6,1580,2.0,0,0,0,4,0,2.0
2240,9,2240,2.5,0,0,0,3,0,1.0
2020,7,1230,3.0,0,0,790,6,0,1.0
1960,8,1400,2.25,0,0,560,3,0,1.0
2320,8,2320,2.5,0,0,0,3,0,2.0
1970,7,1370,1.75,0,0,600,3,0,1.0
1490,7,1490,2.5,0,0,0,3,0,2.0
3330,9,3330,2.25,1,0,0,3,0,2.0
1650,8,1650,1.75,0,0,0,3,0,1.5
1820,8,1820,1.75,0,2,0,3,0,1.0
2680,9,1820,2.75,1,0,860,3,0,1.0
2480,8,1860,2.25,0,0,620,5,0,1.0
1990,8,1530,2.75,0,0,460,3,0,1.0
1740,9,1180,2.5,0,0,560,3,0,2.0
1660,7,1280,2.75,0,0,380,4,0,1.5
3710,9,3710,2.75,0,0,0,4,0,2.0
1340,7,1340,3.25,0,0,0,3,0,2.0
2220,8,1310,2.25,0,0,910,4,0,1.5
970,7,970,1.0,0,0,0,2,0,1.0
2700,9,2700,2.5,0,0,0,4,0,2.0
1200,7,1200,1.0,0,0,0,3,0,1.0
1460,6,1460,1.0,0,0,0,2,0,1.0
2680,9,2680,2.5,1,0,0,4,0,2.0
3820,8,2440,3.5,0,2,1380,4,0,2.0
2920,9,2920,2.5,0,4,0,4,0,2.0
2650,8,1610,2.5,0,3,1040,4,0,1.0
1510,7,1510,1.75,0,0,0,3,0,1.0
1480,7,1300,3.5,0,0,180,3,0,2.0
3260,9,3260,2.75,0,0,0,4,0,2.0
1180,6,1180,1.0,0,0,0,2,0,1.0
1250,7,1250,1.0,0,0,0,3,0,1.0
1040,7,720,2.5,0,0,320,3,0,2.0
1800,8,1800,2.25,0,0,0,3,0,2.0
1280,7,1280,1.75,0,0,0,3,0,1.5
2240,7,2240,1.75,0,0,0,6,0,2.0
1490,8,1490,2.5,0,0,0,3,0,3.0
1680,7,1680,1.5,1,0,0,4,0,2.0
2200,7,1420,2.5,0,0,780,5,0,1.5
1300,7,1300,1.75,0,0,0,2,0,2.0
950,7,950,1.0,0,0,0,3,0,1.0
1010,7,1010,1.0,0,0,0,3,0,1.0
3130,8,3130,2.5,0,0,0,4,0,2.0
1970,8,1470,2.25,0,0,500,3,0,1.0
2320,7,1480,2.5,0,0,840,3,0,1.0
1440,7,840,1.0,0,0,600,2,0,1.0
2460,8,2460,2.5,0,0,0,4,0,2.0
2800,9,2170,2.5,1,0,630,4,0,2.0
1600,7,1600,1.75,0,0,0,3,0,1.0
4730,10,2940,3.5,1,4,1790,4,1,1.0
2910,7,2910,2.5,0,0,0,4,0,2.0
4150,10,4150,2.5,0,0,0,5,0,2.0
1910,8,1910,2.5,0,0,0,4,0,1.0
4280,10,4280,3.5,0,3,0,5,0,2.0
1870,8,1870,2.5,0,0,0,3,0,2.0
1730,7,1730,2.5,0,0,0,3,0,2.0
2460,7,1230,2.25,0,0,1230,4,0,1.0
1960,7,980,1.75,0,0,980,3,0,1.0
2860,8,1460,2.25,0,0,1400,4,0,1.0
1090,7,1090,1.0,0,0,0,3,0,1.0
2690,9,2060,3.25,0,0,630,4,0,2.0
1870,8,1320,1.75,0,0,550,3,0,1.0
2600,8,1620,2.75,1,0,980,4,0,1.0
4670,12,4670,5.25,1,0,0,4,0,2.0
1820,7,1820,1.75,0,0,0,3,0,2.0
2620,9,2620,2.5,0,0,0,3,0,1.5
4340,11,3060,3.25,0,3,1280,3,0,2.0
3480,8,3480,2.25,1,0,0,5,0,2.0
2620,9,2620,2.5,1,0,0,4,0,2.5
1130,6,1130,1.5,0,0,0,4,0,1.0
1310,7,1310,2.0,0,0,0,3,0,3.0
2190,8,2020,1.75,0,0,170,4,0,1.0
1610,7,1080,1.0,0,0,530,3,0,1.0
2500,7,1400,2.5,0,0,1100,5,0,1.0
1880,7,1100,3.0,0,0,780,5,0,1.0
800,6,800,1.0,0,0,0,2,0,1.0
1410,7,1410,2.0,0,0,0,3,0,1.0
980,6,980,1.0,0,0,0,3,0,1.0
1420,6,1420,1.5,0,0,0,3,0,1.0
2714,9,2714,2.5,0,0,0,4,0,2.0
1530,7,1530,2.5,0,0,0,3,0,2.5
1830,8,1290,2.25,0,0,540,3,0,1.0
1280,7,940,1.0,0,0,340,4,0,1.0
1550,8,1550,2.25,0,0,0,3,0,3.0
2230,8,1460,2.75,0,0,770,3,0,1.0
2780,7,1710,3.0,0,0,1070,4,0,1.5
1260,7,1260,1.5,0,0,0,3,0,1.0
2680,8,2680,2.5,0,0,0,3,0,2.0
1530,7,1530,1.75,0,0,0,3,0,1.0
1310,7,1090,1.5,0,0,220,3,0,1.0
2730,9,2730,2.5,0,0,0,3,0,2.0
1350,8,1350,2.0,0,0,0,2,0,1.0
3380,10,3380,2.5,0,0,0,3,0,2.0
1730,8,1730,2.0,0,0,0,3,0,1.0
1000,6,1000,1.0,0,0,0,4,0,1.0
1470,7,1470,2.25,0,2,0,3,0,2.0
1680,8,1680,2.5,0,0,0,3,0,2.0
1210,7,1210,1.0,0,2,0,4,0,1.5
1680,9,1680,2.5,0,0,0,3,0,3.0
5000,12,5000,4.0,1,2,0,4,0,3.0
1460,8,1460,2.0,0,0,0,3,0,2.0
2110,9,2110,2.25,1,0,0,3,0,1.0
1610,7,1610,2.5,0,0,0,4,0,2.0
710,7,710,1.0,0,0,0,2,0,1.0
1700,8,1700,2.5,0,0,0,3,0,2.0
3550,8,2100,2.75,0,0,1450,4,0,1.0
3320,9,2120,3.0,0,0,1200,4,0,2.0
2620,9,2060,3.5,0,4,560,3,0,2.0
1200,6,920,1.0,0,0,280,3,0,1.0
1700,7,1700,1.0,0,0,0,3,0,1.0
1410,7,1410,1.0,0,0,0,3,0,1.0
1670,7,1670,1.75,0,0,0,4,0,1.0
2250,9,2250,2.0,0,2,0,3,0,1.0
2890,7,2890,2.5,0,0,0,4,0,2.0
1430,6,1070,1.0,0,0,360,4,0,1.0
2810,8,1710,2.5,1,0,1100,4,0,1.0
1020,7,720,2.0,0,0,300,3,0,2.0
2560,8,2560,2.5,0,0,0,3,0,2.0
3402,10,2846,2.5,0,0,556,4,0,2.0
1300,7,1300,1.75,0,0,0,3,0,1.5
2840,9,2440,3.0,1,0,400,5,0,2.0
1950,7,1040,1.75,0,0,910,4,0,1.0
1330,6,1330,1.0,0,0,0,3,0,2.0
2070,8,2070,2.5,0,0,0,3,0,2.0
4250,12,3020,3.25,1,4,1230,4,0,2.0
2160,8,2160,1.5,0,2,0,5,0,1.5
1070,6,1070,1.5,0,0,0,3,0,1.0
1120,7,1120,1.0,0,0,0,3,0,1.0
1560,7,1560,2.25,0,0,0,3,0,2.0
2380,7,2380,3.0,0,0,0,5,0,2.0
2700,11,1920,3.5,0,0,780,4,0,2.0
2090,7,2090,2.5,0,0,0,4,0,2.0
2930,8,1660,2.75,0,0,1270,4,0,1.0
1660,7,1660,1.5,0,0,0,3,0,2.0
1850,9,1790,2.5,0,0,60,3,0,2.5
5090,12,5090,5.25,1,0,0,5,0,2.0
2300,8,2300,2.5,1,0,0,4,0,2.0
1590,7,1290,1.0,0,0,300,3,0,1.5
2180,7,1090,1.75,0,0,1090,4,0,1.0
3290,9,3290,2.5,0,0,0,4,0,2.0
1850,8,1850,2.5,0,0,0,3,0,2.0
1890,8,1890,2.5,0,0,0,4,0,2.0
2960,10,2960,3.0,0,0,0,3,0,2.0
1140,7,1140,1.0,0,0,0,3,0,1.0
2540,9,2010,3.5,1,1,530,3,0,2.0
4790,9,3110,3.5,1,1,1680,5,0,2.0
3110,7,2010,2.75,0,0,1100,7,0,1.5
2840,8,2840,3.25,0,0,0,4,0,1.0
2570,8,1570,2.5,0,0,1000,4,0,1.0
1790,7,1790,2.0,0,0,0,3,0,1.5
1840,7,1370,2.25,0,0,470,3,0,1.0
2690,8,2690,2.5,0,0,0,4,0,2.0
2040,7,2040,2.5,0,0,0,4,0,2.0
1750,8,1750,2.5,0,0,0,3,0,2.0
1590,7,1590,1.5,0,0,0,3,0,1.0
2280,8,2280,2.25,0,0,0,4,0,2.0
2820,7,2820,1.5,0,0,0,4,0,2.0
1970,7,1300,2.0,0,0,670,3,0,1.0
1600,7,1600,2.0,1,0,0,3,0,1.0
3040,10,3040,2.75,0,0,0,3,0,2.0
3118,9,3118,2.5,0,2,0,4,0,2.0
1560,8,790,2.0,0,0,770,3,0,1.0
2040,7,2040,2.5,0,0,0,4,0,2.0
2400,7,1860,3.0,0,0,540,3,0,2.0
3290,9,3290,3.5,0,0,0,4,0,2.0
1510,7,1510,2.0,0,0,0,3,0,1.0
1590,7,1590,2.5,0,0,0,3,0,2.0
1890,8,1890,1.75,1,0,0,3,0,1.0
2880,8,1980,3.5,0,3,900,5,0,2.0
2630,9,2630,1.75,1,0,0,4,0,1.0
3570,7,3570,3.25,0,0,0,5,0,2.0
2910,8,2910,2.5,0,0,0,4,0,3.0
1790,8,1210,1.5,0,0,580,4,0,1.0
2330,6,1600,2.0,0,0,730,3,0,1.5
2460,8,2460,2.25,1,0,0,4,0,2.0
1840,7,1840,1.5,0,0,0,4,0,2.0
1960,7,1960,2.5,0,0,0,4,0,2.0
1280,7,1280,1.75,0,0,0,3,0,1.0
1180,8,840,2.25,0,0,340,2,0,2.0
1420,7,1420,2.25,0,0,0,3,0,2.0
3270,9,3270,2.5,0,0,0,4,0,2.0
2360,10,2360,2.5,0,0,0,3,0,2.0
1240,8,1080,1.5,0,0,160,2,0,2.0
1460,8,1200,2.5,0,0,260,3,0,2.0
3230,8,3230,2.25,0,0,0,4,0,2.0
1940,7,1050,2.0,0,0,890,3,0,1.0
1050,7,1050,1.0,0,0,0,3,0,1.0
1500,7,1140,1.5,0,0,360,3,0,1.5
1130,8,1130,1.75,0,0,0,2,0,1.0
1980,8,1980,2.5,0,0,0,3,0,2.0
1900,7,950,1.75,0,0,950,3,0,1.0
3810,10,2680,3.25,1,1,1130,4,0,1.0
7220,12,6220,5.75,0,4,1000,4,0,2.0
2290,8,1780,2.25,1,0,510,4,0,1.0
2280,8,2280,2.5,0,0,0,4,0,2.0
3040,10,3040,3.0,0,2,0,3,0,3.0
2130,8,2130,1.5,0,0,0,4,0,2.0
2500,8,2120,2.75,0,1,380,4,0,1.0
3450,9,2590,2.75,0,3,860,3,0,1.5
1520,6,760,1.75,0,0,760,3,0,1.0
1690,7,970,2.75,0,0,720,5,0,1.0
2860,8,2860,2.5,0,0,0,3,0,2.0
1860,7,1860,2.5,0,0,0,4,0,2.0
2250,8,2150,1.75,0,0,100,4,0,1.0
2120,8,2120,2.5,0,0,0,4,0,2.0
1230,7,1230,1.0,1,0,0,3,0,1.0
1210,7,1210,1.0,0,0,0,3,0,1.0
3490,9,2850,2.5,0,0,640,4,0,2.0
1690,8,1320,3.25,0,0,370,4,0,2.0
2520,8,2520,2.25,0,0,0,5,0,2.0
3850,10,3120,4.5,0,0,730,3,0,2.0
1310,7,1310,1.5,0,0,0,3,0,1.0
3220,8,3220,2.25,0,0,0,4,0,2.0
1850,6,1100,1.75,0,2,750,3,0,1.0
1050,7,1050,1.75,0,0,0,3,0,1.0
1600,7,1600,1.75,0,0,0,3,0,1.0
3140,8,2040,2.0,1,0,1100,4,0,1.0
1280,7,1280,1.75,1,0,0,2,0,1.0
1450,7,1450,2.0,0,0,0,4,0,1.5
1960,7,1750,2.25,0,0,210,3,0,2.0
1870,6,1350,1.5,0,0,520,2,0,1.5
1730,6,1730,1.0,0,0,0,4,0,1.5
1440,8,1440,1.0,0,0,0,3,0,1.0
2341,9,2341,2.5,0,0,0,4,0,2.0
1860,7,1860,2.25,0,0,0,3,0,1.0
1930,6,1930,1.75,0,0,0,3,0,1.5
860,7,860,1.0,0,0,0,3,0,1.5
1250,7,1250,1.0,0,0,0,3,0,1.0
2220,8,2220,2.5,0,0,0,3,0,2.0
1420,7,1050,1.5,0,0,370,5,0,1.0
2250,9,2250,2.5,1,0,0,3,0,2.0
2630,9,2630,2.25,1,0,0,3,0,2.0
2600,7,2600,2.5,0,0,0,4,0,2.0
3030,9,3030,3.5,0,0,0,4,0,3.0
700,6,700,1.0,0,0,0,2,0,1.0
3840,8,2640,3.5,0,0,1200,4,0,2.0
1310,6,1310,1.75,0,0,0,3,0,1.0
1560,7,1560,2.0,0,0,0,3,0,1.0
2910,8,1780,2.75,1,2,1130,4,0,1.0
2310,8,1790,1.5,0,0,520,3,0,1.5
1700,6,890,2.0,0,0,810,3,0,1.0
1380,7,1380,1.0,0,0,0,3,0,1.0
2020,7,2020,2.0,0,0,0,5,0,1.5
1650,7,1650,1.75,0,0,0,3,0,1.0
790,7,790,1.0,0,0,0,1,0,1.0
2610,8,2610,2.5,0,0,0,4,0,2.0
1210,7,1210,2.0,1,0,0,4,0,1.0
2270,7,2270,2.5,0,0,0,3,0,2.0
3290,9,2670,3.5,0,0,620,5,0,2.0
3340,8,3340,2.25,0,0,0,4,0,2.0
1500,7,1050,1.0,0,0,450,3,0,1.5
1290,9,1090,3.25,0,2,200,3,0,2.0
2290,9,2290,2.5,0,0,0,4,0,2.0
1250,7,1250,1.0,0,0,0,3,0,1.0
1230,7,1090,1.0,0,0,140,3,0,1.0
2550,9,1650,1.75,0,0,900,3,0,2.0
1840,7,1840,2.5,0,0,0,3,0,2.0
1720,7,970,2.0,0,0,750,4,0,1.0
620,6,620,1.0,0,0,0,2,0,1.0
2230,7,2230,1.75,0,0,0,4,0,1.0
1040,6,1040,0.75,0,0,0,3,0,1.0
2100,8,1200,3.0,0,0,900,5,0,1.0
1820,7,1820,1.75,0,0,0,3,0,1.0
1290,7,1290,2.0,0,0,0,3,0,3.0
1800,7,1400,2.75,0,0,400,5,0,1.5
2420,8,2420,2.5,0,0,0,3,0,2.0
1010,6,1010,1.0,0,0,0,3,0,1.0
1660,7,1160,1.0,0,0,500,3,0,1.0
2220,8,1780,2.25,0,0,440,3,0,1.0
2170,8,2170,2.25,1,1,0,4,0,2.0
2300,9,2300,2.5,0,0,0,4,0,2.0
2380,8,2380,2.5,0,0,0,4,0,2.0
1790,8,1490,1.0,0,0,300,2,0,1.5
4290,10,4290,4.5,0,0,0,7,0,1.5
870,7,870,1.0,0,0,0,2,0,1.0
4475,12,2659,3.75,1,4,1816,4,1,2.0
1520,7,1520,1.75,0,0,0,3,0,1.0
2590,7,1330,3.25,0,0,1260,5,0,1.0
3240,10,2130,3.5,0,0,1110,3,0,2.0
2740,10,2740,2.0,0,4,0,3,0,2.0
3740,9,1870,2.25,0,0,1870,4,0,1.0
1860,7,1860,2.5,0,0,0,3,0,2.0
3460,10,3460,3.5,0,0,0,4,0,2.0
1640,7,1640,2.5,0,0,0,3,0,2.0
2840,8,2840,2.5,0,0,0,4,0,2.0
1750,6,1390,1.5,1,0,360,5,0,1.0
2570,8,1620,2.5,0,2,950,5,0,1.0
1210,8,1060,1.0,0,0,150,2,0,1.0
2560,9,2560,2.5,0,0,0,3,0,2.0
2160,8,1360,2.25,0,0,800,4,0,1.0
2060,7,2060,2.0,0,0,0,5,0,2.0
1840,8,1840,1.5,1,0,0,4,0,2.0
1950,7,1950,2.5,0,0,0,4,0,2.0
1680,8,1680,2.5,0,0,0,3,0,2.0
2620,8,2620,2.5,0,0,0,4,0,2.0
1840,8,1140,1.75,0,2,700,3,0,1.0
1670,8,1670,2.25,0,0,0,3,0,2.0
1200,7,1200,1.0,0,0,0,3,0,1.0
1790,7,1390,2.25,0,0,400,3,0,1.0
2680,8,1570,2.25,0,0,1110,3,0,1.0
3640,9,2790,3.5,0,3,850,4,0,2.0
1430,7,1430,1.5,0,0,0,4,0,1.5
2450,8,1410,2.5,0,0,1040,4,0,1.0
3610,8,3610,3.0,0,2,0,3,0,2.0
1180,7,1180,1.5,0,0,0,3,0,1.0
1890,8,1890,2.5,0,0,0,3,0,2.0
1420,7,960,2.25,1,0,460,3,0,1.0
2850,9,2850,2.5,1,0,0,4,0,2.0
1700,7,1700,2.5,0,0,0,3,0,2.0
1450,7,1450,2.0,0,0,0,3,0,1.0
1830,7,1400,2.25,0,0,430,3,0,1.0
1720,7,960,2.0,0,2,760,3,0,1.0
2810,9,2810,2.5,0,0,0,4,0,1.5
2100,7,2100,2.5,0,0,0,3,0,2.0
1730,7,1730,2.5,0,0,0,3,0,2.0
1540,7,1540,1.0,0,0,0,4,0,1.5
1190,7,1190,1.0,0,0,0,4,0,1.5
1650,7,1650,2.0,0,0,0,4,0,1.0
1995,8,1995,2.25,0,0,0,4,0,2.0
3920,10,3920,2.5,0,0,0,4,0,2.0
3610,10,3610,4.0,0,0,0,4,0,2.0
570,6,570,1.0,0,1,0,2,0,1.0
1550,7,1550,1.75,0,0,0,4,0,1.0
1720,7,960,1.75,0,0,760,3,0,1.0
2680,8,1450,1.5,1,0,1230,5,0,1.0
1800,7,1330,1.5,0,0,470,4,0,1.0
1430,7,1110,1.0,0,0,320,2,0,1.0
2170,7,2170,2.75,0,0,0,3,0,2.0
800,7,800,1.5,0,0,0,2,0,1.0
4440,10,4440,4.5,0,0,0,5,0,2.0
3470,10,2830,3.25,1,0,640,4,0,2.0
1300,7,1300,2.0,0,0,0,3,0,1.0
1970,7,1970,2.25,0,0,0,3,0,2.0
2690,7,2690,1.75,0,0,0,4,0,1.5
1470,8,1470,2.0,0,0,0,3,0,1.0
1960,8,1960,2.5,0,0,0,3,0,2.0
2270,7,1290,2.25,0,0,980,4,0,1.0
860,6,860,1.0,0,0,0,2,0,1.0
3260,9,3260,2.5,0,0,0,4,0,2.0
2920,9,2920,2.75,1,0,0,4,0,2.0
1100,7,1100,1.0,0,0,0,3,0,1.5
2180,8,1700,2.25,0,0,480,3,0,1.0
2480,10,1730,3.0,0,3,750,3,0,2.0
1360,7,1360,1.5,0,0,0,4,0,1.5
840,6,840,1.0,0,0,0,2,0,1.0
1700,8,1700,1.75,0,0,0,4,0,1.0
1870,8,1870,2.5,0,0,0,3,0,2.0
2190,7,2190,3.0,0,0,0,5,0,2.0
2350,7,1650,3.0,0,3,700,5,0,2.0
1050,7,850,1.0,0,0,200,2,0,1.0
3270,10,3270,2.75,0,0,0,4,0,2.0
2250,7,2250,2.5,0,0,0,3,0,2.0
1340,7,1340,1.5,0,0,0,3,0,1.0
982,8,806,1.5,0,0,176,2,0,2.0
1528,7,1528,2.5,0,0,0,3,0,2.0
1070,6,870,1.0,0,0,200,2,0,1.0
2420,9,2420,2.75,0,0,0,4,0,1.0
1000,7,990,2.5,0,0,10,2,0,2.0
2260,8,1400,2.25,1,0,860,4,0,2.0
2710,9,2710,2.5,0,0,0,3,0,2.0
1630,7,1630,1.75,0,0,0,3,0,1.5
1750,7,1750,1.75,0,0,0,5,0,1.0
2980,9,2980,3.5,1,3,0,4,0,2.0
3360,9,2450,3.5,0,0,910,4,0,2.0
2200,8,1500,1.75,1,0,700,3,0,1.0
2160,8,1410,2.25,0,0,750,3,0,1.0
3000,7,1500,2.75,0,0,1500,5,0,1.0
1590,8,1060,1.75,0,0,530,3,0,2.0
1540,7,1540,2.0,0,0,0,3,0,1.0
1040,7,1040,1.0,0,0,0,2,0,1.0
1420,7,1000,1.75,0,0,420,3,0,1.0
1010,6,1010,1.0,0,0,0,3,0,1.0
4030,11,4030,3.25,0,0,0,4,0,2.0
3520,9,2650,2.5,0,0,870,4,0,2.5
1320,7,1320,1.75,0,0,0,3,0,1.0
2290,8,2290,2.0,0,0,0,3,0,1.0
1630,7,1630,2.25,0,0,0,3,0,1.0
830,6,830,1.0,0,0,0,2,0,1.0
1780,7,1400,2.5,0,0,380,3,0,1.0
1480,7,1480,1.5,0,0,0,2,0,1.0
1120,6,1120,1.0,0,0,0,2,0,1.0
3223,9,3223,3.0,0,0,0,5,0,2.0
1980,6,1120,1.0,0,0,860,3,0,1.0
3790,11,3290,3.75,1,0,500,4,0,2.0
4270,12,4270,3.5,0,0,0,4,0,1.0
1520,7,1020,1.5,0,0,500,3,0,1.0
1940,7,1520,2.25,0,0,420,3,0,1.0
1920,7,1220,1.0,0,0,700,4,0,1.0
2700,8,2700,2.25,0,0,0,4,0,2.0
2410,7,1630,2.5,0,0,780,3,0,1.0
2330,8,2330,1.75,0,0,0,4,0,1.0
1040,7,800,1.75,0,0,240,3,0,1.0
1280,6,1280,1.0,0,0,0,3,0,1.0
2590,10,2590,2.75,1,0,0,3,0,2.0
820,8,820,1.0,0,0,0,2,0,3.0
790,6,790,1.0,0,0,0,2,0,1.0
1140,6,1140,1.0,0,0,0,3,0,1.5
1010,5,1010,1.0,0,0,0,2,0,1.5
1250,7,1250,1.5,0,0,0,3,0,1.0
2600,8,2150,3.25,0,0,450,4,0,2.0
1670,7,1670,2.5,0,0,0,3,0,2.0
1600,7,1600,2.5,0,0,0,3,0,2.0
2170,7,1350,2.5,0,3,820,4,0,1.0
2200,6,1100,2.0,0,0,1100,4,0,1.0
1850,7,1850,2.0,0,0,0,4,0,1.0
1970,8,1970,2.5,0,0,0,3,0,2.0
1630,7,1630,1.0,0,0,0,3,0,1.5
2390,8,2390,2.0,0,1,0,3,0,2.0
2620,7,1710,2.75,0,0,910,5,0,1.5
1780,7,890,1.75,0,0,890,4,0,1.0
1950,8,1350,2.25,0,0,600,2,0,1.0
2380,8,1580,2.5,0,0,800,5,0,1.0
2330,8,2330,2.25,0,0,0,3,0,2.0
780,7,780,1.0,0,0,0,1,0,1.0
2150,7,2150,2.25,0,0,0,3,0,2.0
940,7,940,1.5,0,0,0,2,0,2.0
2130,8,2130,2.0,0,0,0,3,0,1.0
940,7,940,1.0,0,0,0,3,0,1.0
1200,7,1200,1.75,0,0,0,3,0,1.0
2390,9,2390,2.5,0,0,0,3,0,2.0
2280,7,1140,2.25,0,0,1140,4,0,1.0
3400,10,3400,3.25,0,0,0,5,0,2.0
1500,7,1200,1.75,0,0,300,4,0,1.0
2240,9,2240,2.5,0,0,0,4,0,2.0
1720,7,1720,2.5,0,0,0,3,0,2.0
2300,8,1770,1.75,0,0,530,3,0,1.0
1770,7,1420,2.5,0,0,350,3,0,1.0
1260,7,1260,1.0,0,0,0,3,0,1.5
2820,9,2820,2.5,0,0,0,4,0,2.0
2240,8,1370,1.5,0,0,870,3,0,2.0
1600,7,1600,1.75,0,0,0,3,0,1.5
2750,8,1630,3.0,0,0,1120,4,0,1.0
2300,7,2300,2.5,0,0,0,4,0,1.0
1860,7,930,2.0,0,0,930,3,0,1.0
3450,8,2350,3.5,1,0,1100,5,0,1.0
2040,7,1100,2.75,0,2,940,6,0,1.0
2160,8,1880,2.5,0,0,280,3,0,1.5
1270,7,1270,2.5,0,0,0,3,0,3.0
2020,7,2020,1.75,0,0,0,3,0,1.0
1320,7,1320,1.5,0,0,0,2,0,1.0
3350,11,2460,3.5,0,0,890,4,0,1.0
4800,10,4800,3.25,0,0,0,4,0,2.0
2610,7,1670,2.0,0,0,940,3,0,1.0
1180,7,1180,1.75,0,0,0,3,0,1.0
2130,8,1830,2.25,0,0,300,2,0,1.0
1910,7,1210,1.75,0,0,700,4,0,1.0
2050,8,1950,1.0,1,0,100,3,0,2.0
2340,7,1170,2.0,0,1,1170,3,0,1.0
930,6,930,1.0,0,0,0,2,0,1.0
1220,7,1220,1.75,0,0,0,3,0,1.0
1420,5,710,1.75,0,0,710,3,0,1.0
2240,7,1220,1.5,0,0,1020,3,0,1.0
3000,11,3000,2.25,0,4,0,3,1,1.5
1510,7,1510,1.75,0,0,0,4,0,1.0
2080,8,1680,2.25,0,0,400,3,0,1.5
1990,8,1990,2.5,0,0,0,4,0,2.0
1360,8,1360,1.75,0,0,0,3,0,1.0
2540,7,1440,2.75,1,0,1100,5,0,1.0
1200,7,1200,1.0,0,0,0,3,0,2.0
1690,7,940,2.0,0,2,750,3,0,1.0
1880,7,940,1.75,0,0,940,3,0,1.0
1280,5,1280,1.5,0,0,0,3,0,1.5
2140,7,1140,1.75,0,0,1000,4,0,1.0
2500,7,1850,2.25,0,0,650,5,0,1.0
4440,9,2220,3.25,1,1,2220,6,0,1.0
1370,7,1370,2.0,0,0,0,3,0,1.0
1950,8,1330,2.25,1,0,620,4,0,1.0
1580,7,1580,2.25,0,0,0,3,0,2.0
2070,7,2070,2.5,0,0,0,4,0,2.0
1360,7,1360,1.0,0,0,0,4,0,1.5
1010,7,1010,2.0,0,0,0,3,0,1.0
2110,8,2110,1.75,0,0,0,3,0,1.0
1280,7,1280,1.0,0,0,0,3,0,1.0
3600,9,2100,3.0,0,4,1500,4,0,1.0
2330,7,1450,1.75,0,0,880,2,0,1.0
2040,7,1030,1.5,0,0,1010,5,0,1.0
1570,7,1570,1.75,0,0,0,5,0,2.0
3930,10,2540,3.25,1,2,1390,5,0,2.0
2690,8,2690,2.0,0,0,0,3,0,2.0
1714,8,1714,2.5,0,0,0,3,0,2.0
1530,7,980,1.0,0,0,550,4,0,1.0
2120,7,1060,1.75,0,3,1060,3,0,1.0
3300,10,3300,2.5,0,0,0,4,0,2.0
3000,8,1550,2.5,1,0,1450,4,0,1.0
2050,8,2050,2.5,0,0,0,4,0,2.0
1440,7,1440,1.75,0,0,0,3,0,2.0
2260,8,1220,1.75,0,0,1040,4,0,1.0
2520,8,1680,2.5,0,0,840,4,0,1.0
1210,6,1210,1.0,0,0,0,3,0,1.0
1130,7,990,1.0,0,0,140,3,0,1.0
7730,12,6660,5.75,0,0,1070,5,0,2.0
1510,8,1330,2.5,0,0,180,3,0,2.5
1350,7,820,1.0,0,0,530,3,0,1.0
530,6,530,1.0,0,0,0,1,0,1.0
2140,8,2140,2.75,0,0,0,4,0,2.0
1200,6,980,1.0,0,0,220,2,0,1.0
2360,8,1530,2.5,0,2,830,4,0,1.0
1430,6,1430,1.5,0,0,0,3,0,1.0
2400,8,2400,2.5,0,0,0,4,0,2.0
384,4,384,0.75,0,0,0,0,0,1.0
3090,9,2370,3.25,0,0,720,4,0,2.0
2085,7,1610,1.75,0,0,475,4,0,1.0
1120,7,1120,1.0,0,0,0,5,0,1.5
2506,7,2506,2.5,0,0,0,4,0,2.0
2130,7,1330,1.75,0,0,800,4,0,1.0
3280,10,3280,3.5,0,0,0,4,0,2.0
1390,8,1140,3.25,0,0,250,3,0,2.0
1590,8,1300,2.5,0,0,290,2,0,2.0
2250,8,1450,1.75,0,0,800,4,0,1.0
2530,8,1280,2.75,0,0,1250,4,0,1.0
2120,7,1060,1.0,0,0,1060,3,0,1.0
1890,8,1610,2.25,0,0,280,2,0,2.0
1580,7,1580,1.0,0,0,0,3,0,1.5
1660,7,1130,2.0,0,0,530,3,0,1.0
2350,8,1220,2.5,1,0,1130,5,0,1.0
1090,7,1090,1.5,0,0,0,2,0,1.5
1920,7,1920,1.0,0,0,0,4,0,1.5
1360,8,1094,2.25,0,0,266,3,0,2.0
1940,8,1940,2.5,0,0,0,3,0,1.0
1060,7,910,1.0,0,0,150,3,0,1.0
1730,7,1730,2.0,0,0,0,3,0,2.5
1061,7,1061,2.25,0,0,0,2,0,2.0
4740,10,4740,3.75,0,0,0,4,0,2.0
1270,6,1270,1.0,0,0,0,3,0,1.0
1150,8,1020,2.5,0,0,130,3,0,2.0
1600,7,940,2.5,0,0,660,3,0,1.0
3470,10,3470,2.5,0,0,0,4,0,2.0
2320,8,2320,2.5,0,0,0,4,0,2.0
2480,7,1640,1.0,0,0,840,5,0,1.5
3240,10,2260,2.5,0,0,980,4,0,1.0
2270,8,2270,2.5,0,0,0,3,0,2.0
3360,9,3360,2.5,0,0,0,4,0,2.0
2760,7,2230,2.5,0,0,530,4,0,2.0
1270,7,970,1.0,0,0,300,3,0,1.0
2550,7,1560,1.5,0,0,990,5,0,1.0
2260,8,1530,2.25,0,0,730,4,0,1.0
3910,10,2610,4.0,0,2,1300,3,0,2.0
1600,8,1600,2.5,0,0,0,3,0,2.0
870,6,870,1.0,0,0,0,3,0,1.0
3670,10,3670,2.75,1,3,0,4,0,2.0
2910,7,2910,2.75,0,0,0,5,0,2.0
1550,8,1550,2.0,0,0,0,3,0,1.5
2080,8,2080,2.5,0,0,0,4,0,2.0
1840,7,1060,1.75,0,0,780,6,0,1.0
1010,7,1010,1.0,0,0,0,3,0,1.0
1650,7,1650,1.0,0,0,0,4,0,1.0
3470,10,3470,2.5,1,0,0,4,0,2.0
830,6,830,1.0,0,0,0,2,0,1.0
1960,5,1960,1.0,0,0,0,3,0,2.0
880,5,880,1.0,0,0,0,2,0,1.0
2180,7,1560,1.75,0,0,620,4,0,1.0
3290,10,2190,3.75,0,0,1100,5,0,2.0
2820,9,2820,2.5,0,0,0,4,0,2.0
1620,7,1140,2.75,0,0,480,3,0,1.0
2980,10,2020,2.25,0,2,960,4,0,1.5
6900,9,4820,4.25,0,0,2080,6,0,2.0
2390,8,1680,3.0,0,0,710,3,0,2.0
1530,8,1200,3.25,0,0,330,3,0,2.0
1190,7,1190,1.0,0,0,0,2,0,1.0
2190,8,2190,2.5,0,0,0,3,0,2.0
1785,8,1785,2.5,0,0,0,4,0,2.0
1360,7,1360,1.5,0,0,0,3,0,1.0
1296,8,1296,3.0,0,0,0,3,0,3.0
2670,7,1620,2.5,0,0,1050,5,0,1.5
2650,9,2650,2.5,0,0,0,4,0,2.0
1830,8,1720,1.0,0,0,110,3,0,1.5
2180,8,1300,1.75,1,2,880,3,0,1.0
2240,8,2240,2.5,0,0,0,3,0,2.0
2370,9,2370,2.25,1,0,0,5,0,2.0
2240,8,2240,2.5,0,0,0,4,0,2.0
2280,8,2280,2.5,0,0,0,3,0,2.0
700,6,700,1.0,0,0,0,2,0,1.0
3526,10,3526,3.25,0,0,0,4,0,2.0
3238,8,1678,2.5,0,2,1560,4,0,1.0
5010,9,3710,3.25,0,0,1300,4,0,2.0
2360,9,2360,2.5,0,0,0,4,0,2.0
2700,8,1450,1.75,0,0,1250,4,0,1.0
1430,9,1430,1.5,0,0,0,4,0,1.5
2110,7,2110,3.0,0,0,0,5,0,2.0
1320,6,1320,1.5,1,0,0,3,0,1.0
2790,9,2790,2.5,0,0,0,3,0,2.0
1460,7,1460,2.0,0,0,0,3,0,1.0
2150,8,2150,2.5,0,0,0,4,0,2.0
1540,7,1540,1.75,0,0,0,4,0,1.0
9200,13,6200,5.75,1,0,3000,5,0,2.0
2430,7,1580,1.75,0,0,850,4,0,1.0
1140,7,1140,1.0,0,0,0,2,0,1.0
2020,7,1010,1.0,0,0,1010,2,0,1.0
2160,8,2160,2.5,0,0,0,4,0,2.0
860,6,860,1.0,0,0,0,2,0,1.0
1740,7,910,2.25,0,0,830,3,0,1.0
2020,9,1730,2.5,0,0,290,4,0,2.0
3931,10,2650,3.5,0,0,1281,5,0,2.0
1580,7,1580,2.0,0,0,0,4,0,1.0
4040,9,3340,3.0,1,2,700,3,0,1.5
1640,7,1040,1.0,0,0,600,2,0,1.0
1072,7,1072,1.5,0,0,0,3,0,2.0
1640,7,1640,1.0,0,0,0,3,0,1.0
1540,6,1540,2.0,0,0,0,3,0,1.0
2290,8,2290,2.25,0,0,0,3,0,2.0
1500,6,1390,2.0,0,0,110,3,0,1.0
2660,8,2080,1.75,0,0,580,4,0,2.0
1650,8,1650,2.5,0,0,0,3,0,2.0
3190,9,3190,2.5,0,0,0,4,0,2.0
6050,9,4150,4.0,0,2,1900,4,0,2.5
1290,7,1290,2.0,0,0,0,3,0,1.0
1200,7,1200,1.0,0,2,0,3,0,1.0
1560,7,1560,1.75,0,0,0,3,0,1.0
2240,8,1550,1.75,0,0,690,3,0,2.0
1530,8,1290,1.0,0,0,240,3,0,1.0
1900,7,1900,2.25,0,0,0,3,0,2.0
1590,8,1590,2.0,0,3,0,3,0,1.0
4250,10,2150,3.25,0,3,2100,6,0,1.0
2510,7,2510,0.75,0,0,0,3,0,2.0
1140,8,1140,2.25,0,0,0,2,0,3.0
1110,7,1000,1.0,0,0,110,2,0,1.0
1950,7,1250,2.75,0,2,700,4,0,1.0
920,6,920,1.0,0,0,0,3,0,1.0
1500,7,1500,1.75,0,0,0,2,0,1.0
3800,10,3330,2.25,0,0,470,3,0,1.0
1820,8,1640,2.5,0,2,180,3,0,3.0
4320,9,3500,3.5,0,0,820,5,0,2.0
2880,10,2880,2.5,0,0,0,4,0,1.0
1980,8,1780,1.5,0,0,200,4,0,1.5
1370,6,1370,1.5,0,0,0,3,0,1.5
4860,11,3860,3.5,1,0,1000,6,0,2.0
1510,8,1510,1.5,0,0,0,2,0,2.0
3180,8,2120,2.5,0,0,1060,4,0,2.0
3070,9,2730,2.25,0,0,340,5,0,1.0
3400,9,3400,3.5,0,0,0,4,0,2.0
1451,7,1451,2.0,0,0,0,3,0,1.0
1270,8,1270,1.5,0,0,0,3,0,3.0
2570,7,1470,2.5,0,0,1100,5,0,1.0
4260,11,4260,3.0,0,0,0,4,0,2.0
1970,9,1770,3.0,0,3,200,3,1,2.0
5461,9,3265,2.0,0,0,2196,4,0,1.0
3470,10,3470,2.5,0,0,0,4,0,2.0
1150,7,1150,2.0,0,0,0,3,0,1.0
1390,7,1390,1.75,0,0,0,3,0,1.0
1470,8,1090,2.0,1,0,380,3,0,1.0
2180,6,1270,1.75,0,0,910,4,0,1.5
2620,7,2620,2.5,0,0,0,3,0,2.0
2180,7,1090,1.75,0,0,1090,3,0,1.0
2050,7,1280,1.0,0,0,770,4,0,1.0
2660,8,1330,1.75,0,0,1330,3,0,1.0
940,7,940,1.0,0,0,0,3,0,1.0
1900,8,1520,3.5,0,0,380,3,0,2.0
910,6,910,1.0,1,0,0,2,0,1.5
1300,7,900,2.0,0,0,400,3,0,1.0
1470,7,1070,1.75,0,3,400,3,0,1.0
1350,7,1350,1.5,0,0,0,3,0,1.0
1250,7,910,1.75,0,0,340,4,0,1.0
2480,8,1800,1.75,0,0,680,3,0,1.0
1370,6,1370,1.75,0,0,0,2,0,1.0
2030,8,2030,2.5,0,0,0,3,0,2.0
1480,7,1480,1.5,0,0,0,3,0,1.0
1830,8,1130,1.75,0,0,700,4,0,1.0
1450,8,1220,2.5,0,0,230,2,0,2.0
4630,9,3210,4.5,0,0,1420,5,0,2.0
2370,7,1570,1.0,0,0,800,4,0,1.5
1720,7,1720,2.5,0,0,0,3,0,2.0
1300,8,1160,1.5,0,0,140,2,0,2.0
2030,9,1970,2.5,1,0,60,3,0,3.0
3770,8,2550,2.75,0,2,1220,4,0,2.0
1060,6,1060,1.5,0,0,0,3,0,1.0
1020,7,1020,1.0,0,0,0,1,0,1.0
1780,7,1780,1.5,0,0,0,3,0,1.0
2580,8,2580,3.0,0,0,0,4,0,2.0
4860,10,3100,4.25,1,1,1760,5,0,1.5
1255,8,1255,1.75,0,0,0,3,0,3.0
1120,6,730,1.0,0,0,390,2,0,1.0
2250,7,2250,1.75,0,0,0,4,0,1.0
1040,6,1040,1.0,0,0,0,2,0,1.0
1140,7,1140,1.5,0,0,0,3,0,1.5
2580,7,1410,2.5,0,0,1170,5,0,1.0
2518,8,2518,2.5,0,0,0,4,0,2.0
1150,7,1150,2.25,0,0,0,2,0,2.0
1490,7,1200,1.75,0,0,290,3,0,1.0
2170,8,2170,2.5,0,0,0,4,0,2.0
2570,8,2570,2.5,0,0,0,3,0,2.0
2500,8,2500,3.0,0,0,0,3,0,2.0
2110,8,2110,2.5,0,0,0,3,0,2.0
3281,9,3281,2.5,0,0,0,4,0,2.0
1690,7,1400,2.75,0,0,290,4,0,1.5
1250,6,1250,1.0,0,0,0,3,0,1.0
1540,7,1210,2.75,0,0,330,3,0,1.0
1130,6,1130,1.0,0,0,0,3,0,1.0
1700,8,1260,3.5,0,0,440,3,0,2.0
1040,7,1040,1.0,0,0,0,3,0,1.0
1850,8,1850,2.25,0,0,0,4,0,2.5
970,6,970,1.0,0,0,0,2,0,1.0
1600,7,1600,2.0,0,0,0,2,0,1.0
1230,7,1230,1.0,0,0,0,3,0,1.0
3530,8,2630,4.0,0,0,900,4,0,2.0
3480,10,2630,2.75,1,2,850,4,0,2.0
2980,8,2980,2.5,0,0,0,3,0,2.0
880,7,880,1.0,0,0,0,2,0,2.0
4700,11,2660,3.5,1,2,2040,4,0,1.0
1110,7,1110,1.0,0,0,0,3,0,1.0
1380,6,1380,1.5,0,0,0,2,0,1.0
2700,8,2700,2.5,1,0,0,4,0,2.0
3410,9,2760,3.25,0,3,650,5,0,2.0
1820,7,1040,1.75,0,0,780,3,0,1.0
1430,7,990,2.0,0,0,440,3,0,1.0
2350,8,2350,1.75,1,0,0,4,0,1.0
3110,9,3110,2.5,0,0,0,4,0,2.0
3020,10,3020,2.5,0,0,0,4,0,2.0
1070,7,1070,1.0,0,0,0,4,0,1.5
4910,10,3580,2.25,0,0,1330,6,0,2.5
1370,8,1370,3.25,0,0,0,3,0,3.0
1730,7,1730,2.5,0,0,0,3,0,2.0
1640,7,910,1.75,0,0,730,2,0,1.0
3320,10,3320,3.75,0,0,0,4,0,2.0
1250,7,1250,1.5,0,0,0,3,0,1.0
2170,7,2170,1.0,1,0,0,4,0,1.0
2170,7,1570,2.5,0,0,600,4,0,1.0
1530,8,1240,2.25,0,0,290,3,0,2.0
2020,7,1100,1.75,0,0,920,4,0,1.0
2000,7,1100,1.75,0,0,900,4,0,1.0
2630,7,2630,2.5,0,0,0,4,0,2.0
950,7,950,1.0,0,0,0,2,0,1.0
2020,7,2020,1.75,0,0,0,3,0,2.0
3090,10,3090,3.25,0,0,0,4,0,2.0
1260,7,1260,1.75,0,0,0,3,0,1.0
1360,7,1360,2.5,0,0,0,3,0,2.0
950,6,950,1.0,0,0,0,3,0,1.5
1640,7,1180,2.25,0,0,460,3,0,1.0
