sqft_living,grade,sqft_above,bathrooms,quartier,view,sqft_basement,bedrooms,waterfront,floors
1570,7,1070,1.0,0,0,500,3,0,1.0
1780,8,1210,2.5,1,0,570,3,0,1.0
1090,8,1090,1.5,0,0,0,3,0,1.0
2210,8,2210,2.5,0,0,0,4,0,2.0
1800,7,1240,2.5,0,0,560,3,0,2.0
3100,7,2040,2.0,0,0,1060,4,0,1.5
5070,11,5070,3.75,0,0,0,4,0,2.0
1180,8,840,1.0,0,2,340,1,0,1.5
1800,8,1800,2.5,0,0,0,3,0,2.0
3010,8,1780,1.75,0,0,1230,4,0,1.0
2770,7,1700,2.75,0,0,1070,5,0,1.0
1240,7,1240,1.5,0,0,0,3,0,1.0
1990,7,1090,1.75,0,0,900,2,0,1.0
2960,9,2960,2.5,0,3,0,3,1,2.0
2190,8,2190,2.5,0,0,0,4,0,2.0
1520,6,1040,1.0,0,0,480,3,0,1.0
1940,7,1940,1.5,1,0,0,4,0,1.0
2830,9,1910,3.25,0,0,920,4,0,2.0
2160,8,2160,2.5,0,0,0,2,0,1.0
1650,7,860,2.0,0,0,790,4,0,1.0
1810,7,1210,1.75,0,0,600,3,0,1.0
1680,9,1680,2.5,0,0,0,2,0,3.0
2470,8,2470,2.5,0,0,0,4,0,2.0
990,7,990,1.0,0,0,0,2,0,2.0
1270,7,1270,1.75,0,0,0,3,0,1.0
2370,9,1750,3.0,0,0,620,4,0,2.0
2290,9,2290,3.25,0,0,0,4,0,2.0
1200,7,1200,1.75,0,0,0,3,0,1.0
1100,7,1100,2.5,0,0,0,2,0,3.0
2410,8,2070,2.75,0,0,340,4,0,1.5
2800,9,2800,2.5,0,0,0,4,0,2.0
1270,8,1040,2.25,0,0,230,3,0,2.0
2300,7,1560,2.75,0,0,740,4,0,1.0
2060,8,1440,2.25,1,0,620,4,0,1.0
5960,10,3900,3.75,0,4,2060,6,0,2.0
2920,9,2260,2.25,1,0,660,4,0,2.0
3020,8,1920,3.25,1,0,1100,4,0,1.5
1520,8,1240,2.25,0,0,280,3,0,2.0
4250,10,4250,2.75,0,0,0,4,0,2.0
1540,7,1540,1.5,0,0,0,4,0,2.0
3530,10,2370,3.5,0,0,1160,3,0,2.0
760,5,760,1.0,0,0,0,2,0,1.0
1440,7,1440,1.0,0,0,0,4,0,1.5
2590,9,2590,2.5,0,0,0,3,0,2.0
2180,9,1580,2.0,0,4,600,2,1,1.0
1300,8,1300,2.25,0,0,0,3,0,3.0
2400,8,2400,2.5,0,0,0,3,0,2.0
1390,7,1390,1.0,0,0,0,4,0,1.0
2980,9,2230,1.75,0,0,750,5,0,1.0
2530,7,2530,2.5,0,0,0,5,0,2.0
2100,7,2100,1.5,0,0,0,3,0,1.0
1300,7,1300,1.0,0,0,0,3,0,1.0
2740,8,2740,2.5,0,2,0,4,0,1.5
1880,8,1880,2.0,0,0,0,4,0,1.0
1900,7,1390,1.75,0,0,510,3,0,1.0
3550,9,3550,2.75,0,0,0,4,0,2.0
2470,9,2470,2.5,0,0,0,4,0,2.0
940,6,940,1.0,0,0,0,2,0,1.0
4490,12,4490,3.75,0,0,0,4,0,2.0
1852,7,1852,2.5,0,0,0,3,0,2.0
1820,8,1620,3.0,0,0,200,3,0,1.5
1580,7,1050,2.0,0,0,530,3,0,1.0
1600,8,1250,1.5,0,0,350,3,0,1.5
2310,8,1330,2.75,0,2,980,4,0,1.0
2500,7,1730,1.5,0,0,770,3,0,1.5
750,6,750,1.0,0,0,0,1,0,1.0
1320,6,660,2.5,0,0,660,3,0,1.0
680,5,680,1.0,0,0,0,2,0,1.0
3940,9,3440,3.25,0,3,500,4,0,2.0
2020,8,1350,3.0,0,0,670,2,0,1.0
3320,10,3320,3.75,1,0,0,4,0,2.0
990,6,990,1.0,0,0,0,3,0,1.0
2490,7,1400,2.25,0,1,1090,4,0,1.0
1600,8,1600,2.5,0,0,0,3,0,2.0
1820,7,1320,2.25,0,0,500,3,0,1.0
3780,8,3780,2.5,0,0,0,4,0,2.0
1370,7,1110,2.0,0,0,260,3,0,1.0
1010,7,1010,1.0,0,0,0,3,0,1.0
2200,8,2200,2.5,0,0,0,3,0,2.0
800,7,800,1.0,0,0,0,2,0,1.0
2050,7,1470,2.0,0,0,580,5,0,1.5
2240,8,2240,2.75,0,0,0,4,0,1.5
1650,7,1650,1.5,0,0,0,4,0,1.5
970,7,970,1.0,0,0,0,3,0,1.0
1600,8,1600,2.5,0,0,0,3,0,2.0
2060,7,1310,2.75,0,0,750,4,0,1.0
1720,7,1160,2.0,0,0,560,3,0,1.0
2360,7,1780,3.0,0,1,580,3,0,2.0
880,8,880,1.0,0,0,0,2,0,2.0
1830,8,1300,1.75,0,0,530,3,0,1.0
1350,7,1350,1.5,0,0,0,3,0,1.0
3400,8,3400,2.5,0,1,0,5,0,2.0
1980,8,1980,3.0,0,0,0,4,0,2.5
1630,7,1630,2.0,0,0,0,3,0,1.0
2820,8,2820,2.25,0,0,0,3,0,2.0
1870,7,970,1.75,0,0,900,3,0,1.0
3020,9,2540,2.5,0,0,480,4,0,2.0
3450,10,3450,3.0,0,0,0,3,0,2.0
1600,6,1600,1.5,0,0,0,4,0,2.0
1300,6,1300,1.0,0,0,0,3,0,1.0
1070,6,1070,1.75,0,0,0,3,0,1.0
2940,10,2940,2.5,0,0,0,4,0,2.0
1870,8,1870,2.0,0,0,0,3,0,1.0
3510,8,2210,2.0,0,2,1300,4,0,1.0
2500,8,1500,1.75,1,0,1000,4,0,1.0
3730,9,2230,3.0,0,0,1500,3,0,1.5
1610,8,1610,2.0,0,0,0,3,0,1.0
2880,7,2080,2.0,0,0,800,3,0,1.5
1590,8,1590,1.75,0,0,0,3,0,1.0
1170,8,1170,1.5,0,0,0,2,0,3.0
2270,8,1720,2.25,1,0,550,4,0,1.0
3150,9,3150,2.5,0,0,0,4,0,2.0
2440,8,1890,3.0,0,0,550,4,0,2.0
1260,7,1260,1.0,0,0,0,3,0,1.0
1070,7,1070,1.75,0,0,0,3,0,1.0
1670,8,1670,1.75,0,0,0,4,0,1.0
3100,9,3100,2.5,0,0,0,4,0,2.0
860,6,860,1.0,0,0,0,2,0,1.0
1320,7,1320,1.5,0,0,0,3,0,1.0
2010,7,1450,2.0,0,0,560,2,0,1.5
2260,7,1200,1.5,0,0,1060,3,0,1.0
1340,6,1340,2.0,0,0,0,3,0,1.0
2510,9,2510,2.5,0,2,0,4,0,2.0
2410,7,1220,1.75,0,0,1190,4,0,1.0
1990,7,1990,1.5,0,4,0,3,1,1.5
1010,6,1010,1.0,0,0,0,3,0,1.0
2240,7,2240,2.5,0,0,0,3,0,2.0
2150,8,2150,2.5,0,0,0,3,0,2.0
1280,6,920,1.0,0,0,360,3,0,1.0
2060,8,2060,1.5,0,0,0,3,0,1.0
2130,8,1570,2.25,0,0,560,3,0,1.0
2430,8,2430,2.25,1,0,0,4,0,2.0
1160,7,1160,2.0,0,0,0,3,0,1.0
2320,7,2320,2.5,0,0,0,4,0,2.0
2490,10,2490,3.0,0,4,0,3,1,2.0
900,6,900,1.0,0,0,0,1,0,1.0
2840,8,1780,2.25,0,0,1060,4,0,1.0
1630,7,1160,1.5,0,1,470,3,0,1.0
1630,7,1630,2.25,0,0,0,3,0,2.0
1240,6,960,1.0,0,0,280,2,0,1.0
2240,8,1620,1.5,0,0,620,3,0,1.0
3440,10,2190,2.25,1,3,1250,3,0,2.0
960,6,960,1.0,0,0,0,2,0,1.0
990,4,990,1.0,0,0,0,2,0,1.0
1690,8,1690,2.5,0,0,0,3,0,2.5
3370,8,1770,2.5,0,0,1600,6,0,1.0
1620,7,1290,2.0,0,0,330,3,0,1.0
3010,9,2570,2.75,0,2,440,4,0,2.0
2820,9,2820,2.5,0,0,0,4,0,2.0
2290,9,1650,1.75,0,0,640,3,0,1.0
1590,7,1590,2.0,0,0,0,4,0,1.5
2170,8,1450,1.75,0,0,720,3,0,1.0
1640,7,1640,1.75,0,0,0,3,0,1.0
2090,8,1450,3.0,0,0,640,3,0,1.0
3150,10,3150,2.5,0,0,0,3,0,2.0
2170,8,1290,2.75,0,0,880,4,0,1.0
1130,7,1130,1.5,0,0,0,3,0,1.0
3670,10,2530,2.5,0,4,1140,3,0,1.0
2100,8,2100,1.75,0,0,0,4,0,2.0
3300,8,3300,4.5,0,0,0,6,0,2.0
1530,7,1530,1.0,0,0,0,3,0,1.0
2740,10,2740,2.5,0,0,0,4,0,2.0
1250,7,1250,1.0,0,0,0,3,0,1.0
3240,9,3240,2.5,1,0,0,4,0,2.0
2410,8,1550,2.5,0,0,860,4,0,1.0
1610,8,1610,2.0,0,2,0,3,0,2.0
3270,8,1690,2.5,0,0,1580,4,0,1.0
1310,7,1310,1.0,0,0,0,3,0,1.0
1770,7,1030,1.75,0,0,740,3,0,1.0
990,6,990,1.0,0,0,0,3,0,1.0
2280,8,1360,1.75,0,3,920,3,0,1.0
2060,7,1350,1.75,0,0,710,3,0,1.0
1060,7,1060,1.0,0,0,0,3,0,1.0
1620,8,1620,1.75,0,0,0,4,0,1.0
2090,7,1790,1.5,0,0,300,3,0,1.0
1320,7,1320,2.25,0,0,0,3,0,2.0
1300,7,1300,1.5,0,0,0,3,0,1.5
2260,10,2260,2.5,0,0,0,3,0,2.0
3800,10,3800,3.25,1,0,0,4,0,2.0
1440,7,1050,1.75,0,0,390,3,0,1.0
1470,8,1470,2.0,0,0,0,3,0,1.0
2770,7,1470,1.75,1,0,1300,4,0,1.0
2020,7,2020,2.5,0,0,0,4,0,2.0
2110,6,1080,2.0,0,0,1030,3,0,1.0
1250,7,1250,1.75,0,0,0,3,0,1.0
3160,7,1870,2.0,0,0,1290,5,0,1.5
1760,8,1760,1.75,0,0,0,4,0,1.0
1810,8,1370,1.75,0,0,440,3,0,1.0
1070,7,1070,1.0,0,0,0,2,0,1.0
1250,7,1250,1.75,0,0,0,3,0,1.0
5770,11,5770,4.25,1,4,0,4,1,2.0
2280,7,2280,2.5,0,0,0,4,0,2.0
960,6,960,1.0,0,0,0,2,0,1.0
1640,7,1060,2.0,0,0,580,3,0,1.0
2110,7,2110,2.5,0,0,0,3,0,1.0
2990,8,2090,2.75,0,0,900,4,0,1.5
3990,10,2300,3.5,0,2,1690,4,0,1.0
1980,8,1980,2.5,0,2,0,3,0,3.0
1240,7,1240,1.5,0,0,0,3,0,1.0
2420,8,1220,2.75,0,0,1200,4,0,1.0
2930,8,2930,2.5,0,0,0,4,0,2.0
1380,8,1160,2.5,0,0,220,3,0,2.0
2670,7,1640,2.25,0,0,1030,3,0,1.0
1500,6,1500,1.0,0,0,0,3,0,1.0
840,7,840,1.0,0,2,0,2,0,1.0
2120,8,1640,1.75,0,0,480,4,0,1.0
1670,8,1670,2.25,0,3,0,3,0,1.5
1880,7,1090,1.75,0,0,790,4,0,1.5
1710,7,1360,1.75,0,0,350,3,0,1.0
1470,7,930,2.5,0,0,540,3,0,1.0
1720,7,1720,1.75,0,0,0,3,0,1.0
2940,9,2230,3.0,0,0,710,3,0,2.0
2290,8,1390,1.75,0,0,900,3,0,1.0
1350,7,1350,1.5,0,0,0,3,0,1.0
1290,7,1290,1.75,0,0,0,3,0,1.0
2840,9,2200,2.75,0,0,640,3,0,1.0
2640,7,2640,2.5,0,0,0,4,0,2.0
1820,7,1690,1.75,0,3,130,4,0,1.5
1130,7,1130,1.0,0,0,0,2,0,1.0
3190,9,3190,2.75,0,0,0,4,0,2.0
2350,7,1340,3.5,0,2,1010,3,0,1.0
1260,6,720,1.0,0,0,540,3,0,1.0
1690,7,1690,1.0,0,0,0,4,0,1.5
2340,8,1590,1.75,0,0,750,4,0,1.0
2780,10,2780,2.5,0,0,0,3,0,1.0
980,7,980,1.0,0,0,0,2,0,1.0
1020,7,1020,1.5,0,0,0,3,0,1.0
1810,7,1810,2.5,0,0,0,0,0,2.0
1690,7,1690,1.0,0,0,0,3,0,1.0
1670,8,1670,1.0,0,0,0,5,0,1.5
1700,6,970,2.0,0,0,730,3,0,1.0
3910,9,2890,3.0,1,0,1020,5,0,1.0
1810,7,1030,1.5,0,0,780,3,0,1.0
2830,8,1430,2.75,0,0,1400,6,0,1.0
5780,11,4130,4.0,1,0,1650,4,0,2.0
2180,8,1380,1.75,0,2,800,3,0,1.0
2670,8,2020,3.75,0,4,650,3,0,2.5
960,6,960,1.0,0,0,0,3,0,1.0
2020,7,1010,2.0,0,0,1010,3,0,1.0
2780,8,2110,2.5,0,1,670,3,0,1.5
1120,5,860,1.0,0,0,260,4,0,1.0
1850,7,1850,1.0,0,0,0,3,0,1.5
1760,7,1760,1.75,0,3,0,3,0,1.5
1510,7,1510,1.75,0,0,0,4,0,1.5
1290,8,1290,2.0,0,0,0,3,0,3.0
1960,8,1960,2.25,0,0,0,4,0,2.0
1190,6,1190,2.0,0,0,0,3,0,1.5
1630,7,1630,2.0,0,0,0,3,0,1.0
1870,7,1870,2.5,0,0,0,3,0,2.0
2060,7,2060,2.5,0,0,0,4,0,2.0
1740,7,1740,1.75,0,0,0,4,0,1.0
2290,8,1890,3.0,0,0,400,3,0,2.5
2950,10,2270,3.5,0,0,680,4,0,2.0
2020,7,1070,2.5,0,0,950,4,0,1.0
1970,8,1970,2.5,0,0,0,3,0,2.0
1000,7,1000,1.0,0,0,0,3,0,1.0
1740,8,1310,3.5,0,3,430,3,0,2.0
2240,8,1460,2.75,1,0,780,4,0,1.0
1470,7,1470,2.5,0,0,0,3,0,2.0
3730,10,3730,2.5,1,0,0,4,0,2.0
4720,11,3210,4.25,0,0,1510,5,0,2.0
900,7,900,1.0,0,0,0,2,0,1.0
1610,7,1090,1.0,0,0,520,3,0,1.0
2100,7,1240,2.5,0,2,860,4,0,1.0
2620,7,1400,2.5,0,0,1220,5,0,1.0
3230,9,3230,2.5,0,0,0,4,0,2.0
2420,8,2420,2.5,0,0,0,3,0,2.0
1810,7,1810,2.5,0,0,0,3,0,3.0
970,6,970,1.0,0,0,0,2,0,1.0
2000,6,1150,2.5,0,0,850,5,0,1.0
1390,7,1390,1.0,0,0,0,3,0,1.5
1260,8,1260,2.5,0,0,0,3,0,2.0
880,5,880,1.0,0,0,0,3,0,1.0
1100,7,1100,1.0,0,0,0,2,0,1.0
1730,7,1730,3.0,0,0,0,3,0,3.0
2170,9,1650,3.25,1,0,520,3,0,1.5
1750,7,1750,1.0,0,0,0,4,0,1.0
1870,8,1870,2.5,0,0,0,3,0,2.0
3950,11,3950,3.5,1,0,0,4,0,2.0
1490,7,1490,1.0,0,0,0,3,0,1.0
1900,8,1900,2.5,0,0,0,3,0,2.0
3410,9,2680,3.0,0,2,730,4,0,2.0
1310,7,1310,1.75,0,0,0,3,0,2.0
2550,10,2550,2.5,0,2,0,3,0,2.0
2980,8,1800,2.5,0,4,1180,4,1,1.5
1320,7,1320,1.75,0,0,0,2,0,1.5
2190,7,1260,2.0,0,2,930,3,0,1.0
3350,8,2550,2.5,0,0,800,3,0,2.0
1290,7,1290,1.75,0,0,0,3,0,1.0
1470,8,1470,2.5,0,0,0,2,0,2.0
2730,8,2000,3.5,0,0,730,4,0,2.0
1620,6,1620,2.5,0,2,0,3,0,1.0
740,6,740,1.0,0,0,0,2,0,1.0
1230,7,1230,1.0,0,0,0,3,0,1.0
2110,8,2110,2.5,0,0,0,4,0,2.0
3060,8,3060,3.0,0,0,0,4,0,2.0
1340,7,1340,1.5,1,0,0,3,0,1.0
1750,5,1750,2.0,0,0,0,3,0,1.5
3040,9,2320,2.75,0,3,720,4,0,2.0
2660,7,2660,1.5,0,0,0,7,0,1.5
2390,8,1740,2.25,1,0,650,4,0,1.0
1130,6,1130,1.0,0,0,0,2,0,1.5
1750,7,1750,2.5,0,0,0,3,0,2.0
1870,7,1120,2.0,0,0,750,3,0,1.0
1510,7,1510,1.0,0,0,0,3,0,1.0
1300,7,1300,1.0,0,0,0,2,0,1.0
2740,8,2740,2.5,0,0,0,4,0,2.0
3350,8,2610,3.5,0,2,740,4,0,2.0
980,7,980,1.0,0,0,0,2,0,1.0
1150,7,1150,1.0,0,0,0,3,0,1.0
2120,7,1380,1.75,0,0,740,3,0,1.0
1580,6,800,2.0,0,0,780,3,0,1.0
5450,11,5450,5.0,1,0,0,5,0,2.0
6040,11,4100,4.5,0,0,1940,6,0,2.0
1820,7,1120,2.0,0,0,700,3,0,1.0
1170,8,1070,1.5,0,0,100,1,0,2.0
1120,7,1120,1.75,0,0,0,3,0,1.5
2010,6,2010,2.0,0,0,0,3,0,2.0
2620,9,2620,2.75,1,1,0,3,0,1.0
1910,8,1910,2.5,0,0,0,4,0,3.0
830,7,830,1.5,0,0,0,2,0,2.0
2270,9,2270,2.5,0,0,0,4,0,2.0
2120,9,2120,2.5,0,1,0,3,0,1.0
3780,9,3110,3.5,0,0,670,4,0,2.0
2340,8,2340,2.5,1,0,0,4,0,1.0
2700,9,2700,1.5,0,0,0,4,0,1.5
1340,7,1340,1.0,0,0,0,4,0,1.0
1340,8,940,2.5,0,0,400,2,0,2.0
1580,7,1580,1.75,0,0,0,3,0,1.0
2310,7,1410,2.75,0,0,900,4,0,1.0
1340,7,1340,2.0,0,0,0,3,0,1.5
2575,8,2575,2.5,0,0,0,4,0,2.0
3790,10,2530,3.75,1,0,1260,4,0,2.0
910,7,910,1.0,0,0,0,2,0,1.0
900,6,900,1.0,0,0,0,1,0,1.0
2490,8,2490,2.25,1,0,0,3,0,2.0
2120,8,2120,2.5,0,0,0,4,0,2.0
1788,7,1788,2.5,0,0,0,4,0,2.0
2900,8,1890,3.25,0,0,1010,5,0,1.0
1800,7,1200,1.0,0,0,600,2,0,1.0
2700,7,1350,2.5,0,3,1350,3,0,1.0
2790,10,2790,2.75,0,0,0,4,0,2.0
860,6,860,1.0,0,0,0,3,0,1.0
2760,8,2760,3.5,0,0,0,5,0,2.5
770,6,770,1.0,0,0,0,2,0,1.0
2190,8,1800,2.25,0,0,390,4,0,2.0
2380,8,2380,2.25,0,0,0,4,0,1.0
1740,8,1740,2.5,0,0,0,3,0,2.0
1396,7,1396,1.0,0,0,0,2,0,1.0
1810,7,1350,2.5,0,0,460,3,0,2.0
2250,8,2250,2.5,0,0,0,4,0,2.0
940,5,940,1.0,0,0,0,2,0,1.0
2440,8,1480,2.5,1,0,960,4,0,1.0
1160,8,1160,2.5,0,0,0,2,0,3.0
3160,8,3160,3.25,0,0,0,5,0,2.0
1780,7,1060,2.25,0,0,720,4,0,1.0
1710,8,1570,2.5,0,0,140,3,0,2.0
2450,8,1540,1.75,0,2,910,3,0,1.0
1000,7,1000,1.0,0,0,0,3,0,1.0
1580,8,1580,2.5,0,0,0,3,0,2.0
2860,9,2860,2.5,0,0,0,4,0,2.0
2020,7,2020,1.5,0,0,0,4,0,2.0
2220,7,1390,2.0,0,0,830,5,0,1.5
1600,7,1600,2.5,0,0,0,3,0,2.0
2150,7,1110,1.75,0,0,1040,4,0,1.0
2310,8,2310,2.5,0,0,0,4,0,2.0
3980,11,3980,2.75,0,0,0,4,0,2.0
2400,7,1600,3.0,0,2,800,4,0,2.0
3550,10,3550,2.5,0,0,0,4,0,2.0
920,6,920,1.0,0,0,0,2,0,1.0
2920,8,2920,2.5,0,3,0,3,0,2.0
2000,6,2000,1.75,1,0,0,3,0,1.0
2510,8,1600,2.75,0,1,910,5,0,1.0
3700,11,3700,2.5,0,0,0,4,0,2.0
2610,9,2610,2.5,0,0,0,3,0,2.0
1650,8,1650,2.5,0,0,0,3,0,2.0
3490,9,3490,3.75,1,0,0,4,0,2.0
2220,8,2220,1.75,0,3,0,4,0,2.0
1210,7,1210,1.0,0,0,0,4,0,1.5
760,6,760,1.0,0,0,0,2,0,1.0
2530,9,2100,4.0,0,2,430,4,0,3.0
1710,7,910,1.75,0,0,800,4,0,1.0
2590,8,1720,2.0,0,0,870,3,0,1.0
2330,9,1920,3.0,0,0,410,4,0,2.0
2310,8,2310,2.5,0,0,0,3,0,2.0
1770,8,1160,1.5,1,0,610,3,0,1.0
1400,7,1400,1.75,0,0,0,3,0,1.0
3020,8,2840,4.0,0,4,180,6,1,2.0
1230,8,960,2.25,0,0,270,2,0,2.0
2520,8,1630,2.5,0,0,890,3,0,1.0
2340,9,2340,2.5,0,0,0,4,0,2.0
2320,7,1160,1.0,0,0,1160,3,0,1.0
2280,8,2280,2.5,0,0,0,4,0,2.0
1130,6,1130,1.0,0,0,0,2,0,1.0
3002,8,3002,2.5,0,0,0,4,0,2.0
2620,8,2620,2.75,0,0,0,4,0,2.0
2340,8,2340,2.5,0,0,0,4,0,2.0
2390,7,2390,1.5,0,2,0,4,0,1.5
1860,9,1860,3.25,0,0,0,4,0,2.0
1860,8,1860,2.5,0,0,0,3,0,2.0
3540,10,3540,2.5,0,0,0,3,0,2.0
1800,7,990,1.75,0,3,810,2,0,1.0
820,6,820,1.0,0,1,0,2,0,1.0
1170,7,1170,2.25,0,0,0,2,0,2.0
1620,7,1220,1.75,0,0,400,3,0,1.0
1690,8,1690,2.5,0,1,0,3,0,1.5
1620,7,1380,1.75,0,3,240,4,0,1.0
2440,8,1740,1.75,0,4,700,5,0,1.5
1400,7,1400,1.75,0,0,0,3,0,1.0
1780,8,1080,2.5,0,0,700,3,0,2.0
1380,7,1380,1.0,0,0,0,3,0,1.0
1680,8,1680,2.5,0,0,0,3,0,2.0
3870,9,3870,2.5,0,3,0,3,0,2.0
2980,11,2980,2.5,0,0,0,3,0,1.5
790,6,790,1.0,0,0,0,1,0,1.0
940,6,940,1.0,0,0,0,2,0,1.0
1490,7,1490,2.25,0,0,0,3,0,2.0
2830,7,1630,2.75,1,0,1200,5,0,1.0
1700,8,1700,2.5,1,0,0,4,0,2.0
2040,8,2040,2.5,0,0,0,4,0,2.0
2650,9,2650,2.5,0,0,0,4,0,2.0
1110,7,980,2.0,0,0,130,2,0,3.0
620,5,620,1.0,0,0,0,1,0,1.0
6260,11,4840,6.5,0,0,1420,6,0,2.0
1100,7,750,2.75,0,0,350,2,0,2.0
1650,7,950,1.0,0,0,700,2,0,1.0
1490,7,1220,2.25,0,0,270,3,0,2.0
2480,10,2480,2.5,0,0,0,4,0,2.0
1670,7,1670,2.25,0,0,0,3,0,2.0
3050,9,3050,2.5,0,0,0,3,0,1.0
1790,8,1790,2.5,0,0,0,2,0,2.0
2640,7,2080,2.25,0,0,560,4,0,2.0
1570,7,1570,1.0,0,0,0,3,0,1.0
1130,6,1130,1.0,0,0,0,3,0,1.0
2200,7,1100,1.75,0,0,1100,4,0,1.0
920,8,920,1.0,0,0,0,2,0,1.0
2790,8,1600,3.0,0,4,1190,3,1,2.0
2180,8,2180,2.75,0,0,0,4,0,2.0
3800,9,3800,2.75,0,0,0,4,0,2.0
2910,8,2910,2.5,0,0,0,4,0,2.0
1060,7,960,1.0,0,0,100,2,0,1.0
2350,8,1510,1.75,0,0,840,5,0,1.0
1320,8,1270,2.5,0,0,50,3,0,2.0
1290,6,890,1.0,0,0,400,2,0,1.0
2980,9,2980,2.5,0,2,0,4,0,2.0
2970,9,2970,2.5,0,0,0,4,0,2.0
3070,9,2030,3.5,0,0,1040,4,0,2.0
2310,8,2010,2.5,0,4,300,4,0,2.0
2080,8,1240,2.75,0,0,840,4,0,1.0
2155,8,2155,2.5,0,0,0,4,0,2.0
3940,9,3940,3.75,1,3,0,5,0,1.5
2360,6,1180,2.0,0,0,1180,4,0,1.0
1190,6,1190,1.0,0,0,0,3,0,1.0
1060,6,1060,1.0,0,2,0,2,0,1.0
1914,8,1914,2.5,0,0,0,4,0,2.0
1560,6,780,1.75,0,0,780,2,0,1.0
870,7,870,1.0,0,0,0,2,0,1.0
3380,8,3380,3.5,0,0,0,4,0,2.0
1240,6,1240,1.5,0,0,0,3,0,1.0
990,7,990,1.0,0,0,0,3,0,1.0
1780,8,1780,2.25,0,0,0,3,0,2.0
1440,7,1440,1.5,0,0,0,3,0,1.0
2390,9,1690,1.5,0,0,700,3,0,1.5
1460,8,1050,2.25,0,0,410,3,0,2.0
2810,8,1440,2.75,0,0,1370,5,0,1.0
960,7,960,1.0,0,0,0,3,0,1.0
3260,8,3260,2.75,0,0,0,5,0,2.0
1780,8,1420,1.75,0,0,360,3,0,1.0
3520,8,1530,1.75,0,4,1990,3,0,1.0
2730,8,2730,2.5,0,0,0,4,0,2.0
2220,8,2220,2.5,0,0,0,4,0,2.0
2850,8,2240,3.0,0,0,610,3,0,1.0
1710,8,1710,2.5,0,0,0,5,0,2.0
2300,7,1280,2.25,0,0,1020,4,0,1.0
3380,10,3380,2.5,1,0,0,4,0,2.0
2880,8,1920,2.25,0,4,960,3,0,2.0
3902,9,2782,4.5,0,4,1120,6,0,3.0
2170,7,2170,2.5,0,0,0,3,0,2.0
1360,7,1360,1.75,0,0,0,4,0,1.5
2050,7,1230,2.5,0,0,820,4,0,1.0
2740,8,1820,2.5,0,2,920,4,0,1.0
1400,6,1280,1.0,0,0,120,3,0,1.0
2230,8,2230,1.5,1,0,0,3,0,2.0
2760,9,2760,3.5,0,2,0,4,0,2.0
2000,8,2000,2.5,0,0,0,4,0,2.0
2470,7,1970,2.0,0,0,500,4,0,2.0
2020,7,1010,2.5,0,0,1010,4,0,1.0
1330,8,1120,3.0,0,0,210,3,0,2.0
1600,7,1600,2.25,0,0,0,4,0,2.0
990,7,990,1.0,0,0,0,3,0,1.0
1070,7,830,1.0,0,0,240,2,0,1.0
2250,9,1880,2.0,1,0,370,3,0,2.0
2150,7,2150,2.5,0,0,0,4,0,2.0
3490,9,1770,2.5,0,3,1720,3,0,1.0
1811,8,1811,2.5,0,0,0,4,0,2.0
1200,7,1200,1.5,0,0,0,3,0,1.0
1800,7,1800,2.5,0,0,0,3,0,2.0
1410,7,1410,1.0,0,0,0,5,0,1.0
5770,12,4500,4.75,1,3,1270,6,0,2.0
5040,10,3420,4.25,0,3,1620,4,0,1.0
3490,10,2290,2.5,0,4,1200,3,1,1.0
3130,9,3130,2.25,0,0,0,4,0,2.0
2560,8,1280,2.0,0,0,1280,4,0,1.0
3370,8,1770,2.5,0,0,1600,4,0,1.0
1720,7,1470,2.0,0,0,250,4,0,2.0
1310,7,1110,1.75,0,0,200,2,0,1.0
3360,9,3360,1.5,0,0,0,5,0,2.0
1256,7,1256,2.5,0,0,0,3,0,3.0
2020,10,1790,2.0,0,3,230,3,0,1.5
2010,8,1500,1.75,0,0,510,3,0,1.0
1650,7,1650,2.0,0,0,0,3,0,1.0
2680,7,1380,4.0,0,0,1300,4,0,1.0
1250,7,1250,1.0,0,0,0,3,0,1.0
2560,8,1610,2.5,0,0,950,4,0,2.0
2550,7,1300,1.75,0,0,1250,4,0,1.0
1250,7,1250,1.0,0,0,0,2,0,1.0
2040,7,2040,1.75,0,0,0,2,0,1.0
3920,7,2560,2.0,0,0,1360,5,0,1.5
1110,8,1110,1.5,0,0,0,2,0,3.0
2260,7,2260,3.5,0,0,0,4,0,2.0
1780,7,1780,2.5,0,0,0,4,0,2.0
1650,7,1650,2.0,0,0,0,3,0,2.0
2410,9,2220,3.5,0,4,190,6,0,2.0
2030,8,1550,2.75,0,0,480,4,0,1.0
1430,7,1430,2.25,0,0,0,3,0,2.0
2690,9,1890,2.25,0,0,800,4,0,2.0
1180,8,1180,1.75,0,0,0,3,0,1.0
1840,8,1040,1.5,0,0,800,2,0,1.0
3880,10,3880,3.0,1,0,0,5,0,2.0
900,6,900,1.0,0,0,0,3,0,1.0
2440,8,1320,1.75,0,3,1120,3,0,1.0
2940,8,1700,2.25,0,0,1240,5,0,1.0
2460,8,1720,2.25,0,0,740,4,0,1.0
3060,9,3060,2.5,0,0,0,4,0,2.0
2190,8,2190,2.0,0,0,0,4,0,2.5
2040,8,2040,2.5,0,0,0,4,0,2.0
1650,7,1650,2.0,0,0,0,3,0,1.5
830,8,830,1.5,0,0,0,2,0,2.0
2910,9,2910,2.5,1,0,0,4,0,2.0
2250,7,1650,2.0,0,0,600,4,0,1.5
1830,8,1830,2.5,0,0,0,3,0,2.0
1980,7,1470,2.25,0,0,510,4,0,1.0
1510,7,1510,1.0,0,0,0,2,0,1.5
1860,8,1120,2.25,0,0,740,4,0,1.0
2440,7,2440,2.5,0,0,0,4,0,2.0
2130,7,1370,1.75,0,0,760,4,0,1.0
3960,12,3100,3.25,0,2,860,4,0,2.0
1420,7,1420,2.0,0,0,0,3,0,1.0
2140,7,1420,1.75,0,0,720,4,0,1.0
2550,7,1610,1.0,0,1,940,2,0,1.0
1880,7,940,1.75,0,0,940,3,0,1.0
1520,7,990,1.0,0,0,530,3,0,1.0
5545,11,3605,4.0,0,0,1940,4,0,2.0
3090,9,3090,2.5,0,0,0,4,0,2.0
940,6,940,1.0,0,0,0,3,0,1.0
1910,7,1160,2.75,1,0,750,4,0,1.0
1750,6,1750,2.0,0,0,0,4,0,1.0
1250,7,1250,1.0,0,0,0,3,0,1.0
1970,8,1820,2.0,0,0,150,4,0,1.0
1660,7,1660,2.5,0,0,0,3,0,2.0
3080,10,2300,3.5,0,3,780,4,0,2.0
1300,7,1300,1.0,0,0,0,3,0,1.0
4050,10,2150,4.25,1,2,1900,5,0,1.0
2910,9,2210,2.75,0,0,700,4,0,1.0
1290,7,1290,3.25,0,0,0,3,0,3.0
1990,7,1170,1.75,0,0,820,2,0,1.0
5230,10,3740,4.5,1,4,1490,3,1,2.0
1070,7,1070,1.0,0,0,0,3,0,1.0
1640,7,930,2.0,0,0,710,4,0,1.0
1460,7,1460,2.5,0,0,0,3,0,2.0
2290,9,2290,2.5,1,0,0,3,0,2.0
2160,8,2160,2.5,0,0,0,3,0,2.0
1890,8,1890,2.0,1,2,0,3,0,1.0
2980,8,1910,2.75,0,0,1070,4,0,1.0
1330,6,1330,1.0,0,0,0,4,0,1.5
1610,8,1280,2.25,0,0,330,3,0,1.0
990,8,880,2.25,0,0,110,3,0,2.5
1250,6,1250,1.0,0,0,0,3,0,1.5
1370,8,1370,1.75,0,0,0,2,0,1.0
2220,8,1270,1.5,1,0,950,4,0,1.0
2960,9,2960,2.5,0,0,0,4,0,2.0
2880,8,1780,2.5,0,0,1100,4,0,1.0
4960,11,3680,4.25,0,0,1280,4,0,2.5
1480,7,1480,2.5,1,0,0,3,0,2.0
2920,8,2920,2.5,1,0,0,3,0,2.0
3030,8,2600,2.25,0,0,430,5,0,2.0
2970,8,2970,2.25,0,0,0,4,0,2.0
2060,8,2060,2.5,0,0,0,3,0,2.0
1580,7,790,1.75,0,0,790,4,0,1.0
3030,8,1660,2.5,0,0,1370,4,0,1.0
2130,7,1070,2.0,0,0,1060,4,0,1.0
1980,7,1430,1.75,0,0,550,4,0,1.0
9890,13,8860,7.75,1,4,1030,6,0,2.0
1160,7,1160,1.0,0,0,0,2,0,1.5
2150,7,2150,2.5,0,0,0,4,0,2.0
3220,10,3220,2.5,0,0,0,4,0,2.0
2950,9,2950,2.25,0,0,0,3,0,1.5
2610,9,2610,2.5,1,0,0,3,0,2.0
2950,8,2950,2.5,0,0,0,5,0,2.0
2890,8,2890,2.5,0,0,0,4,0,2.0
2080,8,2080,2.25,0,0,0,3,0,2.0
1780,8,1780,2.5,0,0,0,2,0,3.0
2210,8,1490,2.5,0,0,720,4,0,1.0
1300,8,1300,1.75,0,0,0,3,0,1.0
1070,7,950,1.0,0,0,120,3,0,1.0
2329,9,2329,2.5,0,0,0,4,0,2.0
1840,7,1010,2.0,0,0,830,3,0,1.0
2550,9,2550,2.5,0,0,0,3,0,2.0
1930,7,1110,1.75,0,0,820,3,0,1.0
2910,8,1640,2.75,0,0,1270,4,0,1.0
2140,7,1070,1.0,0,0,1070,2,0,1.0
1880,8,1880,2.25,0,0,0,3,0,2.0
1590,7,1090,1.75,0,0,500,3,0,1.0
1320,7,1320,1.75,0,0,0,3,0,1.0
1890,7,1290,1.75,0,0,600,3,0,1.0
2070,7,1230,2.5,0,0,840,4,0,1.0
980,6,980,2.0,0,0,0,3,0,1.0
2060,7,1540,2.25,0,0,520,4,0,1.0
1870,7,1870,1.75,0,0,0,4,0,1.0
1010,6,1010,1.0,0,0,0,2,0,1.0
1630,8,1630,1.0,0,0,0,3,0,1.5
1210,7,1210,1.0,0,0,0,2,0,1.0
1520,7,1520,1.5,0,0,0,2,0,1.0
3480,11,3480,2.5,0,0,0,4,0,1.5
1630,7,1630,2.25,0,0,0,3,0,2.0
1540,7,1540,2.0,0,0,0,4,0,1.0
1730,7,1010,1.0,0,0,720,4,0,1.0
3450,10,2750,3.5,0,0,700,4,0,2.0
2390,9,2390,2.5,0,0,0,4,0,2.0
1560,6,780,1.75,0,0,780,3,0,1.0
1670,7,1670,1.0,0,0,0,2,0,1.0
1710,6,1710,1.0,0,0,0,3,0,1.0
1790,7,1390,2.0,0,0,400,3,0,1.0
1680,8,1680,2.0,0,0,0,2,0,1.0
1800,7,1020,1.0,0,0,780,3,0,1.0
2540,9,1840,2.0,0,0,700,3,0,1.5
790,6,790,1.0,0,0,0,2,0,1.0
2290,7,2170,2.75,0,0,120,4,0,2.0
1435,8,1435,1.75,0,0,0,3,0,1.0
3650,9,2530,2.75,0,2,1120,4,0,2.0
790,6,790,1.0,0,0,0,2,0,1.0
1200,6,1200,1.5,0,0,0,3,0,1.0
1840,8,1840,2.0,0,0,0,3,0,1.0
1880,7,1200,2.0,1,0,680,3,0,1.0
2260,7,1360,1.75,0,0,900,4,0,1.5
2120,7,1190,1.75,0,1,930,4,0,1.0
1440,7,860,1.0,0,0,580,2,0,1.0
4160,11,4160,4.0,0,0,0,3,0,2.0
1510,8,1230,3.25,0,2,280,3,0,2.0
2700,8,1440,2.5,0,0,1260,4,0,1.0
960,6,770,1.0,0,0,190,2,0,1.0
2060,8,1100,1.75,0,4,960,3,0,1.0
1640,7,1640,2.0,0,0,0,3,0,1.0
3190,10,3190,2.75,0,4,0,4,0,2.0
840,6,840,0.75,0,0,0,2,0,1.0
1800,7,1800,1.5,0,0,0,3,0,1.0
1290,7,1290,1.75,0,0,0,3,0,1.0
1430,8,1430,2.5,0,0,0,3,0,3.0
1720,8,1720,1.5,0,0,0,3,0,1.0
1250,7,850,1.0,0,0,400,2,0,1.0
1080,7,1080,1.75,0,0,0,3,0,1.0
3330,10,3330,2.5,0,0,0,4,0,2.0
1860,8,1860,2.5,0,0,0,3,0,2.0
2150,7,1470,1.5,0,0,680,3,0,1.5
2160,8,1170,1.0,0,0,990,2,0,1.0
1890,7,1890,2.0,0,0,0,4,0,1.0
1150,7,770,1.75,0,0,380,2,0,1.0
920,6,920,1.0,0,0,0,3,0,1.0
1600,7,1600,2.0,0,0,0,2,0,1.0
1750,7,1750,1.0,0,0,0,3,0,2.0
860,7,860,1.75,0,0,0,2,0,1.0
1300,6,680,0.75,1,0,620,3,0,1.0
2690,8,2690,3.5,0,0,0,3,0,2.0
1200,7,1200,1.5,0,0,0,2,0,1.0
3400,9,3400,2.25,0,1,0,3,0,1.0
2320,8,1670,2.75,0,0,650,4,0,1.0
2620,9,2620,2.5,0,0,0,4,0,2.0
2920,10,2920,2.5,0,0,0,3,0,3.0
1020,7,1020,1.0,0,0,0,1,0,1.0
1690,7,1690,1.75,0,0,0,3,0,1.0
7080,12,5760,5.5,1,0,1320,4,0,2.0
1660,7,1110,1.0,0,0,550,3,0,1.0
1410,7,1410,1.0,0,0,0,3,0,1.0
1390,6,910,1.0,0,0,480,2,0,1.0
1720,8,1720,2.5,0,0,0,3,0,2.0
910,7,910,1.0,0,0,0,3,0,1.0
1930,8,1510,1.75,0,0,420,4,0,1.0
1740,7,1600,1.5,0,0,140,3,0,1.0
1360,7,1360,1.0,0,0,0,4,0,1.5
1890,7,1890,1.75,0,0,0,3,0,1.0
2700,10,2700,2.75,1,1,0,3,0,1.5
2100,7,1350,1.75,0,0,750,3,0,1.5
1520,8,1520,2.5,0,0,0,3,0,3.0
2090,8,2090,2.5,0,0,0,3,0,2.0
2290,9,2120,2.25,0,0,170,4,0,2.0
4020,10,4020,3.0,0,2,0,3,0,1.5
2380,8,1670,3.5,0,3,710,3,0,2.0
2080,7,2080,1.75,0,1,0,2,0,1.0
1440,8,1140,1.5,0,0,300,2,0,1.0
1980,6,1040,1.75,0,0,940,3,0,1.0
1070,7,1070,1.0,0,0,0,3,0,1.0
2470,6,1970,2.0,0,0,500,4,0,1.5
2730,8,2400,3.5,0,0,330,4,0,2.0
1570,7,1180,2.25,0,0,390,3,0,1.0
1651,8,1341,3.25,0,0,310,3,0,2.0
1580,8,1580,2.5,0,0,0,3,0,2.0
2380,8,1400,1.75,0,0,980,3,0,1.0
1240,8,1240,1.5,0,0,0,3,0,1.0
1996,7,1996,2.5,0,0,0,4,0,2.0
1260,6,1260,1.0,0,0,0,3,0,1.0
1390,7,1010,1.0,0,0,380,2,0,1.0
2900,7,1990,2.25,0,0,910,4,0,2.0
2250,8,2250,2.5,0,0,0,4,0,2.0
2910,8,2910,2.5,0,0,0,4,0,2.0
1220,6,1220,1.75,0,0,0,2,0,1.0
2580,7,1360,1.5,0,0,1220,3,0,1.0
1820,7,1220,2.75,0,0,600,4,0,1.0
2770,9,2770,2.5,0,0,0,4,0,2.0
2680,9,2680,2.5,0,0,0,2,0,1.0
1280,7,1280,1.5,0,0,0,3,0,1.0
2530,7,1290,2.5,0,0,1240,5,0,1.0
2650,8,2650,2.5,0,0,0,4,0,2.0
3870,9,2970,3.25,0,2,900,3,0,2.0
3170,9,3170,2.5,1,0,0,4,0,2.0
1970,8,1970,2.0,0,0,0,3,0,1.0
2330,10,1870,3.0,1,0,460,2,0,2.0
1600,7,1600,2.5,0,0,0,3,0,2.0
2080,7,1040,1.75,0,0,1040,3,0,1.0
2680,8,2680,2.5,0,0,0,4,0,2.0
1440,7,1440,1.0,0,0,0,3,0,2.0
2680,7,1680,2.5,0,3,1000,4,0,1.5
2210,8,1460,2.25,0,0,750,3,0,1.0
1960,7,1000,2.0,0,0,960,3,0,1.0
1990,8,1540,2.5,0,0,450,3,0,1.0
1570,8,1570,1.0,0,0,0,2,0,1.5
1940,7,1940,1.0,0,0,0,5,0,1.0
2120,8,2120,2.5,0,0,0,3,0,2.0
2300,8,2300,3.0,0,0,0,5,0,2.0
1510,6,860,1.0,0,0,650,3,0,1.0
1440,7,1440,2.5,0,0,0,3,0,2.0
2080,8,2080,2.5,0,0,0,3,0,2.0
2190,7,1390,2.0,0,0,800,5,0,1.0
1690,7,1690,2.0,0,0,0,4,0,1.5
1580,7,1150,1.75,0,0,430,3,0,1.0
2580,8,2580,2.5,1,0,0,4,0,2.0
1500,7,1500,1.75,0,0,0,3,0,1.0
2370,7,2370,2.0,1,0,0,3,0,2.0
1750,8,1750,1.75,0,0,0,3,0,1.0
1360,7,1360,2.5,0,0,0,3,0,2.0
4360,10,2960,3.5,0,3,1400,3,0,2.0
2080,7,1160,2.0,0,0,920,3,0,1.0
2050,7,1300,2.5,0,0,750,4,0,1.0
2130,9,1080,2.75,0,0,1050,3,0,2.0
1090,6,1090,1.5,0,0,0,3,0,1.0
2520,8,2520,2.5,0,0,0,4,0,2.0
2230,7,1330,3.0,0,0,900,5,0,1.0
1370,7,1370,1.75,0,0,0,3,0,1.0
2020,7,1320,1.75,0,0,700,5,0,1.5
2630,9,1580,2.5,1,0,1050,3,0,1.0
2600,9,2200,2.5,0,0,400,4,0,1.5
2120,7,1060,2.0,0,0,1060,4,0,1.0
1400,7,1110,1.5,0,0,290,3,0,1.0
1770,7,1630,2.0,0,0,140,4,0,2.0
2140,7,1080,1.75,0,0,1060,4,0,1.0
1930,8,1930,2.5,0,0,0,3,0,2.0
1230,8,1230,1.75,0,0,0,2,0,2.0
1630,6,1030,2.0,0,0,600,4,0,1.5
1650,8,1650,2.5,0,0,0,3,0,3.0
3280,11,3280,2.5,0,3,0,3,1,2.0
1340,7,1340,1.0,0,2,0,4,0,1.5
1090,7,940,2.0,0,0,150,3,0,1.0
3120,9,3120,2.75,0,0,0,4,0,2.0
2520,7,1850,2.25,0,0,670,3,0,2.0
2140,7,1000,1.75,1,0,1140,2,0,1.0
1320,7,1320,2.0,0,0,0,2,0,3.0
2390,8,2390,2.5,0,0,0,4,0,2.0
1870,7,1250,2.5,0,0,620,3,0,1.0
1220,8,1220,2.25,1,2,0,1,0,2.0
1610,7,1610,1.0,0,0,0,3,0,1.0
1400,7,1400,1.0,0,0,0,2,0,1.0
2430,9,2430,2.5,0,0,0,5,0,2.0
2790,8,2790,2.75,0,0,0,4,0,2.0
2190,7,1250,1.75,0,0,940,4,0,1.0
2424,9,2424,2.5,0,0,0,3,0,2.0
3500,9,3500,2.5,0,0,0,4,0,2.0
1500,7,1500,2.5,0,0,0,3,0,2.0
1640,7,1000,2.75,0,0,640,4,0,1.0
1300,7,1300,1.75,0,0,0,3,0,1.0
2360,8,2360,2.0,0,0,0,4,0,2.0
3680,9,2670,3.5,1,0,1010,4,0,2.5
2600,9,1700,2.5,0,0,900,3,0,1.0
1490,7,1010,1.5,0,0,480,3,0,1.0
2480,7,2480,2.5,0,0,0,3,0,2.0
1310,7,1310,2.75,0,0,0,3,0,1.0
2590,9,2590,2.25,1,0,0,4,0,2.0
2500,9,1510,2.5,0,0,990,3,0,1.0
2930,8,2240,2.0,0,0,690,3,0,2.0
1880,7,1280,1.5,0,0,600,4,0,1.0
2300,8,2300,2.75,0,0,0,4,0,1.0
3220,9,2690,2.5,1,2,530,3,0,2.0
2290,9,1950,2.75,1,0,340,3,0,2.0
960,7,960,1.0,0,0,0,2,0,1.0
2160,7,1080,1.75,0,0,1080,3,0,1.0
1990,7,1990,2.0,0,0,0,3,0,1.0
1430,7,1430,1.0,1,0,0,6,0,2.0
1360,7,1360,1.0,0,0,0,4,0,1.0
1100,7,1100,1.75,0,0,0,3,0,1.0
1320,7,880,2.5,0,0,440,3,0,2.0
1500,6,760,1.5,0,0,740,5,0,1.0
2850,9,2850,2.5,1,0,0,4,0,2.0
2200,7,1280,2.75,0,0,920,3,0,1.0
3170,10,3170,2.5,0,0,0,4,0,2.5
910,6,740,1.0,0,0,170,3,0,1.0
1230,7,910,1.5,0,0,320,3,0,1.0
3610,7,3010,2.0,1,0,600,10,0,2.0
1060,6,1060,1.0,0,0,0,2,0,1.0
670,5,670,1.0,0,0,0,2,0,1.0
2100,9,2100,3.5,0,0,0,3,0,2.0
1540,7,1540,1.0,0,0,0,3,0,1.0
520,6,520,1.0,0,0,0,1,0,1.0
1840,8,1840,2.5,0,0,0,4,0,2.0
2440,8,1560,2.5,0,0,880,4,0,1.0
1460,8,1180,2.5,0,0,280,3,0,2.0
2650,7,2650,1.5,0,0,0,4,0,2.0
1180,7,1180,1.0,0,0,0,3,0,1.5
1070,6,1070,1.5,0,0,0,3,0,1.0
2250,8,2250,2.25,0,0,0,4,0,2.0
1330,7,1330,0.75,0,0,0,3,0,1.0
1970,8,1370,1.75,0,3,600,3,0,1.0
2430,9,1430,2.25,1,0,1000,3,0,1.0
2260,8,1660,3.0,0,0,600,3,0,2.0
1950,7,1950,1.75,0,0,0,3,0,1.0
1220,7,1220,1.0,1,0,0,3,0,1.0
700,6,700,1.0,0,0,0,2,0,1.0
1760,7,1400,3.0,0,0,360,3,0,2.0
2450,8,2450,3.0,0,3,0,3,0,1.5
1070,9,720,2.0,0,0,350,2,0,2.0
810,6,810,1.0,0,0,0,2,0,1.0
2303,8,2303,2.5,0,0,0,4,0,2.0
2250,8,2250,2.0,0,0,0,3,0,1.5
1090,8,1090,1.75,0,0,0,2,0,1.0
3080,8,3080,3.0,1,3,0,4,0,2.0
3200,11,3200,2.75,0,0,0,4,0,2.0
2920,8,1620,1.75,1,0,1300,3,0,1.0
950,7,950,1.0,0,0,0,3,0,1.0
3700,8,1850,2.25,0,1,1850,5,0,1.0
3760,10,3760,4.0,1,0,0,5,0,2.0
1320,8,1320,1.5,0,0,0,3,0,3.0
3950,10,3950,3.5,0,0,0,4,0,2.0
1560,7,1560,1.5,0,0,0,3,0,1.0
1500,7,1000,1.75,0,0,500,4,0,1.0
1150,6,1150,1.0,0,0,0,2,0,1.0
1760,6,880,2.0,0,0,880,3,0,1.0
1530,8,1530,2.5,0,0,0,3,0,2.0
1500,6,1500,1.5,0,0,0,3,0,1.5
1130,6,1130,1.0,0,0,0,3,0,1.0
2870,9,2870,2.5,1,0,0,4,0,2.0
2600,9,2600,2.5,0,0,0,4,0,2.0
2140,8,2140,1.75,0,0,0,5,0,1.0
1230,6,830,1.0,0,0,400,1,0,1.0
1643,7,1643,1.5,0,1,0,2,0,1.0
1350,8,1270,2.5,0,0,80,3,0,3.0
1760,7,1760,1.5,0,0,0,2,0,1.0
2690,7,2690,3.5,0,0,0,4,0,2.0
1430,8,980,2.25,0,0,450,3,0,2.0
1980,7,1980,1.5,0,0,0,5,0,1.5
1180,8,1180,2.5,0,0,0,3,0,3.0
3890,10,3890,2.5,0,0,0,4,0,2.0
3150,9,3150,3.0,0,0,0,4,0,2.0
750,6,750,1.0,0,0,0,2,0,1.0
2550,8,2550,3.25,0,0,0,4,0,2.0
2630,8,2630,2.5,0,0,0,4,0,2.0
1580,7,1580,2.5,0,0,0,3,0,2.0
2990,7,1550,2.5,0,0,1440,3,0,1.0
830,7,830,1.0,0,0,0,2,0,1.0
2000,7,2000,2.5,0,0,0,4,0,2.0
2030,7,1530,2.5,0,0,500,4,0,1.0
3920,8,3920,3.75,0,0,0,4,0,3.0
1950,8,1950,1.75,0,0,0,2,0,1.0
1800,8,1800,2.5,0,0,0,3,0,2.0
960,7,960,1.0,0,0,0,3,0,1.0
2560,7,1500,2.75,0,0,1060,4,0,1.0
2900,10,1490,2.5,1,0,1410,3,0,1.0
2940,9,2940,2.5,0,0,0,4,0,2.0
3030,9,3030,2.75,0,0,0,5,0,2.0
2660,7,2660,2.25,0,0,0,5,0,1.5
2280,8,2280,2.25,0,0,0,3,0,2.0
2040,8,2040,2.5,0,0,0,4,0,2.0
1470,8,1310,2.0,0,0,160,3,0,2.0
2560,8,2560,2.5,0,0,0,4,0,2.0
2130,8,1270,2.25,0,0,860,3,0,1.0
2000,8,1480,1.75,0,2,520,3,0,1.0
1410,7,1410,1.75,0,0,0,3,0,1.0
2110,9,1710,2.0,0,0,400,4,0,2.0
2560,7,1880,1.75,0,0,680,4,0,1.0
1510,8,1510,1.75,0,0,0,2,0,1.0
3290,9,3290,2.5,0,0,0,4,0,2.0
1250,7,1250,1.0,0,0,0,3,0,1.0
2200,6,1100,2.75,0,0,1100,3,0,1.0
1470,7,1470,1.5,0,0,0,3,0,1.0
2340,7,1280,1.5,0,0,1060,2,0,1.0
1830,7,930,1.75,0,0,900,3,0,1.0
1380,7,1380,1.75,0,0,0,3,0,1.5
2300,8,2300,2.5,0,0,0,2,0,1.0
1430,7,1070,2.25,0,0,360,3,0,1.0
1910,7,1910,1.75,0,0,0,4,0,1.0
3100,10,3100,2.75,0,0,0,4,0,2.0
890,6,890,1.0,0,0,0,2,0,1.0
2430,8,2430,2.5,0,0,0,4,0,2.0
2230,7,1230,1.75,0,0,1000,5,0,1.0
940,7,940,1.0,0,0,0,2,0,1.0
1460,7,1460,1.75,0,0,0,4,0,1.0
2360,9,2360,2.0,1,0,0,3,0,2.0
1020,6,1020,1.0,1,0,0,3,0,1.0
1700,7,1120,1.75,0,0,580,4,0,1.0
2470,8,2230,2.25,0,0,240,3,0,2.0
660,6,660,1.0,0,0,0,1,0,1.0
1760,7,1760,1.75,0,0,0,4,0,1.5
1250,7,1000,1.0,0,0,250,3,0,1.0
1400,8,1400,2.5,0,0,0,2,0,2.0
1320,7,1320,1.5,0,0,0,3,0,1.0
2150,7,1900,2.75,0,0,250,3,0,1.0
1720,7,1720,1.75,0,0,0,4,0,2.0
2390,8,2390,2.5,0,0,0,3,0,2.0
990,7,990,1.0,0,0,0,2,0,1.0
1500,7,1300,1.0,0,0,200,3,0,2.0
2950,10,2950,2.5,0,0,0,3,0,1.5
770,6,770,1.0,0,0,0,2,0,1.0
1990,7,1990,2.5,0,0,0,4,0,2.0
3580,9,3580,2.5,0,0,0,4,0,2.0
3680,10,2060,3.0,0,3,1620,4,0,1.0
1680,8,1370,4.0,0,0,310,5,0,1.0
2680,7,1530,2.5,0,3,1150,4,0,1.0
2040,7,1190,1.5,0,0,850,4,0,1.0
720,6,720,1.0,0,0,0,2,0,1.0
1580,8,1580,2.25,1,0,0,3,0,1.0
2080,7,1240,2.5,0,0,840,4,0,1.0
1170,7,1170,1.5,0,0,0,2,0,3.0
1500,7,1500,2.0,0,0,0,2,0,3.0
790,6,790,1.0,0,0,0,2,0,1.0
1980,8,1980,2.5,0,0,0,4,0,2.0
2710,8,2230,3.25,0,0,480,5,0,2.0
770,7,770,1.0,0,0,0,2,0,1.0
4820,11,3950,4.5,0,0,870,5,0,2.0
1700,8,1230,1.75,0,0,470,3,0,1.0
2600,9,1890,3.0,0,3,710,3,0,1.5
1340,6,670,2.0,0,0,670,3,0,1.0
1830,8,1830,2.0,1,0,0,3,0,1.0
1210,8,1210,1.0,1,0,0,3,0,2.0
2360,7,1180,2.5,1,0,1180,5,0,1.0
1530,8,1530,2.5,0,0,0,3,0,2.0
2830,9,2460,3.0,0,0,370,5,0,2.0
3000,8,1500,3.5,0,0,1500,6,0,1.0
1690,7,1690,2.0,1,0,0,2,0,2.0
2130,7,1720,1.75,0,0,410,3,0,1.0
1920,9,1920,2.5,0,1,0,3,0,2.0
2860,10,2860,3.5,0,0,0,4,0,3.0
3160,8,2310,2.75,0,3,850,4,0,2.0
710,5,710,1.0,0,1,0,2,0,1.0
2150,7,2150,1.75,0,0,0,3,0,1.0
1800,7,1200,1.0,0,0,600,3,0,1.0
1400,7,1060,1.0,0,0,340,3,0,1.0
2960,10,2960,2.5,0,0,0,4,0,2.0
900,7,900,1.0,0,0,0,3,0,1.0
1730,7,1730,2.0,0,0,0,2,0,2.0
2460,9,1930,2.25,0,4,530,2,0,1.5
2440,9,2440,2.5,0,0,0,3,0,1.0
1210,7,1210,1.5,0,0,0,3,0,1.0
1640,8,1640,2.5,0,0,0,3,0,2.0
1990,8,1180,2.25,0,0,810,4,0,1.0
1860,8,1860,2.5,1,0,0,3,0,2.0
1430,7,1030,1.5,0,0,400,3,0,1.0
2410,8,2410,2.5,0,0,0,4,0,2.0
2930,9,2930,2.75,0,0,0,5,0,2.0
2830,8,1830,3.5,0,0,1000,7,0,1.0
2330,7,2330,2.5,0,0,0,4,0,2.0
1100,7,720,1.0,0,0,380,3,0,1.0
3065,9,3065,3.5,0,0,0,4,0,3.0
1860,8,1220,2.75,0,0,640,4,0,1.0
1420,8,1420,2.25,0,0,0,3,0,3.0
1840,7,1840,2.25,0,0,0,3,0,2.0
1910,8,1910,2.5,0,0,0,4,0,2.0
1940,7,1940,2.5,0,0,0,4,0,2.0
1230,8,1230,2.25,0,0,0,3,0,3.0
1646,7,1646,2.25,0,0,0,3,0,2.0
3000,7,1500,1.75,0,0,1500,5,0,1.0
2220,8,1280,1.75,0,1,940,4,0,1.0
2350,8,2350,2.5,0,0,0,4,0,2.0
1290,8,1290,1.75,0,0,0,2,0,2.0
1990,9,1990,2.25,0,0,0,3,0,3.0
2780,9,2780,2.5,0,0,0,4,0,2.0
2570,7,2170,2.25,0,0,400,3,0,2.0
1170,7,1170,1.0,0,0,0,3,0,1.0
1220,7,1220,1.0,0,0,0,1,0,1.0
1610,7,1610,1.5,0,0,0,3,0,2.0
670,5,670,1.0,0,0,0,2,0,1.0
1570,7,1200,1.75,0,0,370,4,0,1.0
2600,7,1610,1.75,0,0,990,4,0,1.0
4470,10,4470,2.25,0,0,0,4,0,2.0
2242,8,2242,2.5,0,0,0,3,0,2.0
1310,7,1310,2.0,0,0,0,3,0,1.0
1250,7,1250,1.75,0,0,0,2,0,1.0
2160,9,1660,1.75,0,0,500,4,0,1.0
2330,8,2330,2.5,0,0,0,4,0,2.0
2480,7,1300,3.0,0,0,1180,5,0,1.0
2340,9,2340,2.5,0,0,0,4,0,2.0
2320,6,1310,1.0,0,0,1010,4,0,1.5
1000,6,1000,1.0,0,0,0,2,0,1.0
2220,7,1470,1.0,0,0,750,4,0,1.5
2070,7,2070,2.0,1,0,0,4,0,1.0
1300,6,1300,1.0,0,0,0,3,0,1.0
2160,9,2160,2.5,0,0,0,4,0,2.0
1220,6,1220,1.5,0,0,0,2,0,1.0
2510,7,1910,2.5,0,0,600,3,0,1.0
3260,9,2300,3.0,0,0,960,4,0,2.0
2960,7,2960,2.5,0,0,0,4,0,2.0
2360,7,1390,3.0,0,0,970,5,0,1.0
2910,9,2910,2.25,0,0,0,3,0,2.0
2060,7,1220,2.75,0,0,840,5,0,1.0
1010,7,1010,1.75,0,0,0,3,0,1.0
2390,9,2390,2.5,0,0,0,3,0,2.0
4400,11,3390,4.5,1,0,1010,5,0,2.0
2870,8,2870,2.75,0,2,0,3,0,2.0
640,5,640,1.0,0,0,0,1,0,1.0
1700,7,1700,2.5,0,0,0,4,0,2.0
4670,11,4670,4.25,1,2,0,7,0,2.0
2150,8,2150,2.5,0,0,0,4,0,2.0
2030,6,1430,2.0,0,0,600,4,0,1.5
2400,8,2400,2.5,0,0,0,4,0,2.0
1560,7,1560,2.5,0,0,0,4,0,2.0
2120,9,2120,2.0,0,0,0,3,0,1.0
3680,10,2390,2.5,0,0,1290,3,0,1.0
1200,6,1200,2.0,0,0,0,3,0,1.5
1950,7,1350,2.25,0,0,600,3,0,1.0
1920,7,1000,1.75,0,0,920,3,0,1.0
1570,7,1170,1.75,0,0,400,4,0,1.0
3460,10,3460,2.5,0,0,0,4,0,2.0
2160,10,2160,2.25,1,0,0,3,0,2.0
2420,8,920,2.5,0,0,1500,4,0,1.0
1900,7,1900,1.75,0,0,0,3,0,2.0
3370,9,3370,2.5,0,0,0,4,0,2.0
2400,9,2400,2.5,0,0,0,3,0,2.0
2400,7,2400,2.5,0,0,0,4,0,2.0
2390,8,1600,2.5,0,0,790,3,0,1.0
1380,7,1380,1.5,0,0,0,3,0,1.0
2170,7,1920,2.25,0,0,250,4,0,2.0
1980,7,1980,1.0,0,0,0,4,0,1.5
2570,8,2570,2.5,0,0,0,4,0,2.0
1560,7,880,1.75,0,0,680,2,0,1.0
3340,9,3340,2.5,0,0,0,4,0,2.0
910,7,910,1.0,0,0,0,3,0,1.0
1470,7,1470,1.75,0,0,0,3,0,1.0
1890,7,1210,1.75,0,0,680,3,0,1.0
2070,8,2070,2.5,1,0,0,3,0,2.0
2110,8,2110,1.75,0,0,0,4,0,1.0
1720,7,1720,2.5,0,0,0,3,0,2.0
3440,8,3440,3.5,0,0,0,4,0,2.0
2830,7,1710,2.75,0,0,1120,5,0,1.0
1700,7,1700,1.75,0,0,0,4,0,1.0
2250,8,2250,2.5,0,0,0,3,0,2.0
1300,8,1300,2.25,0,0,0,2,0,3.0
1680,8,1680,2.25,0,0,0,3,0,2.0
1850,8,1850,2.5,0,0,0,4,0,2.0
4230,8,2360,4.5,0,3,1870,6,0,2.0
2410,9,1800,2.25,0,2,610,4,0,2.0
1880,8,1760,2.25,0,0,120,4,0,2.0
1240,8,1240,2.25,0,0,0,3,0,3.0
800,6,800,1.0,0,0,0,2,0,1.0
2820,7,1410,3.25,0,0,1410,4,0,1.0
1690,7,1090,1.75,1,0,600,4,0,1.0
1270,7,1270,1.0,1,0,0,3,0,1.0
1260,7,1260,1.0,0,0,0,3,0,1.0
1980,8,1980,1.75,0,0,0,3,0,1.0
1670,7,1670,2.5,0,0,0,4,0,2.0
2870,10,2510,3.75,0,3,360,4,0,2.0
1450,8,1030,2.5,0,0,420,3,0,1.0
2130,9,2130,2.25,0,0,0,4,0,2.0
1010,8,1010,2.0,0,0,0,3,0,1.0
3410,10,3410,2.5,0,0,0,4,0,2.0
1180,7,800,1.5,0,0,380,3,0,1.0
1620,7,1620,1.0,0,0,0,3,0,1.5
960,5,960,1.0,0,0,0,1,0,1.0
1510,7,1510,1.75,0,0,0,3,0,1.0
1670,8,1670,2.25,0,0,0,3,0,1.0
2660,9,2660,2.0,0,0,0,3,0,1.0
1690,7,1690,1.75,1,0,0,3,0,1.0
910,7,910,1.0,0,0,0,2,0,1.0
1120,8,1120,1.5,0,0,0,2,0,2.0
1900,8,1200,2.25,0,0,700,3,0,1.5
2630,8,1330,2.0,0,1,1300,4,0,1.0
1480,6,780,1.0,0,0,700,3,0,1.0
1070,8,880,2.0,0,0,190,1,0,2.0
3910,9,3130,3.5,0,0,780,4,0,2.0
2300,6,2300,2.5,0,0,0,5,0,2.0
1270,7,1270,1.0,0,0,0,2,0,1.5
1370,7,1370,1.75,0,0,0,3,0,1.0
2600,8,2150,2.5,0,4,450,3,1,1.5
1200,7,1200,1.0,0,0,0,4,0,1.5
1280,8,1030,1.75,0,0,250,3,0,1.0
2510,7,1490,2.5,0,0,1020,5,0,1.0
2440,8,1830,2.25,0,2,610,3,0,1.0
3610,11,3290,3.75,0,0,320,4,0,3.0
1750,5,1750,2.0,0,0,0,6,0,1.0
3120,9,1980,2.75,1,2,1140,4,0,1.0
2080,7,1600,1.75,0,0,480,3,0,1.0
1550,6,1550,2.0,0,0,0,3,0,1.0
2260,8,1660,3.0,0,0,600,3,0,2.0
3110,10,3110,2.5,1,3,0,4,0,2.0
880,7,880,1.0,0,0,0,2,0,1.0
2220,10,2010,2.5,0,0,210,3,0,2.0
1580,7,1580,1.75,0,0,0,3,0,1.5
3620,11,2350,3.25,0,3,1270,4,0,2.0
3500,9,2500,3.5,1,0,1000,4,0,2.0
1660,7,1660,1.75,0,0,0,2,0,2.0
2490,9,2490,2.5,0,2,0,4,0,2.0
4460,11,4460,3.5,0,2,0,4,0,2.0
2020,7,2020,2.25,0,0,0,4,0,2.0
3440,7,3440,4.0,0,0,0,7,0,2.0
2140,7,1320,2.75,0,0,820,4,0,1.0
1550,7,1050,1.75,0,0,500,2,0,1.0
2540,10,2540,2.5,0,0,0,3,0,2.0
2550,9,2550,2.25,1,0,0,4,0,2.0
2840,9,1990,3.0,0,2,850,4,0,1.0
1080,7,580,1.75,0,0,500,3,0,1.0
1670,8,1240,2.25,0,0,430,3,0,1.0
2050,7,1170,2.0,0,0,880,3,0,1.0
1920,7,960,1.75,0,0,960,4,0,1.0
1240,7,1240,1.75,1,0,0,5,0,1.0
3820,11,3820,3.0,0,2,0,4,0,2.0
2800,7,1400,2.75,1,0,1400,3,0,1.0
1400,7,1400,1.75,0,0,0,4,0,1.0
1880,7,1880,1.75,0,0,0,3,0,1.0
1450,7,1450,1.0,0,0,0,3,0,2.0
1370,8,950,2.0,0,0,420,2,0,1.0
2510,9,2510,2.5,0,0,0,2,0,2.0
1150,7,1010,1.0,0,1,140,2,0,1.0
2580,7,1730,2.75,1,0,850,5,0,1.0
2900,9,2900,2.5,0,0,0,5,0,2.0
1070,7,1070,1.0,0,0,0,2,0,1.0
3260,10,2170,2.75,1,0,1090,4,0,1.0
3100,10,3100,2.5,0,0,0,3,0,1.0
3630,9,2150,2.5,1,0,1480,3,0,1.0
2740,8,1370,1.75,0,3,1370,6,0,1.0
1140,8,1010,1.0,0,0,130,2,0,1.5
1110,8,940,1.5,0,0,170,3,0,2.0
1950,7,1950,2.5,0,0,0,3,0,2.0
2930,9,2930,2.5,0,0,0,4,0,2.0
1160,7,1160,1.5,0,0,0,3,0,1.0
1280,6,1280,2.0,0,0,0,4,0,1.0
1190,7,1190,2.0,0,0,0,3,0,1.0
1800,7,1800,1.5,0,0,0,4,0,1.5
1340,5,1340,1.0,0,0,0,3,0,1.5
1980,10,1580,2.5,0,4,400,3,1,2.0
2452,7,2452,3.75,0,0,0,4,0,2.0
1300,7,1300,1.75,0,0,0,3,0,1.0
1080,6,1080,1.0,0,0,0,1,0,1.0
3060,8,1600,2.75,0,0,1460,5,0,1.0
2755,7,2755,2.5,0,0,0,4,0,2.0
2672,8,2020,2.5,0,0,652,4,0,2.0
1550,7,1550,2.5,0,0,0,3,0,2.0
2700,8,1350,2.0,0,0,1350,3,0,1.0
3050,9,3050,3.75,1,0,0,5,0,2.0
3540,8,1970,2.75,0,1,1570,4,0,1.5
1808,8,1808,2.5,0,0,0,3,0,1.0
3695,9,3695,3.5,0,0,0,4,0,2.0
800,6,800,1.0,0,0,0,2,0,1.0
1500,7,1500,2.0,0,0,0,3,0,1.0
2120,7,1060,1.5,0,0,1060,3,0,1.0
3220,9,1680,2.5,1,0,1540,4,0,1.0
2680,8,2040,3.5,0,0,640,4,0,2.0
880,7,880,1.0,0,0,0,2,0,1.0
1200,7,1060,1.5,0,0,140,3,0,1.0
1160,8,960,2.25,0,0,200,2,0,2.0
1630,7,1630,2.0,0,0,0,3,0,1.0
1140,7,1140,1.0,0,0,0,3,0,1.0
1850,8,1850,2.5,0,0,0,3,0,2.0
1350,8,1100,1.75,0,0,250,3,0,1.0
2280,8,2280,1.75,0,0,0,3,0,1.0
3960,9,2630,2.25,1,2,1330,4,0,2.0
720,6,720,1.0,0,0,0,2,0,1.0
1540,9,1540,3.25,0,0,0,3,0,3.0
2060,7,2060,2.5,0,0,0,3,0,2.0
2880,11,2270,3.25,0,0,610,4,0,1.0
1358,7,1358,2.25,0,0,0,3,0,3.0
4140,7,2070,4.5,0,0,2070,7,0,1.0
1310,7,1060,1.5,0,0,250,4,0,1.0
1380,7,1380,1.5,0,0,0,3,0,1.5
1390,7,1130,2.0,0,0,260,3,0,1.0
2500,8,2500,2.5,0,0,0,4,0,2.0
2180,8,2180,2.0,0,0,0,2,0,2.0
1990,7,1990,2.5,0,0,0,3,0,2.0
530,5,530,1.0,0,0,0,1,0,1.0
1820,7,1220,2.5,0,0,600,4,0,1.0
1730,7,1730,1.75,0,0,0,3,0,1.5
1190,6,1190,2.0,0,0,0,2,0,1.0
1330,7,1000,1.75,0,0,330,3,0,1.0
2517,8,2517,2.5,0,0,0,3,0,2.0
1890,7,1890,1.75,0,0,0,3,0,1.0
1780,7,1780,1.5,0,0,0,4,0,1.5
4190,10,4190,2.5,1,0,0,3,0,2.0
1380,7,1380,1.0,1,0,0,3,0,1.5
1200,7,1200,1.5,0,0,0,3,0,1.0
770,6,770,1.0,0,0,0,2,0,1.0
2840,8,1510,1.5,0,0,1330,3,0,1.0
1440,7,1440,2.0,0,0,0,3,0,1.0
1250,8,1250,2.25,0,0,0,3,0,3.0
2090,10,2090,2.25,0,2,0,3,0,2.0
2980,8,2130,2.75,0,4,850,6,0,1.0
2780,8,2780,2.75,0,0,0,4,0,2.0
2740,9,2740,2.5,0,0,0,4,0,2.0
980,8,980,2.5,0,0,0,2,0,3.0
2210,8,2210,2.5,0,0,0,4,0,2.0
1500,7,1500,1.5,0,0,0,3,0,1.0
2230,8,2230,2.5,0,0,0,4,0,2.0
1080,6,1080,1.0,0,0,0,3,0,1.0
3430,10,3430,2.5,0,0,0,4,0,2.0
1330,7,1330,2.25,0,0,0,3,0,3.0
880,5,880,1.0,0,0,0,3,0,1.0
1610,6,1610,1.75,0,0,0,2,0,1.5
2530,8,2530,2.75,0,0,0,4,0,2.0
1330,8,1060,2.0,0,0,270,3,0,2.0
3440,10,2260,2.5,1,3,1180,4,1,1.5
2960,10,2960,2.5,0,0,0,4,0,2.0
3230,8,2000,2.5,0,3,1230,4,0,1.0
2130,7,1290,2.25,0,0,840,3,0,1.0
3090,9,3090,2.5,0,0,0,4,0,2.0
2950,8,1780,1.75,0,2,1170,4,0,1.0
2710,9,2710,2.5,0,0,0,4,0,2.0
2790,8,2790,2.75,0,0,0,4,0,2.0
910,6,910,1.0,0,0,0,2,0,1.0
2630,7,1640,3.5,0,3,990,4,0,1.5
4640,11,2860,3.5,1,1,1780,7,0,2.0
1990,7,1990,2.5,0,0,0,3,0,2.0
2502,9,2502,2.5,0,0,0,4,0,2.0
1910,9,1910,3.0,0,0,0,3,0,1.5
1620,7,1620,2.25,0,0,0,3,0,2.0
1200,7,1200,1.0,0,0,0,3,0,1.0
2620,9,2620,2.5,0,0,0,4,0,2.0
1946,7,1946,3.25,0,1,0,4,0,2.0
1560,7,1560,1.0,0,0,0,4,0,1.5
3100,9,2250,3.5,1,2,850,4,0,2.0
1840,8,1240,2.5,0,2,600,4,0,1.0
550,5,550,0.75,0,0,0,2,0,1.0
1640,7,1640,2.0,0,0,0,3,0,2.0
1300,7,1300,1.5,0,0,0,3,0,1.0
1410,6,1410,1.0,0,0,0,2,0,1.5
1600,7,1600,2.5,0,0,0,3,0,2.0
1861,8,1578,2.5,0,0,283,3,0,2.0
2070,8,1340,1.75,0,3,730,3,0,1.0
550,4,550,1.0,0,0,0,1,0,1.0
1290,7,1030,1.0,0,0,260,2,0,2.0
1920,7,1370,1.5,0,0,550,4,0,1.0
1780,7,980,2.0,0,0,800,2,0,1.5
1690,8,1690,1.75,0,0,0,3,0,1.0
1080,7,1080,1.0,0,0,0,3,0,1.0
2400,8,1800,2.25,0,0,600,4,0,1.0
2490,8,2490,2.5,0,2,0,3,0,2.0
1890,8,1890,2.5,0,0,0,3,0,2.0
1516,7,998,1.75,0,0,518,3,0,1.0
2550,8,1890,1.75,0,0,660,4,0,1.0
1790,8,1280,1.5,0,0,510,2,0,1.5
2440,8,1420,1.75,0,4,1020,4,0,1.0
2560,7,1760,3.0,0,0,800,5,0,1.5
1190,7,990,1.0,0,0,200,2,0,1.0
1480,7,1480,2.5,0,0,0,2,0,3.0
2320,7,1510,1.75,0,0,810,4,0,1.0
2990,8,2990,2.75,0,0,0,5,0,2.0
1170,6,1170,1.5,1,0,0,4,0,1.0
3530,10,3530,2.75,0,0,0,3,0,2.0
1720,8,1720,1.5,0,0,0,5,0,1.5
3290,8,3290,2.5,0,0,0,4,0,2.0
910,7,910,1.0,0,0,0,2,0,1.0
970,7,970,1.5,0,0,0,3,0,1.0
3090,8,3090,3.75,0,0,0,5,0,2.0
2000,7,1650,2.25,0,0,350,4,0,2.0
860,7,860,1.0,0,0,0,2,0,1.0
1570,8,1570,1.0,0,3,0,2,0,1.5
2040,8,2040,2.5,0,0,0,4,0,2.0
990,7,990,1.0,0,0,0,3,0,1.5
1440,7,1440,2.0,0,0,0,4,0,2.0
3520,10,3520,3.0,0,2,0,4,0,2.0
1800,8,1800,2.5,0,0,0,3,0,2.0
2680,8,1610,2.5,0,0,1070,3,0,1.0
1300,7,1300,1.0,0,0,0,2,0,1.0
3430,10,3430,2.75,0,0,0,5,0,2.0
4660,11,4660,3.5,1,2,0,4,0,2.0
1760,7,1160,2.0,0,0,600,3,0,1.0
1630,7,1630,1.75,0,0,0,4,0,1.0
1880,7,1880,2.5,0,0,0,4,0,2.0
830,6,830,1.0,0,0,0,2,0,1.0
3000,9,3000,2.5,0,0,0,4,0,2.0
2590,9,2590,2.5,0,0,0,4,0,2.0
2890,8,1990,2.75,0,0,900,4,0,1.5
3720,9,1880,3.0,0,0,1840,4,0,1.0
3290,10,3290,2.5,0,0,0,4,0,2.0
4140,9,4140,3.25,0,0,0,4,0,2.0
1560,7,1560,2.0,0,0,0,4,0,1.0
3420,9,2620,3.25,0,0,800,5,0,2.0
2570,8,2570,2.5,0,0,0,5,0,2.0
2630,9,2630,2.5,0,0,0,3,0,2.0
4370,11,4370,3.5,0,0,0,4,0,2.0
1950,8,1950,2.75,0,0,0,4,0,2.0
1750,7,1240,2.5,0,0,510,4,0,1.0
660,6,660,1.0,0,0,0,1,0,1.0
3350,10,3350,2.75,0,0,0,4,0,2.0
2350,8,2350,2.5,0,0,0,4,0,2.0
4440,10,2220,4.0,1,0,2220,5,0,1.0
4590,10,3160,4.25,1,0,1430,4,0,2.0
1630,8,1630,2.5,0,0,0,3,0,2.0
2050,6,1430,2.0,0,0,620,5,0,1.0
1910,8,1910,2.0,0,0,0,3,0,1.0
2690,9,2690,2.5,0,0,0,4,0,2.0
2850,9,2850,2.5,0,0,0,3,0,2.0
720,6,720,1.0,0,0,0,1,0,1.0
1365,7,1315,2.5,0,0,50,3,0,3.0
1954,8,1954,2.5,0,0,0,4,0,2.0
2960,8,2960,2.5,0,0,0,3,0,2.0
2350,8,2350,2.0,0,0,0,4,0,2.0
2270,7,2270,2.5,0,0,0,3,0,2.0
1310,8,1310,2.75,0,0,0,2,0,3.5
800,7,800,1.0,0,0,0,2,0,1.0
1400,7,1400,1.75,0,0,0,4,0,1.0
4040,9,4040,2.5,0,0,0,3,0,2.0
1060,7,760,1.75,0,0,300,2,0,2.0
1060,8,1060,1.0,0,0,0,3,0,1.0
1370,7,1370,2.0,0,0,0,4,0,1.0
1790,8,1790,1.75,0,0,0,4,0,1.0
2830,7,2830,2.75,0,0,0,5,0,1.5
820,6,820,1.0,0,0,0,2,0,1.0
2370,8,2370,2.5,0,0,0,3,0,2.0
3810,9,3810,2.5,0,0,0,4,0,2.0
2750,9,2750,2.5,0,0,0,3,0,2.0
1990,7,1990,2.5,0,0,0,4,0,2.0
3100,9,3100,2.5,0,0,0,4,0,2.0
2390,9,1700,2.5,0,3,690,3,0,1.0
3340,8,3340,2.5,0,0,0,4,0,2.0
2030,7,1330,2.5,0,0,700,4,0,1.0
1240,7,1040,1.0,0,0,200,2,0,1.0
2060,7,2060,2.25,0,0,0,4,0,2.0
1900,7,1200,2.0,0,0,700,6,0,1.0
1084,7,1084,1.5,0,0,0,2,0,2.0
2600,7,2600,2.5,0,0,0,5,0,2.0
2130,8,1490,2.5,0,0,640,4,0,1.0
2473,7,2473,3.5,0,1,0,5,0,2.0
2150,8,1080,2.0,0,0,1070,3,0,1.0
2150,8,2150,2.25,0,0,0,3,0,2.0
5050,11,4750,3.25,1,2,300,4,0,1.5
1300,7,1300,1.0,0,0,0,3,0,1.0
1650,7,1650,1.75,0,0,0,3,0,1.0
2730,10,2730,2.5,0,0,0,3,0,2.0
1020,5,1020,1.0,0,0,0,3,0,1.0
1380,7,790,1.0,0,0,590,3,0,1.0
2507,8,2507,2.5,0,0,0,3,0,2.0
1610,6,1610,1.75,0,0,0,5,0,1.0
2120,8,2120,2.5,0,0,0,3,0,2.0
1840,6,1840,1.0,0,0,0,2,0,1.0
1770,8,1220,1.0,0,3,550,2,0,1.0
900,5,700,1.0,0,0,200,3,0,1.0
1430,7,1430,1.75,0,0,0,3,0,2.0
2940,9,2940,2.75,0,0,0,4,0,2.0
1770,7,1770,2.0,0,0,0,4,0,1.5
3610,9,2640,3.25,0,0,970,4,0,2.0
3960,10,3960,3.25,0,0,0,5,0,2.0
2920,8,1460,2.5,0,2,1460,3,0,1.0
1890,7,1890,2.0,0,0,0,5,0,2.0
2710,10,2000,2.5,0,2,710,3,0,2.0
2880,9,2880,2.5,1,0,0,3,0,2.0
1890,7,1500,2.5,0,0,390,4,0,1.0
2320,9,1620,2.5,0,0,700,4,0,1.0
2500,7,1490,2.5,0,0,1010,5,0,1.0
2550,8,2370,1.0,0,0,180,4,0,2.0
1480,7,1200,1.75,0,0,280,3,0,1.5
1810,7,1810,1.5,0,0,0,3,0,1.0
1670,8,1670,2.5,0,0,0,4,0,2.0
1430,7,1430,1.75,0,0,0,3,0,1.0
1470,7,1470,1.0,0,0,0,4,0,1.5
3000,7,1780,3.5,0,0,1220,4,0,1.0
2990,9,2990,2.5,0,0,0,4,0,2.0
1510,7,1510,2.75,0,1,0,5,0,2.0
2220,7,1230,2.75,0,0,990,5,0,1.0
1530,7,1260,1.75,0,0,270,2,0,2.0
2650,9,2650,2.5,0,0,0,4,0,2.0
3480,9,2360,2.5,0,0,1120,4,0,2.0
1410,7,1410,1.75,0,0,0,3,0,1.0
1620,7,1040,1.75,0,0,580,2,0,1.0
1570,7,1570,2.5,0,0,0,3,0,2.0
2450,8,1870,2.5,0,0,580,3,0,1.0
2470,9,2470,2.0,1,0,0,3,0,2.0
1880,8,1480,2.25,0,0,400,3,0,1.0
2910,8,2910,2.75,0,0,0,4,0,2.0
920,7,920,1.0,0,0,0,3,0,1.0
5610,11,4750,4.0,0,0,860,4,0,3.0
1730,9,1730,1.75,0,0,0,3,0,1.0
920,7,920,1.0,0,0,0,3,0,1.0
3600,9,2940,3.5,0,0,660,4,0,2.0
2240,8,1540,2.5,0,0,700,4,0,1.0
1670,9,1670,1.75,0,0,0,2,0,1.0
2510,8,2510,2.25,0,0,0,3,0,2.0
2780,8,2780,2.75,0,0,0,4,0,2.0
1100,7,1100,2.0,0,0,0,3,0,1.0
1750,8,1750,2.5,0,0,0,3,0,3.0
1980,8,1980,2.5,0,0,0,3,0,2.0
3480,8,1980,2.5,0,0,1500,5,0,1.0
1100,7,1100,1.0,0,0,0,3,0,1.0
2670,9,1640,3.25,0,0,1030,4,0,1.0
1460,8,1260,2.25,0,0,200,2,0,2.0
1220,6,1220,1.0,0,0,0,3,0,1.0
520,3,520,0.75,0,0,0,1,0,1.0
1790,9,1790,1.75,0,3,0,3,0,1.0
1500,7,1500,1.5,0,0,0,4,0,2.0
2500,7,2500,2.25,0,0,0,5,0,1.5
2160,8,1460,2.25,0,0,700,3,0,1.0
2130,7,1570,3.0,0,0,560,3,0,1.5
4590,10,3490,3.0,0,0,1100,4,0,2.0
1600,7,1600,2.5,0,0,0,3,0,2.0
1800,8,1800,2.5,0,0,0,3,0,2.0
3610,8,1950,2.5,0,0,1660,3,0,1.0
2470,7,1480,1.5,0,0,990,4,0,1.5
2640,9,2260,2.75,0,0,380,3,0,1.5
1400,6,1400,1.75,0,0,0,3,0,1.0
700,7,700,1.0,0,0,0,2,0,1.0
1730,5,1730,2.0,0,0,0,5,0,1.0
1270,7,1270,1.75,0,0,0,3,0,1.0
1540,7,1540,1.5,0,0,0,3,0,1.0
1480,6,1480,1.0,0,0,0,3,0,1.5
1810,8,1310,1.5,0,0,500,3,0,1.5
1940,8,1940,1.75,0,0,0,4,0,1.0
1970,7,1070,2.0,0,0,900,3,0,1.0
1810,7,1810,2.0,0,0,0,3,0,1.0
1490,6,1490,1.5,0,0,0,3,0,1.0
5350,10,5020,3.0,1,0,330,7,0,2.5
2230,7,1510,2.0,0,0,720,4,0,1.5
3280,9,2050,2.75,1,0,1230,5,0,1.0
2520,8,2520,2.5,0,0,0,4,0,2.0
1010,6,1010,1.5,0,0,0,3,0,1.0
2050,7,1520,1.5,0,0,530,5,0,1.0
2870,8,2090,3.0,0,0,780,5,0,2.0
2090,6,2090,2.75,0,0,0,4,0,1.0
1990,7,1990,2.25,0,0,0,3,0,2.0
1540,7,1540,1.5,0,0,0,3,0,1.0
4490,9,3390,3.5,0,0,1100,4,0,2.0
3250,8,2370,3.75,0,2,880,3,0,2.0
4430,10,4430,3.25,1,0,0,4,0,2.0
1530,7,1530,2.5,0,0,0,3,0,2.0
4750,11,4750,3.25,0,0,0,4,0,2.0
1500,7,1500,2.25,0,0,0,3,0,2.0
2310,8,2310,3.75,0,0,0,7,0,2.0
4430,12,4430,4.0,0,0,0,4,0,2.0
2010,8,1570,2.25,0,0,440,3,0,1.0
4130,9,3170,3.75,0,0,960,5,0,2.0
2980,7,1710,2.75,0,0,1270,5,0,1.0
1480,7,1480,2.5,0,0,0,3,0,2.0
4510,10,2820,3.5,0,0,1690,5,0,2.0
1000,6,1000,1.0,0,0,0,4,0,1.0
1500,6,1500,1.0,0,0,0,4,0,1.5
1980,8,1890,2.5,0,0,90,3,0,2.0
3020,8,1510,2.5,0,0,1510,5,0,1.0
1220,8,1010,2.5,0,0,210,3,0,2.0
2010,8,1340,2.5,0,0,670,3,0,2.0
2070,8,2070,2.5,0,0,0,4,0,2.0
1540,7,850,2.75,0,2,690,4,0,1.0
1720,7,1240,2.5,0,0,480,3,0,2.0
2200,9,2200,2.5,0,0,0,3,0,2.0
1310,7,1310,2.25,0,0,0,3,0,1.0
1190,8,800,2.0,0,0,390,2,0,2.0
3600,9,3600,3.75,1,0,0,4,0,1.0
1250,7,1250,1.0,0,0,0,3,0,1.0
2320,8,1720,1.75,0,2,600,2,0,1.5
1670,8,1670,1.75,0,0,0,3,0,1.0
2020,7,1620,2.0,0,0,400,5,0,1.5
1390,8,970,2.0,0,0,420,2,0,1.0
1640,8,1320,2.25,0,0,320,3,0,1.0
3050,8,1720,2.5,0,3,1330,3,0,1.0
1170,6,1170,1.5,0,0,0,3,0,1.0
1440,8,1440,1.75,0,0,0,2,0,1.0
1680,7,1070,1.75,0,0,610,3,0,1.0
2440,6,1640,2.0,0,0,800,3,0,1.0
1510,7,880,1.0,0,0,630,2,0,1.0
2880,8,2880,3.25,0,0,0,4,0,2.5
4050,8,2620,3.0,0,0,1430,6,0,2.0
1380,7,1080,1.5,0,0,300,3,0,1.0
1300,7,1300,2.0,0,0,0,3,0,1.5
1980,9,1560,2.25,0,0,420,3,0,1.0
920,7,920,1.0,0,3,0,1,0,1.0
1060,6,1060,1.0,0,0,0,3,0,1.0
1860,8,1470,1.0,0,0,390,3,0,1.0
1540,7,1540,2.0,0,0,0,3,0,2.0
3840,10,3840,2.5,0,0,0,4,0,2.0
1520,7,1370,1.75,0,0,150,4,0,1.0
3240,11,3240,2.5,1,0,0,3,0,2.0
2360,10,2360,2.25,1,0,0,4,0,2.0
2630,10,2030,3.25,0,0,600,4,0,2.0
4030,11,4030,4.5,0,0,0,5,0,2.0
3010,9,3010,2.75,0,0,0,3,0,2.0
1940,8,1940,2.5,0,0,0,4,0,2.0
2010,9,1890,1.0,0,0,120,5,0,1.5
1090,7,1090,1.0,0,0,0,3,0,1.0
3740,8,2240,2.25,0,0,1500,5,0,1.5
3540,10,2000,3.25,1,2,1540,5,0,1.0
1520,7,1520,2.5,0,0,0,3,0,2.0
640,5,640,1.0,0,0,0,1,0,1.0
2200,7,1160,3.0,0,0,1040,5,0,1.0
2000,7,1350,2.25,0,0,650,4,0,1.0
1760,8,1760,2.5,0,0,0,3,0,1.0
1690,8,1150,2.5,0,0,540,3,0,2.0
2840,10,2840,2.5,0,0,0,4,0,2.0
1140,7,1140,1.75,1,0,0,3,0,1.0
2230,7,1480,2.75,0,0,750,4,0,1.0
1360,7,1360,2.0,0,0,0,3,0,2.0
2670,8,1420,2.25,0,0,1250,4,0,1.0
3650,10,3650,3.5,0,0,0,4,0,2.0
3240,7,2690,1.75,0,0,550,5,0,2.0
1540,6,1540,1.0,1,0,0,3,0,1.0
1650,7,1160,2.0,0,0,490,3,0,1.0
1440,7,1440,2.5,0,0,0,3,0,2.0
2400,7,1200,2.75,0,0,1200,4,0,1.0
1740,7,1740,1.75,0,0,0,3,0,1.0
1250,7,1250,1.0,0,0,0,4,0,1.0
1960,8,1290,2.25,1,0,670,4,0,1.0
1820,6,1220,1.75,0,0,600,3,0,1.0
3150,9,3150,2.75,0,0,0,5,0,2.0
1270,7,1150,1.5,0,0,120,3,0,1.0
1760,7,880,1.75,0,0,880,4,0,1.0
2150,7,1420,2.5,0,0,730,4,0,1.0
2740,9,2190,3.5,0,0,550,3,0,2.0
3300,8,1960,4.0,0,0,1340,6,0,1.0
1230,7,830,1.0,0,0,400,2,0,2.0
2520,8,1420,1.75,0,4,1100,4,1,1.0
1090,7,1090,1.0,0,0,0,3,0,1.5
860,7,860,1.0,0,0,0,2,0,1.0
2400,7,1400,1.75,0,0,1000,6,0,1.5
3650,9,1860,3.0,1,3,1790,5,0,1.0
2000,6,1150,2.5,0,0,850,5,0,1.0
2490,8,1290,2.25,1,0,1200,4,0,1.0
3340,10,3340,2.5,0,0,0,5,0,2.0
1410,8,1140,1.0,0,0,270,3,0,1.0
1690,7,1690,2.0,0,0,0,3,0,1.5
2700,9,2700,2.75,0,0,0,4,0,2.0
1950,8,1950,2.5,0,0,0,4,0,2.0
1110,7,1110,1.0,0,0,0,3,0,1.0
2235,7,990,2.5,0,0,1245,3,0,1.0
2630,9,2630,2.5,0,0,0,4,0,2.0
1120,7,1120,1.75,0,0,0,3,0,1.0
1410,7,1020,1.0,0,0,390,2,0,1.0
2770,9,2770,2.5,0,2,0,3,0,2.0
2420,7,2420,3.5,0,0,0,5,0,2.0
3274,9,3274,2.5,0,0,0,4,0,2.0
1380,7,1380,2.0,0,0,0,3,0,1.0
2370,8,1980,2.5,0,2,390,4,0,1.5
1420,7,1420,2.25,0,0,0,3,0,2.0
2730,8,2730,2.5,0,0,0,4,0,2.0
1060,7,1060,1.0,0,0,0,3,0,1.0
930,6,930,0.75,0,0,0,1,0,1.0
1790,7,1790,1.5,0,3,0,3,0,2.0
2080,7,1220,1.75,0,0,860,3,0,1.0
2230,8,2230,2.5,0,0,0,3,0,2.0
1480,7,750,2.0,0,0,730,3,0,1.0
1210,7,1210,1.0,1,0,0,3,0,1.0
1890,8,1890,2.5,0,0,0,4,0,2.0
2600,7,2600,2.5,0,0,0,3,0,2.0
1370,7,1370,1.0,0,0,0,3,0,1.5
2120,7,1420,2.25,0,0,700,3,0,1.0
5620,11,4700,4.5,0,3,920,5,0,3.0
920,6,920,1.0,0,0,0,3,0,1.0
1050,7,1050,1.0,0,0,0,2,0,1.0
2170,8,2170,2.25,0,0,0,3,0,2.0
950,7,950,1.0,0,0,0,2,0,1.0
890,5,890,1.0,0,0,0,3,0,1.5
1650,7,1650,2.75,0,0,0,5,0,1.0
2130,8,1370,2.25,0,0,760,3,0,1.0
1590,7,1060,2.0,0,0,530,3,0,1.0
2130,7,1560,2.75,0,0,570,4,0,1.0
1500,7,1500,1.75,0,0,0,3,0,1.0
1350,7,1350,1.75,0,0,0,3,0,1.0
4120,8,2060,2.75,0,4,2060,4,0,1.0
1000,7,930,1.5,0,0,70,2,0,2.0
3560,10,3560,3.5,0,0,0,4,0,2.0
2720,9,2720,2.25,1,0,0,4,0,2.0
1720,7,860,2.0,0,0,860,4,0,1.0
1910,7,1020,2.0,0,0,890,5,0,1.0
2780,9,2780,3.0,0,0,0,3,0,2.0
2420,9,2420,2.5,0,0,0,4,0,2.0
2070,8,2070,2.5,0,0,0,3,0,2.0
1620,7,1170,2.25,0,0,450,3,0,1.0
1110,7,1110,1.75,0,0,0,3,0,1.0
2590,8,2590,2.25,1,0,0,4,0,2.0
3300,10,2600,3.75,0,4,700,4,0,1.5
2390,7,2390,3.0,0,0,0,4,0,2.0
2380,7,1680,3.0,0,0,700,4,0,1.5
1070,7,1070,1.0,0,0,0,3,0,1.0
1700,7,1200,2.75,0,0,500,4,0,1.0
2230,8,1850,3.0,0,0,380,3,0,2.5
1720,8,900,1.75,0,0,820,3,0,1.0
2180,8,1620,2.5,0,0,560,4,0,1.0
1060,6,950,1.0,0,0,110,4,0,1.0
1470,7,1350,2.25,0,0,120,3,0,1.0
1720,7,1720,2.0,0,0,0,3,0,2.0
1350,6,1350,1.0,0,3,0,3,0,1.0
2130,7,2130,2.25,0,0,0,4,0,2.0
3430,9,3430,3.25,0,0,0,4,0,2.0
1400,8,940,2.0,0,0,460,2,0,2.0
2560,8,1660,1.5,1,0,900,3,0,1.5
1280,7,1280,1.75,0,0,0,2,0,1.0
1950,6,1160,1.75,0,3,790,2,0,1.0
3320,9,3320,3.5,0,0,0,4,0,2.0
1630,7,1630,2.0,0,0,0,4,0,1.0
2890,7,1590,3.0,0,0,1300,4,0,1.0
1540,7,1540,1.5,0,0,0,3,0,1.0
1820,8,1620,1.75,0,0,200,3,0,1.0
2440,8,2440,2.25,0,0,0,5,0,1.5
1250,7,1250,2.0,0,0,0,3,0,3.0
1280,6,1280,1.0,0,0,0,3,0,1.0
2230,7,1300,2.25,0,0,930,4,0,1.0
3750,9,2030,3.5,1,2,1720,5,0,1.0
3940,9,3110,2.5,0,0,830,3,0,2.0
2710,8,2710,2.75,0,0,0,5,0,2.0
1050,6,840,1.0,0,0,210,2,0,1.0
3640,10,2540,3.0,0,3,1100,5,0,2.0
1670,7,1670,1.0,1,0,0,2,0,1.5
2440,8,1940,3.5,0,0,500,4,0,2.0
3070,9,3070,2.75,0,0,0,4,0,2.0
1580,8,1580,1.5,0,0,0,3,0,3.0
2000,7,1300,1.75,0,0,700,3,0,1.0
2000,7,2000,2.5,0,0,0,3,0,2.0
1330,7,900,1.0,0,0,430,3,0,1.0
2700,8,1950,2.5,0,0,750,5,0,1.0
860,7,860,1.0,0,0,0,3,0,1.5
2820,9,1770,2.5,0,3,1050,4,0,1.0
3890,9,2840,3.5,0,4,1050,7,0,2.0
2210,8,2210,2.5,0,0,0,3,0,2.0
1730,7,1150,1.75,0,0,580,3,0,1.0
3030,9,2130,3.25,0,2,900,5,0,2.0
4460,10,3140,3.0,1,0,1320,4,0,2.0
1770,5,1770,2.0,0,0,0,3,0,1.0
2220,8,2220,2.25,0,0,0,3,0,2.0
3010,8,3010,2.5,0,0,0,4,0,2.0
3660,9,3660,2.75,0,0,0,4,0,2.0
1630,7,1630,1.5,0,0,0,3,0,1.0
4030,9,2800,3.25,0,0,1230,3,0,2.0
2600,8,1300,2.5,1,0,1300,3,0,1.0
3550,9,3550,2.5,0,0,0,4,0,2.0
2000,8,1120,1.75,0,0,880,3,0,1.0
2340,8,2340,2.5,0,0,0,3,0,1.0
3050,9,2050,3.5,0,3,1000,4,0,2.0
1400,6,1400,1.0,0,0,0,3,0,1.0
2690,8,2690,2.5,0,0,0,4,0,2.0
1730,7,1010,1.75,0,0,720,4,0,1.0
1060,7,1060,1.0,0,2,0,3,0,1.0
3010,9,3010,2.25,0,0,0,4,0,1.0
670,6,670,1.0,0,0,0,2,0,1.0
2480,9,1890,2.75,1,0,590,3,0,1.5
1490,7,1110,2.0,0,0,380,4,0,1.0
1480,7,1080,1.0,0,0,400,3,0,1.0
1530,7,1530,3.0,0,0,0,4,0,2.0
1970,8,1570,1.75,0,0,400,3,0,1.0
1930,8,1930,2.5,0,0,0,3,0,2.0
3100,9,3100,2.5,0,0,0,5,0,2.5
1530,7,1030,1.75,0,0,500,2,0,1.0
1250,7,1250,1.0,0,0,0,2,0,1.5
1600,8,1600,2.5,0,0,0,3,0,2.0
2900,7,1870,3.0,0,2,1030,4,0,1.0
1670,7,1090,1.5,0,0,580,2,0,1.0
3370,10,2240,2.5,1,0,1130,4,0,1.0
2220,8,2040,1.75,0,2,180,3,0,1.0
4550,9,2300,4.0,0,1,2250,4,0,1.0
2580,9,2580,2.5,0,0,0,4,0,2.0
1330,8,1330,2.25,0,0,0,2,0,2.0
2340,7,1360,1.75,0,0,980,4,0,1.0
6085,11,6085,4.5,0,0,0,5,0,3.0
1730,8,1730,2.5,0,0,0,3,0,2.0
2930,9,2130,3.75,0,0,800,4,0,1.5
1750,7,1300,1.75,0,1,450,3,0,1.0
2860,8,1430,1.75,0,0,1430,5,0,1.0
1520,8,1520,1.75,1,0,0,3,0,1.0
1030,7,830,1.0,0,0,200,2,0,1.0
2110,8,1530,2.25,0,0,580,3,0,1.0
1260,7,1260,1.0,0,0,0,3,0,1.5
2230,8,2230,2.5,0,0,0,3,0,2.0
1940,7,970,1.5,1,0,970,2,0,1.0
2910,10,2910,2.5,1,0,0,4,0,2.0
2670,9,1870,3.5,0,0,800,3,0,2.0
2190,8,1410,2.5,1,0,780,4,0,1.0
3020,9,3020,2.5,0,0,0,4,0,2.0
2660,8,1750,2.25,0,0,910,4,0,1.0
2990,9,2990,2.25,0,0,0,3,0,2.0
1430,7,930,1.0,0,0,500,2,0,1.0
1110,7,1110,1.5,0,0,0,2,0,1.0
1790,8,1360,1.0,0,0,430,2,0,1.0
3310,9,3310,3.0,0,0,0,4,0,1.5
960,6,960,1.0,0,0,0,2,0,1.0
4420,11,4420,4.0,0,0,0,4,0,2.0
2460,10,2460,2.5,0,0,0,3,0,1.0
710,6,710,1.0,0,0,0,1,0,1.5
1340,7,1340,2.0,0,0,0,3,0,1.5
3140,8,1820,2.5,0,0,1320,4,0,1.0
1070,9,720,2.0,0,0,350,2,0,2.0
990,6,990,1.0,0,0,0,3,0,1.0
1330,7,1330,1.75,0,0,0,3,0,1.0
1570,7,1570,2.5,0,0,0,3,0,2.0
1480,7,1480,1.5,0,0,0,2,0,1.0
1670,7,840,2.75,0,0,830,4,0,1.0
2810,10,2810,2.5,0,0,0,4,0,2.0
1010,7,1010,1.0,1,0,0,2,0,1.0
2560,9,2560,2.5,0,0,0,3,0,2.0
1240,7,1240,1.75,0,0,0,4,0,1.5
2390,7,1270,2.5,0,0,1120,5,0,1.0
4400,9,4400,3.25,0,0,0,4,0,2.0
3010,9,3010,2.25,0,0,0,4,0,2.0
2890,9,2890,2.25,0,0,0,5,0,2.0
1950,9,1610,3.0,1,0,340,3,0,3.0
3700,7,1840,4.75,0,0,1860,4,0,1.0
1160,7,1160,1.0,0,0,0,3,0,1.0
2340,8,1720,2.75,0,0,620,4,0,1.0
2780,9,2780,2.5,0,0,0,3,0,2.0
2280,8,1660,2.25,0,0,620,4,0,1.0
2560,9,2560,3.0,0,0,0,4,0,2.0
1610,7,1610,2.5,0,0,0,3,0,2.0
2460,9,1860,2.5,0,0,600,3,0,1.0
2220,7,1110,1.75,0,0,1110,4,0,1.0
1570,8,1570,2.25,0,0,0,3,0,2.0
2370,8,2370,2.5,0,0,0,3,0,2.0
1180,6,760,1.75,0,0,420,3,0,1.0
3060,8,3060,2.25,0,0,0,4,0,2.0
1520,7,1520,1.75,0,0,0,3,0,1.5
2180,8,1700,2.5,0,0,480,4,0,2.0
2710,7,1710,3.0,0,0,1000,4,0,1.0
2430,8,2430,2.5,0,0,0,4,0,2.0
2340,8,2340,2.25,0,0,0,4,0,1.0
2620,7,2620,2.5,0,0,0,3,0,2.0
3340,8,2060,2.5,0,0,1280,4,0,1.0
1990,7,1320,1.75,0,1,670,3,0,1.0
2820,9,2820,2.75,0,0,0,4,0,2.0
2940,10,2940,2.5,0,0,0,3,0,2.0
950,6,950,1.0,0,0,0,2,0,1.0
1580,8,1580,2.5,0,0,0,3,0,2.0
2260,7,1130,1.75,0,0,1130,3,0,1.0
1550,7,1100,1.75,0,0,450,5,0,1.0
1810,7,1410,1.0,0,0,400,4,0,1.0
1670,7,1220,2.25,0,0,450,3,0,1.0
1500,8,1500,1.75,0,0,0,3,0,1.0
2910,9,2910,3.5,0,0,0,4,0,2.0
2760,9,2120,2.0,0,0,640,4,0,1.0
1880,7,1090,1.75,0,0,790,4,0,1.5
2240,8,1280,1.5,0,0,960,5,0,1.0
2500,7,1570,2.0,0,0,930,5,0,1.5
1010,5,1010,1.0,0,4,0,2,1,1.0
2010,6,1510,2.5,0,0,500,5,0,1.5
1650,7,1650,2.5,0,0,0,3,0,2.0
3590,10,3590,3.5,0,0,0,3,0,2.0
1690,7,870,2.5,0,0,820,3,0,1.0
5480,10,5140,4.25,0,0,340,6,0,2.0
2120,8,2120,2.25,0,0,0,3,0,1.0
1200,8,1200,2.0,0,0,0,2,0,1.0
4640,10,4640,3.5,0,0,0,4,0,2.0
2070,8,2070,2.5,0,0,0,3,0,2.0
1770,7,1770,2.0,0,0,0,4,0,2.0
1540,8,1540,2.0,0,0,0,3,0,2.0
1620,8,1540,2.25,0,0,80,3,0,2.5
1760,7,1460,1.75,0,0,300,3,0,1.0
1730,8,1730,3.0,0,0,0,3,0,3.5
2270,7,2270,2.5,0,0,0,4,0,2.0
940,7,940,1.0,0,0,0,2,0,1.0
1460,7,1100,1.5,0,0,360,3,0,1.0
1650,7,1170,1.0,0,0,480,3,0,1.0
3100,8,3100,2.5,0,0,0,5,0,2.0
1660,7,1260,2.0,0,0,400,3,0,1.0
1620,8,1620,1.5,0,0,0,4,0,1.5
620,6,620,1.0,0,0,0,2,0,1.0
1260,7,1260,1.75,0,0,0,3,0,1.0
760,7,760,1.0,0,0,0,2,0,1.0
2030,7,2030,3.0,0,0,0,4,0,2.0
1120,7,1120,1.0,0,0,0,2,0,1.0
1700,8,1700,2.5,0,0,0,2,0,2.0
2930,8,1730,2.25,0,0,1200,6,0,1.0
2233,7,2233,2.5,0,0,0,4,0,2.0
1680,7,1680,2.0,0,0,0,3,0,1.0
1650,8,1650,2.5,0,0,0,3,0,2.0
1210,7,1210,2.0,0,0,0,3,0,1.0
1000,7,1000,1.0,0,0,0,3,0,1.0
3180,10,3180,3.25,0,0,0,4,0,2.0
1560,7,880,1.75,0,0,680,2,0,1.0
2260,9,2260,2.5,0,0,0,3,0,2.0
1200,7,1200,1.0,0,0,0,3,0,1.0
1970,7,1970,1.5,0,0,0,4,0,2.5
1070,7,1070,1.0,0,2,0,2,0,1.0
2660,8,1740,2.5,0,0,920,4,0,1.0
1180,6,590,0.5,0,0,590,2,0,1.0
870,6,870,1.0,0,0,0,2,0,1.0
2210,8,2210,2.25,0,0,0,3,0,2.0
2660,8,1940,2.0,0,3,720,3,0,1.5
2290,8,2290,2.5,0,0,0,4,0,2.0
1680,8,1680,3.0,0,0,0,3,0,3.0
2270,8,2270,2.5,0,0,0,3,0,2.0
2460,8,2460,2.25,0,0,0,4,0,1.0
3680,10,3680,2.5,1,0,0,3,0,2.0
2050,7,2050,2.5,0,0,0,4,0,2.0
3180,9,3180,3.0,0,0,0,4,0,2.0
1070,7,1070,1.5,0,0,0,2,0,2.0
1620,7,1210,1.75,0,0,410,3,0,1.0
1240,7,1240,1.5,0,2,0,3,0,1.0
1530,8,1530,3.0,0,0,0,3,0,3.0
1610,7,1610,2.5,0,0,0,3,0,2.0
1200,7,800,1.75,0,0,400,2,0,1.0
3240,8,2910,2.5,0,0,330,3,0,2.0
2180,7,1140,1.75,0,0,1040,5,0,1.0
2630,9,2030,3.5,0,2,600,3,0,2.0
890,7,890,1.0,0,0,0,2,0,1.0
1480,6,1380,1.0,0,0,100,3,0,1.0
3860,10,3860,3.5,0,0,0,4,0,2.0
1950,8,1530,1.75,0,0,420,3,0,1.0
1080,6,1080,1.0,0,0,0,3,0,1.5
2890,9,2890,2.75,0,0,0,4,0,2.0
1000,6,1000,1.0,0,0,0,2,0,1.0
3960,10,3960,2.5,0,0,0,4,0,2.0
2240,7,1520,2.5,0,0,720,4,0,1.0
1210,7,1210,1.0,0,0,0,2,0,1.0
3690,9,2070,3.0,0,4,1620,5,0,1.0
2050,8,1730,2.5,0,3,320,3,0,1.0
1070,6,1070,1.0,0,0,0,2,0,1.0
2420,9,2420,2.5,0,0,0,4,0,2.0
1470,8,1000,2.0,0,0,470,3,0,2.0
1300,8,1300,2.0,0,0,0,2,0,1.0
3050,8,1800,2.75,0,0,1250,5,0,1.0
1060,7,1060,1.5,0,0,0,3,0,1.0
2530,8,2530,2.75,0,0,0,4,0,2.0
1590,7,1320,2.0,0,0,270,3,0,1.0
1460,7,1460,1.75,0,0,0,3,0,1.0
1490,7,1490,2.0,0,0,0,4,0,1.5
1960,8,1650,2.0,0,2,310,3,0,1.0
3220,10,3220,2.5,0,0,0,4,0,2.0
1010,7,1010,1.75,0,0,0,3,0,1.0
2180,7,1170,2.0,0,0,1010,4,0,1.0
2840,7,2840,1.75,0,2,0,5,0,2.0
1270,7,1270,1.0,0,0,0,3,0,1.0
1420,6,1420,1.0,0,0,0,2,0,1.5
1810,7,1810,1.0,0,2,0,5,0,1.5
2020,7,2020,2.5,0,0,0,3,0,2.0
2130,7,1090,1.75,0,0,1040,3,0,1.0
1510,7,860,1.75,0,0,650,3,0,1.0
4170,11,4170,2.5,1,0,0,5,0,2.0
1640,8,1640,1.5,0,0,0,3,0,1.5
1300,7,1080,1.75,0,0,220,3,0,1.0
2350,8,1350,1.75,0,2,1000,4,0,1.0
1620,7,1190,1.75,0,0,430,3,0,1.0
3530,9,2660,3.5,0,0,870,4,0,2.0
1450,7,950,1.5,0,0,500,2,0,1.0
2600,8,2600,2.25,1,0,0,4,0,2.0
2940,8,2760,2.75,0,0,180,5,0,2.0
3220,8,3220,2.75,0,0,0,4,0,2.0
1410,8,1360,3.25,0,0,50,3,0,3.0
2960,8,2160,2.5,0,0,800,4,0,2.0
1760,7,920,1.75,0,0,840,4,0,1.0
2160,8,2160,2.25,0,0,0,4,0,1.0
3820,10,3820,3.25,1,0,0,4,0,2.0
1510,6,1510,1.0,0,0,0,3,0,1.0
2100,7,1300,1.75,0,0,800,3,0,1.0
3640,9,2570,3.25,1,0,1070,4,0,1.0
1140,7,1140,1.5,0,0,0,2,0,1.0
3220,8,3220,3.5,0,0,0,5,0,2.0
2180,9,2180,2.5,0,0,0,3,0,2.0
1690,7,1690,1.75,1,0,0,3,0,1.0
4520,9,3580,4.5,0,0,940,6,0,2.0
3190,9,1690,2.75,1,3,1500,5,0,1.0
2020,8,1010,2.75,0,0,1010,4,0,1.0
2090,8,2090,2.75,1,0,0,4,0,1.0
1770,7,1770,2.5,0,0,0,4,0,2.0
1610,7,1610,1.75,1,0,0,3,0,1.0
1470,8,1170,2.5,0,0,300,3,0,2.0
2190,8,2190,1.75,0,0,0,4,0,2.0
1750,8,1410,2.0,0,0,340,3,0,1.0
860,7,860,1.0,0,0,0,2,0,1.0
2360,7,1180,2.0,0,0,1180,4,0,1.0
1830,7,1060,2.0,0,0,770,4,0,1.0
1150,7,1150,2.0,0,0,0,1,0,1.0
2190,8,2190,2.5,0,0,0,4,0,2.0
2960,9,2960,2.5,0,0,0,4,0,2.0
3040,8,2350,3.5,0,0,690,4,0,2.0
2330,7,1520,2.25,0,2,810,3,0,1.5
2090,8,2090,2.5,0,0,0,4,0,2.0
2480,7,1600,1.75,0,0,880,4,0,1.0
2620,8,2620,2.5,0,0,0,4,0,2.0
620,6,620,1.0,0,0,0,2,0,1.0
3860,9,3860,3.25,0,2,0,5,0,2.0
1480,7,1050,1.0,0,0,430,2,0,1.0
2190,8,1810,2.25,0,0,380,3,0,2.0
1840,8,1220,1.5,1,0,620,3,0,1.0
910,6,910,1.0,0,0,0,2,0,1.0
3380,9,1690,3.5,1,1,1690,4,0,1.0
1510,7,1510,2.0,0,0,0,3,0,1.0
980,6,980,1.0,0,0,0,2,0,1.0
770,6,770,1.0,0,0,0,2,0,1.0
1650,8,1650,2.25,0,0,0,3,0,3.0
1200,8,1000,1.5,0,0,200,2,0,2.0
1720,8,1030,3.25,1,0,690,3,0,2.0
1860,7,1530,1.0,0,0,330,5,0,1.5
3210,10,2290,3.5,0,2,920,5,0,2.0
970,6,970,1.0,0,0,0,2,0,1.0
1050,7,1050,1.5,0,0,0,4,0,1.0
1660,7,1660,2.5,0,0,0,3,0,2.0
2040,8,1420,2.5,0,0,620,3,0,1.0
850,7,850,1.0,0,0,0,2,0,1.0
1620,8,1540,2.25,0,0,80,2,0,2.0
1210,8,1210,2.5,0,0,0,3,0,3.0
1440,7,1440,1.0,1,0,0,3,0,1.0
1830,7,1070,2.0,0,0,760,4,0,1.0
2110,9,1710,3.0,0,0,400,4,0,2.0
1090,7,1090,1.0,0,0,0,3,0,1.0
1260,7,1260,1.75,0,0,0,3,0,1.0
1470,8,1180,2.5,0,0,290,3,0,2.0
2570,9,2570,2.5,1,0,0,4,0,2.0
2110,7,1290,2.75,0,0,820,4,0,1.0
2300,8,2000,2.5,0,0,300,3,0,1.5
1560,7,1560,2.5,0,0,0,3,0,2.0
1360,6,1360,2.0,1,2,0,3,0,1.0
1370,6,1370,1.0,0,0,0,2,0,1.0
1340,7,1340,1.5,1,0,0,3,0,1.0
990,7,990,1.0,0,0,0,3,0,1.0
830,6,830,1.0,0,0,0,2,0,1.0
2760,9,2760,2.25,0,0,0,4,0,2.0
2710,8,2710,2.75,0,0,0,5,0,2.0
1210,8,780,1.0,0,0,430,2,0,1.0
1600,7,1600,2.5,0,0,0,3,0,2.0
2030,8,1360,2.25,0,0,670,3,0,1.0
1490,7,1090,1.5,0,0,400,3,0,1.0
2200,8,2200,2.5,0,0,0,3,0,2.0
1340,7,1340,2.0,0,0,0,4,0,1.0
1960,7,980,1.5,0,0,980,4,0,1.0
1850,7,1850,1.75,0,0,0,4,0,1.0
1570,7,1570,1.75,0,0,0,3,0,1.0
2690,8,2690,2.5,0,0,0,3,0,2.0
3450,9,1860,3.25,0,0,1590,5,0,2.0
2060,8,1600,2.25,0,2,460,3,0,1.0
2600,8,2600,2.75,0,0,0,5,0,2.0
1960,7,1960,2.5,0,0,0,3,0,2.0
920,8,800,2.0,0,0,120,2,0,2.0
1900,7,1180,2.0,0,0,720,5,0,1.0
2220,7,2220,3.0,0,3,0,5,0,2.0
1590,7,1590,1.5,0,0,0,3,0,1.0
1720,7,860,1.75,0,0,860,3,0,1.0
870,6,870,1.0,0,0,0,2,0,1.5
2475,7,2475,2.75,0,0,0,4,0,2.0
1260,7,750,2.0,0,0,510,3,0,1.0
1930,7,1470,2.25,0,0,460,3,0,1.0
4830,10,3720,4.25,1,0,1110,5,0,2.0
2070,8,2070,2.5,0,0,0,4,0,2.0
3010,8,2010,3.25,0,0,1000,5,0,1.5
3720,10,3720,3.5,1,0,0,6,0,2.0
1230,7,1160,2.25,0,0,70,2,0,2.0
2060,8,1600,2.5,0,0,460,3,0,1.0
3280,9,3280,3.75,1,0,0,4,0,2.0
2430,8,2430,2.5,0,0,0,4,0,2.0
1770,7,1020,1.75,0,0,750,3,0,1.0
2790,7,1450,1.75,0,2,1340,4,0,1.0
2980,9,2980,3.25,0,0,0,5,0,2.5
1630,7,1630,1.75,1,0,0,3,0,1.0
2720,7,1700,2.75,0,4,1020,5,0,1.0
2310,8,2310,2.5,0,2,0,4,0,2.0
1360,7,1360,1.75,0,0,0,3,0,1.0
1250,7,1250,1.0,0,0,0,3,0,1.0
1140,7,1140,2.0,0,0,0,3,0,1.0
1150,7,1150,1.0,0,0,0,3,0,1.0
2790,9,1130,3.25,0,3,1660,4,0,1.0
3410,10,2530,2.25,0,0,880,5,0,2.0
1240,7,1240,1.75,0,0,0,3,0,1.0
700,7,700,1.0,0,0,0,2,0,1.0
1940,7,1940,2.5,0,0,0,4,0,2.0
2880,9,1710,2.75,0,0,1170,4,0,1.5
1560,7,1560,2.0,0,0,0,3,0,1.0
1780,7,1270,1.5,0,0,510,3,0,1.0
1650,7,1650,1.75,0,0,0,3,0,1.0
2600,7,1570,2.5,0,0,1030,4,0,1.5
1880,8,1250,2.5,0,0,630,3,0,1.0
940,7,940,1.0,0,0,0,3,0,1.0
600,5,600,1.0,0,0,0,2,0,1.0
1300,7,1300,1.75,0,0,0,3,0,1.0
4470,11,4470,3.75,1,0,0,5,0,2.0
3100,10,3100,2.5,0,0,0,4,0,2.0
1860,7,1860,2.5,0,0,0,3,0,2.0
1470,7,1160,2.25,0,0,310,3,0,1.0
2730,8,1780,2.75,0,0,950,6,0,1.0
870,6,870,1.0,0,0,0,3,0,1.0
1820,7,1250,1.75,0,0,570,3,0,1.0
2350,9,2350,2.5,0,0,0,3,0,1.0
4920,10,4280,4.0,0,0,640,4,0,2.0
1220,6,1220,1.0,0,0,0,3,0,1.0
840,7,840,1.0,0,0,0,2,0,1.0
2730,8,2230,2.5,0,0,500,4,0,1.5
10040,11,7680,4.5,1,2,2360,5,1,2.0
3290,9,2360,3.5,0,1,930,4,0,2.0
1820,8,1820,2.25,0,0,0,3,0,2.0
3060,10,3060,2.75,1,0,0,3,0,2.0
2100,7,2100,1.75,0,0,0,3,0,1.0
2160,7,1380,2.75,0,0,780,3,0,1.0
2270,8,1310,2.25,1,0,960,4,0,1.0
1370,7,1370,1.0,0,0,0,4,0,1.0
1490,8,1490,2.5,0,0,0,3,0,3.0
1550,9,1550,2.75,0,0,0,4,0,1.5
3260,10,3260,3.5,0,0,0,4,0,2.0
1950,8,1360,3.75,0,0,590,3,0,1.0
1690,7,1690,2.5,0,0,0,3,0,2.0
1740,8,950,1.75,0,0,790,3,0,1.0
2300,8,1510,2.5,0,0,790,3,0,1.5
1740,7,870,1.75,0,0,870,4,0,1.0
1710,7,1210,2.25,0,0,500,3,0,1.0
1030,8,1030,1.5,0,0,0,2,0,3.0
1250,8,1250,2.25,0,0,0,3,0,3.0
3140,10,3140,2.5,0,0,0,4,0,2.0
1830,7,1100,2.0,0,0,730,3,0,1.0
3300,9,3300,2.5,1,0,0,3,0,2.0
910,6,910,1.0,0,0,0,2,0,1.0
1490,8,1490,1.5,0,0,0,3,0,1.0
910,6,910,1.75,0,0,0,2,0,1.0
1120,7,1120,1.5,0,0,0,3,0,1.0
5010,11,4000,4.25,1,1,1010,4,0,2.0
1780,7,1780,1.0,0,0,0,4,0,1.5
2090,7,1370,3.0,0,0,720,4,0,1.0
850,6,850,1.0,0,0,0,2,0,1.0
2490,7,1890,2.25,0,0,600,4,0,1.0
1350,6,1350,1.0,0,0,0,3,0,1.5
2440,8,2440,2.75,0,0,0,5,0,2.0
2260,9,2260,2.5,0,0,0,4,0,1.0
1900,7,1360,1.75,0,0,540,4,0,1.5
3160,9,3160,2.5,1,0,0,4,0,2.0
3190,10,3190,2.5,0,0,0,4,0,2.0
1970,7,1680,1.5,0,0,290,3,0,1.0
2010,8,1610,1.75,0,2,400,4,0,1.0
1550,7,1100,1.75,0,0,450,3,0,1.0
2130,7,1270,2.0,0,0,860,5,0,1.5
3650,9,2550,3.5,0,0,1100,4,0,2.0
2980,9,1860,2.75,0,0,1120,4,0,1.0
2150,8,1340,2.75,0,0,810,4,0,1.0
2040,7,1020,1.75,0,0,1020,4,0,1.0
1830,8,1830,2.0,0,0,0,3,0,1.0
1420,7,1200,1.0,1,0,220,3,0,1.0
2520,7,1510,1.5,0,0,1010,5,0,1.5
1370,7,1370,1.5,0,0,0,3,0,1.0
1070,6,1070,1.0,0,0,0,2,0,1.0
3560,10,2560,3.5,1,0,1000,4,0,2.0
1370,7,1370,1.75,0,0,0,3,0,2.0
1470,7,1470,1.0,1,0,0,4,0,1.5
910,6,910,1.0,0,0,0,3,0,1.0
2420,8,1780,2.5,0,0,640,3,0,2.0
1960,8,1960,2.75,0,2,0,3,0,1.5
1381,8,1381,2.25,0,0,0,3,0,3.0
3060,8,3060,1.75,0,0,0,4,0,1.0
1620,7,1620,2.5,0,0,0,3,0,2.0
1250,7,1250,1.0,0,1,0,2,0,2.0
1410,7,1310,1.0,0,0,100,2,0,1.5
1430,8,1430,1.75,0,0,0,3,0,2.0
1900,7,1110,1.75,0,0,790,3,0,1.5
1360,7,1360,1.0,0,0,0,4,0,1.5
2520,9,2520,2.5,0,0,0,4,0,2.0
810,6,810,1.0,0,0,0,2,0,1.0
2880,10,2880,2.25,1,0,0,3,0,2.0
4220,11,2460,3.25,0,4,1760,3,1,1.0
1560,7,1560,2.5,0,0,0,3,0,2.0
2290,8,2290,2.5,0,0,0,4,0,2.0
2380,8,2380,2.25,0,0,0,4,0,2.0
2260,7,1330,2.75,0,3,930,4,0,1.0
1540,7,1540,2.0,0,0,0,3,0,1.0
2330,8,1730,2.75,0,3,600,3,0,2.0
2330,7,1390,1.75,0,0,940,3,0,1.0
2330,7,1400,2.0,0,0,930,4,0,1.0
3250,8,3250,2.5,0,0,0,4,0,2.0
2950,8,2530,3.25,0,0,420,5,0,1.0
2640,10,2640,3.0,0,0,0,5,0,2.0
1560,8,1560,2.0,0,0,0,2,0,1.0
2880,8,2260,3.5,0,0,620,5,0,2.0
1890,7,1250,1.75,0,0,640,4,0,1.0
2890,9,2240,3.75,1,0,650,4,0,2.0
2230,7,1220,2.5,0,0,1010,4,0,1.0
1890,7,1890,1.5,0,0,0,3,0,1.5
2080,8,1040,1.75,0,4,1040,2,1,1.0
1280,8,1080,2.5,0,0,200,2,0,2.0
1720,7,1000,1.75,0,2,720,3,0,1.0
2250,8,1500,2.0,1,0,750,3,0,1.0
820,7,820,1.0,0,0,0,2,0,1.0
1760,7,1230,1.0,0,0,530,4,0,1.0
1100,7,1100,1.0,0,0,0,2,0,1.0
1930,8,1670,1.75,0,2,260,4,0,1.5
1295,9,1105,1.5,1,0,190,2,0,2.0
1840,8,1370,1.75,1,0,470,3,0,1.0
3600,11,3310,3.25,0,2,290,4,0,2.0
1500,9,1200,2.5,0,0,300,3,0,2.0
2660,9,2660,2.5,0,2,0,4,0,2.0
1670,7,1670,1.75,0,0,0,3,0,1.5
1730,8,1350,1.75,0,0,380,3,0,1.0
2590,8,2590,2.5,0,0,0,4,0,2.0
2920,9,2920,2.5,0,0,0,4,0,2.0
1440,7,1440,2.5,0,0,0,3,0,2.0
2360,8,2360,2.5,0,0,0,4,0,2.0
1920,7,1080,2.0,0,0,840,4,0,1.0
1990,8,1330,1.75,0,1,660,3,0,1.0
900,7,900,1.0,0,0,0,2,0,1.0
1470,7,1470,2.0,0,0,0,3,0,1.0
3010,11,3010,2.75,0,0,0,4,0,2.0
3230,9,2680,2.75,0,0,550,3,0,2.0
3010,10,3010,2.5,0,0,0,4,0,2.0
2350,9,2350,2.25,0,0,0,4,0,2.0
1740,8,1740,2.5,0,2,0,3,0,3.0
2680,8,1510,2.5,0,3,1170,4,0,1.0
1560,6,1060,1.5,0,0,500,3,0,1.0
3290,10,3290,2.5,0,0,0,3,0,2.0
2380,8,1430,3.75,0,0,950,5,0,1.0
5040,10,2870,4.0,1,0,2170,4,0,1.0
3630,9,2790,3.5,0,0,840,5,0,2.0
1130,7,1130,1.0,0,0,0,4,0,1.0
1910,9,1910,2.5,0,0,0,3,0,2.0
2840,7,2210,1.75,0,0,630,5,0,1.0
3500,9,3500,2.5,0,0,0,4,0,2.0
1910,8,1390,1.75,0,0,520,5,0,1.0
1220,8,1220,2.5,0,0,0,3,0,3.0
1730,8,1440,3.0,0,0,290,3,0,2.0
1100,7,1100,1.75,0,0,0,3,0,1.0
1995,8,1995,1.5,0,1,0,2,0,1.5
850,6,850,1.0,0,0,0,2,0,1.0
2350,8,2350,2.25,0,0,0,4,0,2.0
3120,7,2150,2.0,0,0,970,3,0,1.0
2730,9,1660,3.5,0,0,1070,4,0,1.0
3320,10,3320,2.5,0,0,0,4,0,2.0
2250,8,2250,2.5,0,0,0,3,0,2.0
1760,7,960,2.0,0,0,800,3,0,1.0
2340,8,1610,1.75,0,0,730,4,0,1.0
1090,7,1090,1.0,0,0,0,3,0,1.0
3120,9,2480,3.5,0,0,640,4,0,2.0
1030,7,1030,2.0,0,0,0,2,0,3.0
2120,7,2120,2.5,0,0,0,4,0,2.0
2010,7,1210,1.0,0,0,800,3,0,1.0
1980,7,1980,2.5,0,0,0,4,0,2.0
1940,7,1940,2.5,0,0,0,7,0,2.0
1960,6,980,1.75,0,0,980,3,0,1.0
2750,8,1750,2.5,0,0,1000,5,0,1.5
2190,8,2190,3.0,0,0,0,4,0,2.0
1040,6,1040,2.0,0,2,0,2,0,1.0
2070,8,2070,2.75,0,0,0,3,0,2.0
5610,11,4090,4.0,0,0,1520,5,0,2.0
2670,9,2670,2.5,0,0,0,3,0,2.0
1520,7,1140,2.0,0,0,380,3,0,1.5
1170,7,1030,1.0,0,0,140,2,0,1.0
1630,8,1630,2.5,0,0,0,3,0,2.0
1780,7,1320,2.5,0,0,460,3,0,1.0
1670,7,1670,2.5,0,0,0,3,0,2.0
1400,7,960,1.5,0,0,440,2,0,1.0
1640,7,1640,2.0,0,0,0,4,0,2.0
1370,8,1370,1.75,0,0,0,3,0,1.0
3270,10,3270,3.0,0,0,0,3,0,2.0
1950,8,1950,2.5,0,0,0,3,0,2.0
2650,8,2650,3.0,0,0,0,4,0,2.0
1270,7,1270,1.0,0,0,0,4,0,1.5
2710,8,1440,1.75,0,0,1270,4,0,1.0
1530,8,1530,1.75,1,0,0,3,0,1.0
1490,7,750,1.75,0,0,740,2,0,1.0
1370,7,1080,1.5,0,0,290,3,0,1.0
1530,7,1020,2.5,0,0,510,4,0,1.0
1140,7,1140,1.75,0,0,0,3,0,1.0
2340,10,2340,1.75,0,0,0,3,0,1.0
1560,7,1080,2.25,1,0,480,3,0,1.0
2360,7,1280,1.75,0,0,1080,4,0,1.0
2150,6,2150,2.5,0,0,0,3,0,1.5
1480,7,980,1.75,0,0,500,3,0,1.0
1320,7,1320,1.0,0,0,0,3,0,1.0
1390,7,1140,1.5,0,0,250,4,0,1.0
1450,7,1450,1.5,0,0,0,3,0,1.0
2860,9,2860,2.75,0,0,0,5,0,2.0
1050,7,1050,1.0,0,0,0,2,0,1.0
1240,7,1240,1.0,0,0,0,2,0,1.0
1860,7,1060,1.5,0,0,800,2,0,1.0
2070,8,2070,2.5,1,0,0,3,0,2.0
2710,8,1700,2.5,0,0,1010,4,0,1.0
2030,8,2030,1.75,0,0,0,4,0,1.0
1000,6,860,1.0,0,0,140,3,0,1.0
2730,8,2730,2.5,0,0,0,4,0,2.0
1714,8,1714,2.5,0,0,0,4,0,2.0
1310,8,1180,2.5,0,0,130,3,0,2.0
1240,7,890,1.75,0,0,350,2,0,1.0
1070,5,1070,1.0,0,0,0,2,0,1.0
1480,7,1480,1.0,0,0,0,4,0,1.5
2120,8,1920,1.75,0,0,200,4,0,1.5
1900,7,1900,2.5,0,0,0,4,0,1.0
2410,8,1400,2.5,1,0,1010,5,0,1.0
1610,7,1610,1.75,0,0,0,4,0,1.0
2420,8,1210,2.5,0,2,1210,3,0,1.0
2800,8,1420,2.25,1,0,1380,3,0,1.0
1620,7,1620,1.5,0,0,0,3,0,1.0
1500,7,1500,2.25,0,0,0,4,0,2.0
1270,6,1270,1.0,0,0,0,3,0,1.0
1500,7,1500,1.75,0,0,0,3,0,1.0
1810,8,1810,2.5,0,0,0,4,0,2.0
2980,9,2890,2.5,1,0,90,4,0,2.0
3190,9,3190,3.25,0,0,0,3,0,2.0
2750,8,2750,2.5,0,0,0,5,0,2.0
1780,9,1780,2.5,1,0,0,2,0,2.0
2600,9,2600,2.5,0,0,0,5,0,2.0
1680,7,1560,1.75,0,0,120,4,0,1.0
1130,7,1130,1.75,0,0,0,3,0,1.5
1330,8,1330,2.0,0,0,0,3,0,1.0
1630,7,960,1.75,1,0,670,3,0,1.0
1430,8,1140,2.25,0,0,290,3,0,2.0
1870,7,1870,1.75,0,0,0,3,0,2.0
2120,8,2120,2.25,0,0,0,3,0,2.0
1880,8,1280,2.0,0,2,600,3,0,1.0
1200,8,1200,1.5,0,0,0,3,0,2.0
2180,7,1480,1.0,0,0,700,2,0,1.0
3190,9,3190,2.5,0,0,0,3,0,2.0
2020,8,1200,2.25,0,0,820,4,0,1.5
1590,6,1140,1.0,0,0,450,4,0,1.5
1270,7,1270,2.0,0,0,0,3,0,2.0
1720,8,1470,2.5,0,2,250,4,0,2.0
1190,7,1190,1.75,0,0,0,3,0,1.0
3010,9,1510,2.5,1,2,1500,4,0,1.0
1400,7,1400,2.5,0,0,0,3,0,2.0
3010,9,3010,2.25,1,0,0,4,0,2.0
2140,7,1200,1.75,1,0,940,5,0,1.0
2490,8,2490,1.75,0,0,0,6,0,1.5
1930,8,1300,2.5,0,0,630,3,0,2.0
4580,10,4580,4.0,0,4,0,5,1,3.0
2720,8,2040,2.5,0,0,680,3,0,1.0
1520,7,1080,2.5,0,0,440,3,0,1.0
1360,7,1360,2.0,0,0,0,3,0,1.0
2410,7,2410,2.0,0,0,0,3,0,1.5
1140,7,1140,1.0,0,0,0,3,0,1.0
720,6,720,1.0,0,0,0,2,0,1.0
2780,8,1730,2.5,1,1,1050,4,0,1.0
1840,8,1340,2.5,0,1,500,3,0,1.0
1550,6,970,1.75,0,0,580,2,0,1.0
1450,7,1450,2.25,0,0,0,3,0,2.0
4050,10,3020,3.5,1,3,1030,5,0,2.0
2420,10,2420,2.5,0,0,0,3,0,2.0
2730,7,1510,2.0,0,0,1220,5,0,1.0
3230,9,2680,2.75,0,0,550,3,0,2.0
980,7,980,1.0,0,0,0,3,0,1.0
1240,7,1240,2.5,0,0,0,2,0,2.0
2070,8,2070,2.25,0,0,0,4,0,2.0
2320,9,2320,2.25,0,0,0,4,0,2.0
1860,7,1860,2.5,0,0,0,2,0,2.0
4010,11,4010,3.5,0,1,0,4,0,2.0
2480,8,1900,2.25,0,0,580,4,0,1.0
1270,8,1090,1.0,0,0,180,2,0,1.0
990,7,990,1.0,0,0,0,2,0,1.0
1210,7,1210,1.0,0,0,0,3,0,1.0
1930,7,1150,1.75,0,1,780,3,0,1.0
1910,7,1010,2.0,1,0,900,5,0,1.0
1730,8,1000,1.5,0,1,730,3,0,1.0
2570,10,2570,2.5,0,0,0,4,0,1.5
1050,7,1050,1.0,0,0,0,2,0,1.0
1890,7,980,2.5,0,0,910,4,0,1.0
2050,7,2050,2.5,0,0,0,3,0,3.0
2820,7,1630,2.75,0,0,1190,2,0,2.0
2970,9,2970,3.0,0,0,0,5,0,2.0
2860,7,1560,2.75,0,1,1300,4,0,1.0
1500,7,1150,2.25,0,0,350,3,0,1.0
1840,7,1400,2.5,0,0,440,4,0,2.0
1420,7,1420,2.0,0,0,0,3,0,1.0
520,5,520,1.0,0,0,0,2,0,1.0
4380,9,3720,4.5,0,3,660,3,1,2.0
2680,9,2680,2.5,0,0,0,4,0,2.0
670,6,670,1.0,0,0,0,2,0,1.0
3140,8,1570,2.25,0,0,1570,6,0,1.0
1530,7,1530,2.0,0,0,0,3,0,1.0
2210,8,1530,1.5,0,2,680,2,0,1.0
1580,7,1580,2.5,0,0,0,3,0,2.0
5000,10,3410,3.5,1,3,1590,5,0,2.0
1220,7,1220,1.0,0,0,0,2,0,1.0
4040,10,3690,2.5,1,2,350,4,0,2.0
750,7,750,1.0,0,0,0,2,0,1.0
3100,9,3100,3.5,0,0,0,4,0,2.0
1580,7,1080,1.75,1,0,500,4,0,1.0
2260,6,2260,2.5,0,2,0,3,0,1.0
1720,7,1720,3.0,0,2,0,3,0,1.0
1280,7,1280,2.0,0,0,0,3,0,1.0
930,6,820,1.0,0,0,110,3,0,1.0
970,6,970,1.0,0,0,0,3,0,1.0
2070,7,1060,1.5,0,0,1010,4,0,1.0
2110,7,1870,2.75,0,0,240,5,0,2.0
1450,7,1350,1.75,0,0,100,2,0,1.5
1800,8,1500,3.0,0,2,300,3,0,1.5
1310,7,1310,1.0,0,0,0,3,0,1.0
720,6,720,2.0,0,0,0,3,0,1.0
2080,8,1330,1.75,0,0,750,4,0,1.0
3490,8,3490,3.5,0,0,0,5,0,2.0
2210,8,1730,2.75,0,0,480,4,0,2.0
1770,8,1770,1.75,0,2,0,4,0,1.0
2140,7,1220,1.75,0,2,920,5,0,1.0
1210,7,1210,1.0,0,0,0,3,0,1.0
1290,7,1290,2.0,0,0,0,3,0,1.0
1790,7,1480,3.5,0,0,310,3,0,2.0
3400,10,3400,2.25,0,0,0,3,0,2.0
2260,9,2260,2.5,0,0,0,3,0,2.0
1820,7,1380,1.5,1,0,440,4,0,1.0
3180,9,3180,2.5,0,0,0,5,0,1.0
1330,7,1330,1.5,0,0,0,3,0,2.0
3250,8,3250,2.75,0,0,0,4,0,2.0
1670,8,1670,2.0,0,0,0,3,0,1.0
1200,6,1200,1.0,0,0,0,3,0,1.0
2180,9,2180,1.75,1,0,0,4,0,1.0
1360,6,1020,1.0,0,0,340,4,0,1.0
1250,7,1250,2.0,0,0,0,2,0,1.0
3570,9,2370,3.25,0,0,1200,2,0,1.0
1450,8,1140,2.25,0,0,310,3,0,2.0
3280,10,2180,2.5,0,4,1100,4,0,2.0
1430,7,1430,1.0,1,0,0,3,0,1.0
2020,7,2020,2.0,0,0,0,4,0,1.5
1230,7,1230,1.0,0,0,0,3,0,1.0
1440,7,1440,2.0,0,0,0,4,0,1.0
1360,8,1360,1.5,0,0,0,3,0,3.0
2110,8,1280,1.75,0,0,830,3,0,1.0
4110,10,2570,3.25,0,2,1540,4,0,2.0
1310,6,810,1.0,0,0,500,2,0,1.0
970,7,970,1.0,0,0,0,3,0,1.0
3330,9,3330,3.25,1,0,0,3,0,2.5
1620,8,1340,1.75,0,0,280,3,0,1.0
1690,7,1690,2.5,0,0,0,3,0,2.0
2350,9,2350,2.5,0,0,0,4,0,2.0
2750,8,1770,4.5,0,0,980,6,0,2.0
1650,8,1650,1.75,0,0,0,5,0,1.5
1970,7,1130,1.75,0,0,840,3,0,1.0
1490,7,770,2.0,0,0,720,3,0,1.0
2080,8,2080,2.5,0,0,0,3,0,2.0
1710,7,1710,1.5,0,2,0,3,0,2.0
1640,8,1640,2.25,1,0,0,3,0,3.0
2180,7,2180,3.0,0,0,0,6,0,2.0
3780,11,2770,4.5,0,4,1010,4,0,2.0
1400,7,1000,1.0,0,0,400,4,0,1.0
5730,11,4280,2.5,0,4,1450,4,0,2.0
1140,6,1140,2.0,1,0,0,2,0,1.0
1500,7,750,1.75,0,0,750,4,0,1.0
1010,7,1010,2.0,0,0,0,3,0,1.0
2880,9,1710,2.25,1,2,1170,3,0,1.0
2270,7,1360,2.75,0,0,910,4,0,1.0
1840,8,1140,1.75,0,0,700,2,0,1.0
1970,8,1350,2.0,0,0,620,4,0,1.0
1370,7,1370,1.0,0,0,0,3,0,1.5
2460,8,1370,2.0,0,2,1090,3,0,1.0
3220,8,3220,2.5,0,0,0,5,0,2.0
930,6,930,1.0,0,0,0,2,0,1.0
2810,8,2810,2.5,0,0,0,3,0,2.0
830,7,830,1.0,0,0,0,2,0,1.0
2810,10,2810,2.75,0,4,0,3,1,2.0
2330,8,2330,2.5,0,0,0,3,0,2.0
2010,7,1090,1.75,0,0,920,3,0,1.0
1490,10,1090,1.75,0,0,400,3,0,2.0
2100,7,1050,1.0,0,0,1050,4,0,1.0
1330,7,1040,1.75,0,0,290,3,0,1.0
910,6,910,1.0,0,0,0,2,0,1.0
2060,8,2060,2.25,0,0,0,4,0,1.0
800,6,800,1.5,0,0,0,3,0,1.0
2230,8,2230,3.0,0,0,0,4,0,2.0
3270,9,2180,3.5,0,0,1090,5,0,2.0
3030,9,3030,2.5,0,0,0,4,0,3.0
2420,8,2420,2.0,0,0,0,3,0,1.5
890,7,890,1.0,0,0,0,3,0,1.0
1900,8,1500,2.0,0,0,400,3,0,1.0
2100,8,1750,2.25,1,0,350,4,0,1.5
1120,7,770,1.0,0,0,350,2,0,1.0
2340,8,2160,3.0,0,0,180,3,0,2.0
2200,7,1290,2.75,0,0,910,4,0,1.0
1540,9,1540,3.25,0,0,0,3,0,3.0
2669,9,2669,2.5,0,0,0,4,0,2.0
1890,9,1890,1.5,0,0,0,3,0,1.5
2750,9,2750,2.5,0,0,0,3,0,2.0
3530,10,3530,2.5,1,0,0,3,0,2.0
2800,9,2800,2.5,0,0,0,4,0,2.0
4090,9,3100,3.75,0,0,990,6,0,2.0
1580,7,1580,1.75,0,0,0,3,0,1.0
2260,7,1520,2.5,0,0,740,4,0,1.0
740,5,740,1.0,0,2,0,2,0,1.0
1300,7,1300,1.5,0,2,0,2,0,1.0
1480,6,1480,2.0,0,0,0,4,0,1.5
1830,8,1830,2.5,0,0,0,4,0,2.0
820,7,820,1.0,0,0,0,2,0,1.0
1890,8,1730,2.5,0,0,160,3,0,2.0
2200,8,2200,2.5,0,0,0,4,0,2.0
1890,7,1890,1.5,0,0,0,4,0,1.0
3100,7,3100,3.0,0,0,0,5,0,2.0
1520,8,1240,2.5,0,0,280,2,0,2.0
800,6,800,1.0,0,0,0,2,0,1.0
2340,8,1470,2.75,0,2,870,3,0,1.0
740,6,740,1.0,0,0,0,2,0,1.0
1000,6,1000,1.0,0,0,0,2,0,1.0
1700,8,1700,2.5,0,0,0,3,0,2.0
1490,7,1490,1.75,0,0,0,3,0,1.0
2000,7,1790,2.5,0,0,210,6,0,1.5
2810,8,2810,2.5,0,0,0,4,0,2.0
520,5,520,1.0,0,0,0,1,0,1.0
700,6,480,1.0,0,0,220,2,0,1.0
3610,7,3610,3.5,0,0,0,5,0,2.0
1590,6,1590,1.0,0,0,0,4,0,1.5
3030,9,3030,2.75,0,0,0,5,0,2.0
1900,8,1220,2.25,0,0,680,3,0,1.0
1770,7,1770,2.5,0,0,0,3,0,2.0
1940,7,1940,1.75,0,0,0,3,0,1.0
1960,7,1960,2.0,0,0,0,4,0,2.0
2670,8,2670,1.75,0,4,0,4,0,2.0
1880,7,1880,2.5,0,0,0,3,0,2.0
1340,7,880,1.75,0,0,460,3,0,1.0
970,6,970,1.0,0,0,0,3,0,1.0
1630,7,1630,1.75,0,3,0,3,0,1.5
1710,7,1710,2.5,0,0,0,3,0,2.0
1050,7,1050,1.0,0,0,0,3,0,1.0
2210,7,1310,1.75,0,0,900,6,0,1.0
1770,7,1770,2.0,0,0,0,4,0,2.0
1330,7,970,1.0,0,0,360,4,0,1.0
4590,9,2500,5.25,1,2,2090,10,0,1.0
2450,7,1450,2.0,0,0,1000,4,0,1.0
3200,9,3200,2.5,0,0,0,4,0,2.0
1670,7,1030,2.0,0,0,640,4,0,1.0
1720,9,1410,3.25,0,2,310,3,0,2.5
1480,7,1480,1.5,0,0,0,3,0,1.0
1310,7,780,2.0,0,0,530,3,0,1.0
1120,6,860,1.75,0,0,260,3,0,1.0
2030,8,2030,3.25,0,0,0,3,0,2.0
1950,7,1350,2.25,0,0,600,4,0,1.0
3170,7,3170,2.5,0,0,0,4,0,2.0
2130,8,2130,2.5,0,0,0,4,0,2.0
2440,8,2440,2.5,0,0,0,4,0,2.0
3090,10,3090,2.5,0,0,0,3,0,2.0
5850,12,4410,3.75,1,0,1440,4,0,2.0
1330,6,1330,1.0,0,0,0,3,0,1.5
710,6,710,1.0,1,0,0,2,0,1.0
1140,7,1140,1.0,0,0,0,3,0,1.0
2070,7,1120,2.75,0,0,950,4,0,1.0
1140,7,1140,1.75,0,0,0,3,0,1.0
4510,10,4510,4.0,1,0,0,5,0,2.0
2670,8,2020,1.75,0,0,650,4,0,2.0
2640,10,2640,2.5,0,3,0,3,0,1.5
1490,8,1490,2.0,0,0,0,3,0,3.0
3090,8,2190,3.5,0,0,900,4,0,1.0
1880,7,1040,1.75,0,0,840,3,0,1.0
3330,8,1790,3.0,0,0,1540,4,0,1.0
2140,8,1480,2.0,0,0,660,3,0,1.0
2710,8,2710,2.5,0,0,0,4,0,2.0
1280,7,1280,2.0,0,0,0,3,0,1.0
2120,8,2120,3.0,0,0,0,4,0,2.0
2500,7,2500,2.5,0,0,0,4,0,2.0
770,6,770,1.0,0,0,0,2,0,1.0
2350,7,1510,2.25,1,1,840,4,0,1.0
970,6,970,1.0,0,0,0,2,0,1.0
1490,8,1220,3.25,0,0,270,3,0,3.0
1960,7,1160,2.0,0,0,800,4,0,1.0
2060,8,1320,2.25,1,0,740,4,0,1.0
1130,8,1030,1.5,0,0,100,2,0,2.0
3810,11,3810,3.75,1,0,0,4,0,2.0
3010,9,3010,2.5,0,0,0,4,0,2.0
1560,8,1560,2.0,0,0,0,3,0,3.0
2580,7,1290,1.75,1,0,1290,3,0,1.0
1778,7,1778,2.5,0,0,0,3,0,2.0
2580,8,1290,1.75,0,2,1290,4,0,1.0
1530,7,1530,1.5,0,0,0,3,0,1.0
1420,7,1420,1.5,0,0,0,3,0,1.0
2680,7,2680,2.25,0,0,0,3,0,2.0
2440,7,1240,2.75,0,0,1200,5,0,1.0
1790,7,1790,1.75,0,0,0,3,0,1.0
1200,6,1200,1.0,0,0,0,2,0,1.0
1700,7,1100,2.25,0,0,600,3,0,1.5
1170,7,970,1.0,0,0,200,2,0,1.0
2080,6,1040,1.75,0,0,1040,3,0,1.0
4180,9,4180,4.0,0,0,0,5,0,2.0
2470,8,2470,2.5,0,0,0,4,0,2.0
1950,8,1250,1.75,0,0,700,3,0,1.0
1960,8,1960,1.75,0,0,0,4,0,1.0
1410,8,1410,1.0,0,0,0,3,0,1.0
2440,9,1450,3.0,0,0,990,5,0,1.0
1650,7,1650,2.5,0,0,0,3,0,2.0
2080,8,2080,2.5,0,0,0,3,0,2.0
3010,9,3010,3.5,0,0,0,4,0,2.0
2560,9,2110,2.5,1,0,450,3,0,2.0
3090,9,3090,3.25,0,4,0,4,0,2.0
5000,11,3610,3.5,0,0,1390,4,0,2.0
1870,7,1870,2.5,0,0,0,3,0,2.0
3500,9,3500,2.75,0,0,0,4,0,2.0
2670,8,1630,2.75,0,3,1040,4,0,2.0
1150,7,1150,1.75,1,0,0,3,0,1.0
3770,10,2830,3.5,0,0,940,4,0,2.0
2640,9,2640,2.25,0,0,0,4,0,1.0
3400,8,1700,2.5,0,0,1700,5,0,1.0
1650,7,1650,2.5,0,0,0,3,0,2.0
2770,9,2770,2.5,1,0,0,5,0,2.0
2500,8,1300,2.5,1,0,1200,5,0,1.0
560,5,560,1.0,0,0,0,1,0,1.0
1010,7,1010,2.0,0,0,0,3,0,1.0
2070,8,1220,2.0,0,0,850,3,0,1.0
1650,7,1220,1.75,0,0,430,3,0,1.0
3190,9,1890,3.0,0,2,1300,5,0,1.0
2040,7,1360,1.75,0,0,680,4,0,1.0
1930,9,1930,2.5,0,0,0,4,0,1.0
2320,7,2320,1.5,0,0,0,3,0,1.0
1810,7,1810,1.5,0,0,0,4,0,1.5
2050,8,2050,1.75,0,2,0,2,0,1.5
1250,7,980,1.75,0,0,270,3,0,1.0
2920,8,1460,2.0,1,2,1460,3,0,1.0
1770,7,1770,2.5,0,0,0,4,0,2.0
3000,7,2400,3.0,0,0,600,11,0,2.0
2540,8,1600,2.0,0,3,940,3,0,1.5
1200,6,1200,1.0,0,0,0,3,0,1.0
3240,8,2770,3.25,0,0,470,3,0,2.0
2190,7,2190,2.25,0,0,0,4,0,2.0
2520,8,2520,2.75,0,0,0,4,0,2.0
1870,8,1870,1.75,0,0,0,4,0,1.0
1500,7,1500,1.0,0,0,0,4,0,1.5
2090,7,1610,1.75,0,0,480,3,0,2.0
1360,7,860,1.75,0,0,500,2,0,1.0
3980,10,3980,3.25,1,0,0,4,0,2.0
1470,8,1340,2.25,0,0,130,2,0,2.0
1650,8,1650,1.75,0,0,0,3,0,1.5
3040,9,3040,2.5,0,0,0,4,0,2.0
1390,7,1390,2.0,0,0,0,4,0,1.5
4410,10,2920,3.5,1,3,1490,5,0,2.0
950,8,950,1.75,0,0,0,2,0,1.0
2690,8,2690,2.5,0,0,0,4,0,2.0
930,7,830,1.5,0,2,100,2,0,1.0
1790,7,1670,2.0,0,1,120,4,0,1.0
1320,7,1320,1.5,0,0,0,2,0,3.0
3590,9,3590,3.0,0,0,0,4,0,2.0
810,6,810,1.0,0,0,0,2,0,1.0
1870,7,990,1.75,0,0,880,3,0,1.0
1510,7,1510,1.75,0,0,0,3,0,1.0
3190,9,3190,2.5,0,0,0,4,0,2.0
1230,7,1230,1.75,0,0,0,3,0,1.0
2410,9,1840,2.0,1,0,570,3,0,2.0
1720,7,1140,2.25,1,0,580,3,0,1.0
1170,6,780,1.75,0,0,390,2,0,1.0
1110,6,1110,1.0,0,0,0,2,0,1.0
1190,7,1190,1.5,0,0,0,3,0,1.0
1010,7,1010,1.5,0,0,0,3,0,1.0
2410,9,2410,2.5,0,0,0,3,0,2.0
1130,8,910,1.5,0,0,220,2,0,2.0
900,7,900,1.0,0,0,0,2,0,1.0
1960,8,1960,1.75,0,0,0,4,0,1.0
1250,7,1250,1.0,0,0,0,3,0,1.0
3880,9,2540,3.5,1,3,1340,5,0,2.0
1250,8,1250,2.25,0,0,0,3,0,3.0
1830,7,1830,2.25,0,0,0,3,0,2.0
2000,8,1250,2.25,1,0,750,3,0,1.0
2440,8,1700,2.5,0,0,740,4,0,2.0
2229,7,2229,2.5,0,0,0,4,0,2.0
1560,7,1560,1.0,1,0,0,3,0,1.5
1070,7,1070,1.0,0,0,0,3,0,1.0
2530,8,2530,2.5,0,0,0,4,0,2.0
1280,6,1280,1.0,0,0,0,3,0,1.5
2670,8,2170,2.25,0,0,500,4,0,1.0
2600,8,2600,2.5,0,0,0,4,0,2.0
1410,8,1410,1.75,0,0,0,3,0,2.0
2180,7,1210,2.75,0,3,970,4,0,1.0
2430,7,2430,2.5,0,0,0,4,0,2.0
1200,7,1200,1.5,0,0,0,3,0,1.0
3000,7,1970,2.0,0,0,1030,3,0,2.0
1270,7,1270,1.75,0,2,0,4,0,1.0
2010,7,1860,3.0,0,0,150,3,0,2.0
2400,8,1900,2.0,0,0,500,5,0,1.5
1930,7,1360,2.25,0,0,570,4,0,1.0
3250,8,3250,2.5,0,0,0,4,0,2.0
1300,7,1300,1.75,0,0,0,3,0,1.0
1440,7,1440,1.0,0,0,0,4,0,1.5
2960,7,1500,2.0,0,0,1460,5,0,1.0
6630,10,4930,5.5,1,0,1700,7,0,2.0
2080,7,2080,2.75,0,0,0,3,0,1.0
2040,7,2040,2.5,0,0,0,4,0,2.0
2570,9,2570,2.5,0,0,0,3,0,2.0
1370,8,1080,2.75,0,0,290,2,0,2.0
1870,8,1620,1.75,0,0,250,4,0,1.0
2070,8,1470,2.25,0,0,600,4,0,1.0
600,5,600,1.0,0,0,0,2,0,1.0
1300,7,1300,1.0,0,0,0,4,0,1.0
1420,8,1420,1.75,0,0,0,3,0,3.0
2930,11,1920,2.25,1,2,1010,3,0,2.0
2010,9,1610,2.5,0,0,400,3,0,2.0
2210,9,2210,2.5,0,0,0,4,0,2.0
2430,10,2430,2.5,0,0,0,3,0,2.0
1120,7,1120,1.0,0,0,0,4,0,1.5
1690,7,1080,2.5,0,0,610,4,0,1.0
1160,7,1160,1.0,0,0,0,3,0,1.0
1480,7,1480,2.0,0,0,0,4,0,1.0
1130,6,1130,2.0,0,0,0,2,0,1.0
3950,11,2880,4.5,0,3,1070,3,0,2.0
1040,6,1040,1.0,0,0,0,3,0,1.0
2330,7,1480,2.5,0,0,850,3,0,1.0
4190,11,4190,3.5,0,2,0,4,0,2.0
1240,7,1240,1.5,0,0,0,3,0,1.0
2970,8,1810,3.0,0,0,1160,5,0,1.0
2030,8,1330,1.75,0,0,700,3,0,1.0
1390,7,1390,2.0,0,0,0,3,0,1.0
2760,8,1400,2.75,0,0,1360,4,0,1.0
3590,9,2950,2.5,0,0,640,3,0,1.0
1800,7,1080,2.0,0,0,720,3,0,1.0
1430,6,1230,1.0,1,0,200,2,0,1.5
2760,9,2760,2.5,0,0,0,4,0,2.0
1920,7,960,1.75,0,0,960,4,0,1.0
1500,7,1100,1.5,0,0,400,3,0,1.0
1630,7,1050,2.0,0,0,580,4,0,1.0
1190,7,1190,1.5,0,0,0,3,0,1.0
2330,8,1590,1.75,1,0,740,3,0,1.0
1000,5,1000,1.0,0,0,0,2,0,1.0
980,7,980,1.5,1,0,0,3,0,1.0
630,6,630,1.0,0,0,0,2,0,1.0
1780,7,1210,1.75,0,0,570,3,0,1.0
2800,9,1580,3.0,0,0,1220,3,0,1.0
1510,9,1330,3.25,0,0,180,3,0,2.0
2060,9,2060,2.5,0,0,0,3,0,2.0
4320,10,2160,2.25,1,0,2160,3,0,1.0
1850,7,1130,3.5,0,0,720,4,0,2.0
2410,7,1950,2.25,0,1,460,4,0,1.0
2329,8,2329,2.5,0,0,0,3,0,2.0
1190,7,1190,1.5,0,0,0,2,0,3.0
1950,7,1150,2.25,0,2,800,5,0,1.0
1160,7,1160,1.0,0,0,0,3,0,1.0
2020,7,2020,2.0,0,0,0,5,0,2.0
2980,8,2980,2.5,0,0,0,4,0,2.0
1000,7,1000,1.0,0,0,0,3,0,1.0
1920,7,1240,2.25,0,0,680,3,0,1.0
1450,7,1450,1.0,0,0,0,2,0,2.0
1790,7,1170,2.25,0,0,620,4,0,1.0
1700,7,1700,2.5,0,0,0,3,0,2.0
2150,7,1360,2.5,0,0,790,4,0,1.0
1730,7,1330,2.5,0,0,400,3,0,1.0
3230,10,3230,3.25,0,0,0,3,0,2.0
2830,9,2830,2.5,0,0,0,3,0,2.0
1010,7,1010,1.0,0,0,0,3,0,1.0
4400,11,4400,3.25,0,0,0,4,0,2.0
1590,6,1590,1.75,0,0,0,3,0,1.5
2830,9,2830,2.5,0,0,0,3,0,2.0
3990,11,3990,3.5,0,0,0,5,0,2.0
1670,6,860,2.0,0,0,810,2,0,1.0
1420,8,1140,2.5,0,0,280,3,0,2.0
3240,9,2500,3.25,0,4,740,5,0,1.5
1330,8,1330,2.5,0,0,0,3,0,3.0
4610,11,4610,3.5,1,2,0,4,0,2.0
1400,7,1400,2.0,0,0,0,3,0,1.0
2430,9,2430,2.5,0,0,0,4,0,2.0
1830,7,1830,2.5,0,0,0,4,0,2.0
1450,7,1450,1.0,0,0,0,2,0,1.0
2060,8,2060,1.5,1,0,0,4,0,1.0
1320,6,1320,1.0,0,0,0,3,0,1.0
3380,7,2420,3.25,0,3,960,4,0,2.0
1720,7,1720,1.0,0,0,0,4,0,1.5
2350,8,2350,2.5,0,0,0,4,0,2.0
1140,7,1140,1.75,0,0,0,3,0,1.0
2680,7,1340,2.5,1,0,1340,6,0,1.0
1940,8,1940,2.75,0,0,0,4,0,2.0
1370,7,1070,1.0,0,0,300,3,0,1.0
4570,12,4570,2.5,0,4,0,4,0,2.0
1270,8,1270,2.0,0,0,0,2,0,3.0
2070,8,2070,2.5,0,0,0,3,0,2.0
2490,9,2490,2.5,0,0,0,3,0,2.0
2680,9,2680,2.5,0,0,0,3,0,2.0
2120,8,2120,2.25,0,0,0,4,0,2.0
1040,7,1040,1.0,0,0,0,3,0,1.0
1410,7,1410,1.0,0,0,0,3,0,1.0
2480,7,2480,2.5,0,0,0,3,0,2.0
2740,8,1670,3.0,0,0,1070,4,0,1.0
1370,7,1370,2.5,0,0,0,2,0,2.0
1170,7,1170,1.0,0,0,0,2,0,1.5
1160,7,1160,1.75,0,0,0,3,0,1.0
1430,7,1430,1.5,0,0,0,3,0,1.0
3020,10,2720,2.25,0,0,300,3,0,2.0
1260,7,1260,1.0,0,2,0,3,0,1.5
2360,9,2360,2.5,0,2,0,3,0,1.0
2300,8,2300,0.5,0,0,0,4,0,2.0
3190,9,1680,2.5,1,3,1510,4,0,1.0
1960,7,980,1.75,0,0,980,5,0,1.0
2050,8,2050,2.5,0,0,0,3,0,2.0
3420,9,3420,3.5,0,0,0,4,0,2.0
2490,7,1290,1.75,0,0,1200,3,0,1.0
2490,8,1490,2.25,0,0,1000,4,0,1.0
1500,7,1060,2.0,0,0,440,3,0,1.0
2080,8,2080,2.75,0,0,0,4,0,1.5
2810,9,2810,2.5,0,0,0,4,0,2.0
1390,7,1390,2.0,0,0,0,3,0,1.5
2940,9,2940,2.5,0,0,0,4,0,2.0
3220,10,3220,2.5,0,1,0,4,0,2.0
2540,8,1270,3.0,1,0,1270,5,0,1.0
1180,6,1030,1.0,0,0,150,3,0,1.0
1890,7,1890,1.5,0,0,0,4,0,1.0
1670,7,1670,2.0,0,0,0,4,0,1.0
1340,6,1340,1.75,0,0,0,4,0,1.5
1510,7,1510,1.5,0,0,0,3,0,1.0
1700,7,1700,2.25,0,0,0,3,0,2.0
1960,7,1960,2.5,0,0,0,4,0,2.0
2010,8,1390,2.5,0,0,620,3,0,2.0
2190,7,2190,1.75,0,0,0,3,0,1.5
1070,7,1070,1.75,0,0,0,3,0,1.0
2270,7,1360,3.0,0,0,910,5,0,1.0
3360,9,3360,2.75,0,0,0,5,0,2.0
2010,7,1150,1.75,0,0,860,4,0,1.0
1590,7,1590,2.5,0,0,0,3,0,2.0
2420,7,1210,2.5,0,0,1210,4,0,1.0
4370,10,2580,3.5,0,2,1790,4,0,1.0
1910,7,1610,1.5,0,0,300,4,0,1.5
1690,8,1140,2.5,0,0,550,3,0,2.0
1140,8,1140,1.0,0,0,0,2,0,1.0
1270,7,1270,1.0,0,2,0,3,0,1.0
2170,8,2170,2.5,0,0,0,2,0,1.0
1654,7,1654,2.25,0,0,0,3,0,2.0
1500,7,900,2.5,0,0,600,3,0,1.0
2780,7,1390,2.5,1,3,1390,4,0,1.0
720,6,720,1.0,0,0,0,2,0,1.0
2900,9,2900,2.5,1,0,0,4,0,2.0
1470,8,930,2.5,0,0,540,3,0,2.0
980,7,760,1.0,0,0,220,3,0,1.0
1570,8,1330,3.5,0,0,240,3,0,2.5
5350,11,3040,3.75,1,1,2310,5,0,1.0
1880,7,960,1.75,0,0,920,5,0,1.0
2290,7,2290,2.5,0,0,0,4,0,2.0
6300,12,4360,4.0,1,1,1940,5,0,2.0
680,5,680,1.0,0,0,0,2,0,1.0
2900,8,2900,2.5,0,0,0,4,0,2.0
1340,6,1340,1.0,0,0,0,3,0,1.0
2100,8,2100,2.25,1,0,0,4,0,2.0
2540,7,2540,2.5,0,0,0,5,0,2.0
770,6,770,1.0,0,0,0,2,0,1.0
1930,8,1130,1.75,0,0,800,3,0,1.0
970,7,970,1.0,0,0,0,3,0,1.0
2930,9,2930,3.25,0,0,0,4,0,2.0
1560,8,1240,3.5,0,0,320,3,0,2.0
1490,6,1490,2.0,0,0,0,4,0,1.0
2864,8,2864,3.25,0,0,0,4,0,3.0
2010,7,2010,1.75,0,0,0,3,0,2.0
1160,8,1160,1.5,0,0,0,3,0,3.0
3350,10,3350,3.0,0,0,0,4,0,2.0
1494,7,1494,2.0,0,4,0,2,1,2.0
1140,7,1040,2.0,0,0,100,2,0,2.0
2070,7,2070,2.25,0,0,0,4,0,2.0
1340,7,1340,1.75,0,0,0,3,0,1.0
2800,7,1400,2.0,0,0,1400,3,0,1.0
1440,8,1440,2.0,0,0,0,2,0,1.0
12050,13,8570,8.0,0,3,3480,6,0,2.5
1350,7,1350,2.0,0,0,0,3,0,1.0
2880,9,1920,3.0,0,0,960,4,0,2.0
1730,7,1480,1.75,0,0,250,3,0,1.0
1200,8,1200,2.0,0,0,0,2,0,1.0
2070,8,1720,2.25,0,0,350,3,0,1.0
2510,7,1610,2.25,0,0,900,4,0,1.0
2450,9,2450,2.5,0,0,0,4,0,2.0
2400,8,2400,2.75,0,0,0,5,0,2.0
3140,9,3140,2.5,0,0,0,4,0,2.0
2240,8,2240,1.75,0,0,0,3,0,2.0
2100,7,2100,2.5,0,4,0,3,0,2.0
1070,6,1070,1.0,0,0,0,2,0,1.0
1040,6,1040,1.0,0,0,0,3,0,1.0
2960,10,2960,3.25,0,0,0,3,0,2.0
1200,6,1200,2.0,0,0,0,2,0,2.0
2160,8,1080,2.25,1,0,1080,4,0,1.0
1760,8,1310,1.0,0,0,450,2,0,1.0
1400,7,1400,1.75,0,0,0,3,0,1.0
2720,7,1360,2.5,0,0,1360,4,0,1.0
1500,7,1500,1.5,0,0,0,3,0,1.0
1840,7,920,1.75,0,0,920,3,0,1.0
2030,7,1210,2.75,0,0,820,3,0,1.0
3030,10,3030,2.5,0,0,0,4,0,2.0
4475,9,4475,3.25,0,0,0,5,0,2.0
2140,7,1470,2.25,0,0,670,3,0,1.0
2680,8,2680,2.25,0,0,0,3,0,1.0
3060,10,3060,2.25,1,0,0,3,0,2.0
2850,10,2700,3.25,1,0,150,4,0,2.5
2560,7,1280,1.75,1,0,1280,3,0,1.0
2000,8,2000,2.5,0,0,0,3,0,3.0
2120,6,2120,1.5,0,0,0,4,0,1.5
2750,7,1750,3.0,0,0,1000,5,0,1.5
2270,7,1410,3.0,0,0,860,4,0,1.0
2510,8,1840,2.25,0,0,670,4,0,2.0
2270,8,1420,1.5,0,0,850,3,0,1.0
2160,7,1500,2.75,0,0,660,5,0,1.0
1840,8,1840,3.25,0,0,0,2,0,3.0
1690,7,870,1.75,0,0,820,4,0,1.0
2200,8,2200,2.25,0,0,0,3,0,2.0
3280,10,3280,2.25,0,0,0,3,0,1.0
1060,7,1060,1.0,0,0,0,3,0,1.0
1470,7,1470,1.75,0,0,0,3,0,1.0
1410,8,1410,3.25,0,0,0,3,0,3.0
5540,11,3950,4.75,0,2,1590,6,0,2.5
2140,8,2140,1.75,0,0,0,4,0,2.5
930,5,930,1.0,0,0,0,2,0,1.0
5305,11,3745,4.75,1,2,1560,5,0,2.0
1270,7,1270,1.75,1,0,0,3,0,1.0
860,7,860,1.0,0,0,0,2,0,1.0
2430,9,2430,2.25,0,0,0,4,0,1.0
2090,7,2090,2.5,0,0,0,5,0,2.0
2160,7,1410,2.75,0,0,750,4,0,1.0
1860,8,1860,2.5,0,0,0,3,0,2.0
2170,7,2170,2.75,0,0,0,4,0,2.0
1950,8,1330,2.25,0,0,620,4,0,1.0
1340,7,1340,1.0,0,0,0,4,0,1.5
1790,7,1390,2.0,0,0,400,3,0,1.0
1410,8,1410,2.0,0,0,0,3,0,1.5
800,6,800,1.0,0,0,0,3,0,1.0
2020,7,1010,1.5,0,0,1010,4,0,1.0
2240,7,1650,2.75,0,0,590,3,0,2.5
1730,6,1730,1.75,0,0,0,3,0,1.5
1820,7,1820,2.5,1,0,0,3,0,1.0
1940,7,970,1.75,0,0,970,4,0,1.0
2740,10,2740,2.75,0,0,0,4,0,2.0
2420,7,1520,3.0,0,0,900,4,0,1.5
1740,7,1180,1.75,0,0,560,4,0,1.0
1740,8,1740,2.5,0,2,0,3,0,3.0
1790,8,1790,2.5,0,0,0,3,0,2.0
1610,7,1610,1.5,0,0,0,3,0,1.0
1490,8,1190,2.0,0,0,300,2,0,2.0
2360,8,2360,4.25,0,0,0,4,0,2.0
4700,11,2520,3.25,0,4,2180,4,0,1.0
1920,7,1470,1.75,1,0,450,4,0,1.0
2770,8,1910,3.0,0,0,860,2,0,1.5
1410,7,1290,2.25,0,0,120,3,0,2.0
2150,8,2150,2.5,0,0,0,3,0,2.0
700,6,700,1.0,0,0,0,1,0,1.0
2740,8,2740,2.5,0,0,0,5,0,2.0
1680,7,1680,1.0,0,0,0,4,0,1.5
2560,8,2560,2.5,0,1,0,4,0,2.0
2680,7,1340,2.5,0,0,1340,3,0,1.0
1730,8,1730,2.25,0,0,0,3,0,1.0
3430,10,3430,2.5,0,0,0,3,0,2.0
1330,8,1330,2.25,0,0,0,4,0,1.5
1260,8,1260,1.75,0,0,0,3,0,2.0
1060,7,1060,1.0,0,0,0,2,0,2.0
2770,8,1580,1.75,0,0,1190,3,0,1.0
1460,7,1460,1.5,0,0,0,3,0,1.0
1790,7,1100,3.25,0,0,690,4,0,2.0
3230,9,3230,2.5,0,0,0,4,0,2.0
1594,7,1088,2.5,0,0,506,4,0,1.0
1600,7,1600,1.0,0,0,0,3,0,1.0
1520,7,1520,1.75,0,0,0,3,0,1.0
1830,8,1830,2.5,0,0,0,3,0,2.0
920,6,920,1.0,0,0,0,3,0,1.0
1160,7,1160,1.5,0,0,0,2,0,2.0
2770,9,2180,3.0,0,0,590,4,0,2.0
590,5,590,1.75,0,0,0,2,0,1.0
2650,7,1350,2.5,0,0,1300,5,0,1.0
880,6,880,1.0,0,0,0,3,0,1.0
2510,7,1710,2.5,0,0,800,5,0,1.5
770,5,770,1.0,0,0,0,2,0,1.0
2440,7,2440,2.5,0,0,0,4,0,2.0
1250,8,1250,2.25,0,0,0,3,0,3.0
2020,8,1430,2.5,0,0,590,5,0,1.0
3100,11,3100,4.25,1,2,0,6,0,3.0
2370,7,1640,2.5,0,0,730,3,0,1.0
1650,7,950,1.75,0,0,700,2,0,1.0
1810,8,1810,1.5,0,0,0,3,0,1.0
3860,7,3860,3.75,0,0,0,5,0,2.0
1050,6,1050,1.0,0,0,0,3,0,1.0
3600,9,2310,2.5,0,3,1290,3,0,1.0
3630,11,3630,2.5,0,0,0,3,0,2.0
4710,10,3690,2.75,0,3,1020,6,0,2.0
2290,7,2290,2.75,1,2,0,4,0,1.0
2020,7,2020,2.25,0,0,0,3,0,2.0
4540,11,4200,3.5,1,0,340,4,0,2.0
2040,9,2040,1.5,1,0,0,4,0,2.0
2180,8,1430,2.25,0,0,750,5,0,1.0
1720,8,1030,3.25,1,0,690,3,0,2.0
3090,8,2590,2.75,0,0,500,4,0,3.0
1670,7,1670,2.0,0,0,0,3,0,1.0
2460,8,1330,2.25,0,0,1130,5,0,1.0
2190,7,1340,2.25,0,0,850,4,0,1.0
5170,11,3520,3.5,0,4,1650,5,1,3.0
2440,8,1990,3.25,0,0,450,5,0,2.0
1810,7,1350,2.5,0,0,460,3,0,2.0
3000,9,2000,1.5,0,0,1000,3,0,2.0
2242,8,2242,2.5,0,0,0,3,0,2.0
1930,7,1930,2.5,0,0,0,3,0,2.0
2120,7,1060,1.75,0,0,1060,4,0,1.0
1770,8,1270,2.25,0,0,500,3,0,1.0
2210,8,1560,1.75,0,3,650,2,0,1.0
2260,8,1540,2.75,0,0,720,3,0,2.0
1650,8,1650,1.5,0,0,0,3,0,1.5
1800,7,1600,2.0,0,0,200,3,0,2.0
2760,8,1510,1.75,0,0,1250,5,0,1.0
1450,8,1200,3.5,0,0,250,3,0,2.0
1520,7,1140,2.0,0,0,380,3,0,1.0
1270,7,1270,1.75,0,0,0,3,0,1.0
3680,7,2830,3.0,0,0,850,9,0,2.0
3110,8,1720,2.5,0,0,1390,5,0,1.0
1320,7,1320,1.0,0,0,0,3,0,1.0
1820,8,1820,1.0,0,0,0,4,0,1.5
1560,8,1260,3.25,0,0,300,3,0,2.0
3780,11,2240,3.25,1,1,1540,4,0,1.0
1690,7,1210,2.0,0,0,480,4,0,1.0
3850,11,2430,3.5,1,1,1420,4,0,2.0
3540,9,3540,3.25,0,0,0,4,0,2.0
1270,7,990,2.25,0,0,280,3,0,1.0
1580,7,1580,1.0,0,0,0,3,0,1.0
1890,7,1230,2.5,0,0,660,4,0,1.0
1290,7,1290,1.0,0,0,0,4,0,1.5
1870,8,1870,2.0,0,0,0,2,0,1.0
1160,7,890,1.5,0,0,270,2,0,2.0
1040,7,840,1.0,0,0,200,2,0,1.0
1260,7,1260,1.5,0,0,0,3,0,1.0
1320,7,1320,1.0,0,0,0,2,0,1.5
920,7,920,1.0,0,0,0,3,0,1.0
1350,8,1350,1.75,0,0,0,2,0,1.0
1820,7,1480,2.25,0,0,340,3,0,1.0
2770,9,2770,2.25,0,0,0,4,0,2.0
5550,9,3880,4.5,1,0,1670,4,0,2.0
2690,9,2690,3.5,0,0,0,4,0,2.0
2440,7,1220,2.0,0,0,1220,4,0,1.0
1350,8,1270,2.5,0,0,80,3,0,3.0
2830,8,2830,2.75,0,0,0,3,0,2.0
3480,8,3480,3.0,0,0,0,5,0,2.0
2540,9,2540,2.5,0,0,0,4,0,2.0
3110,9,3020,2.0,0,0,90,3,0,2.0
3830,10,3830,3.75,0,0,0,5,0,2.0
2230,9,2230,2.0,0,0,0,4,0,1.5
2830,8,2830,2.75,0,0,0,4,0,2.0
1870,7,1300,1.5,0,0,570,3,0,1.0
1900,7,1180,1.75,1,0,720,4,0,1.0
1090,7,780,1.0,0,0,310,2,0,1.0
3500,9,2140,4.25,0,4,1360,4,0,1.0
3790,11,3790,3.5,0,0,0,4,0,2.0
3190,11,3190,2.5,0,0,0,4,0,2.0
1610,7,1610,2.25,0,0,0,3,0,2.0
1770,7,1770,1.5,0,0,0,4,0,1.0
1610,7,1610,1.0,0,0,0,3,0,1.5
3200,10,3200,2.5,0,0,0,4,0,2.0
1730,8,1370,2.0,0,0,360,3,0,1.0
1920,8,1920,2.5,0,0,0,3,0,2.0
5180,11,4070,4.75,0,2,1110,5,0,2.0
2290,9,2290,2.25,1,0,0,4,0,2.0
770,7,770,1.0,0,2,0,2,0,1.0
1990,6,1430,1.5,0,0,560,2,0,1.0
1140,6,1140,1.0,0,0,0,3,0,1.0
2320,9,2320,2.5,0,0,0,3,0,2.0
1910,7,1140,2.0,0,0,770,4,0,1.0
2140,7,1570,1.75,0,0,570,3,0,1.0
2730,9,2730,2.0,0,3,0,3,0,2.5
1920,8,1560,2.25,0,0,360,3,0,1.0
1470,7,1470,2.0,0,0,0,3,0,1.5
5160,12,5160,4.5,0,0,0,5,0,2.0
1410,6,1230,1.0,1,2,180,3,0,1.0
1130,8,1000,1.5,0,0,130,2,0,2.0
870,6,870,1.0,0,0,0,2,0,1.0
2260,7,1380,2.5,0,0,880,3,0,1.5
2500,8,2500,2.5,0,0,0,3,0,2.0
2050,8,2050,2.0,0,0,0,3,0,1.0
2970,8,1670,2.5,0,0,1300,5,0,1.0
1540,7,1540,1.75,0,0,0,3,0,1.0
2320,7,1220,1.75,0,0,1100,4,0,1.0
1350,7,1050,1.75,0,0,300,3,0,1.0
720,6,720,1.0,0,0,0,2,0,1.0
902,7,902,1.0,0,0,0,3,0,1.0
1680,8,1680,2.5,0,0,0,3,0,2.0
4310,10,4310,2.5,0,0,0,5,0,2.0
1752,8,1752,1.0,0,2,0,3,0,2.0
4470,9,3230,4.0,0,3,1240,6,0,3.0
2300,8,2300,2.0,0,0,0,5,0,2.5
1810,7,1810,1.5,0,0,0,3,0,1.0
1590,7,1080,1.5,0,0,510,3,0,1.0
1300,7,1300,1.0,0,0,0,3,0,1.0
1010,6,1010,1.0,0,0,0,3,0,1.0
1880,8,1650,3.5,0,0,230,4,0,3.0
2100,9,2100,2.5,1,0,0,3,0,2.0
2490,9,2490,2.0,1,0,0,4,0,2.0
1660,7,1660,1.75,1,0,0,3,0,2.0
3000,8,1500,2.5,1,0,1500,5,0,1.0
1350,7,1350,1.75,0,0,0,3,0,1.0
1660,8,1460,1.0,1,0,200,3,0,1.5
1740,7,1240,2.25,0,0,500,3,0,1.0
2980,10,2980,2.5,0,0,0,3,0,2.0
2840,9,2840,2.75,0,0,0,4,0,3.0
2320,8,2320,2.25,1,0,0,4,0,2.0
2350,7,2350,2.0,0,0,0,3,0,1.0
2020,7,2020,2.5,0,0,0,4,0,2.0
1440,7,1440,2.25,0,0,0,3,0,2.0
2010,8,2010,2.25,0,0,0,4,0,1.0
870,7,870,1.0,0,0,0,2,0,1.0
1920,7,960,1.5,0,0,960,2,0,1.0
1830,8,1830,1.75,0,2,0,3,0,1.5
1580,7,1280,1.75,0,0,300,3,0,1.5
1790,7,1130,1.75,0,0,660,3,0,1.0
750,6,750,1.0,0,2,0,2,0,1.0
1370,7,1370,1.5,0,0,0,4,0,1.5
1500,7,1190,1.0,0,0,310,2,0,1.0
1260,8,1260,3.0,0,0,0,3,0,3.0
1730,7,1250,1.75,0,0,480,4,0,1.0
3310,8,3310,2.5,0,0,0,4,0,2.0
3700,8,1920,2.5,1,0,1780,4,0,1.0
5090,11,4180,3.75,1,0,910,4,0,1.0
1910,7,1910,2.5,0,0,0,4,0,2.0
2100,8,2100,2.25,0,0,0,4,0,2.0
1400,7,1400,1.75,0,0,0,3,0,1.5
1280,6,1280,1.5,0,0,0,3,0,2.0
2750,9,2560,2.5,1,0,190,3,0,2.0
2430,7,1830,1.75,0,0,600,3,0,1.5
2560,8,1590,3.0,0,0,970,5,0,1.0
2130,8,2130,2.5,0,0,0,4,0,2.0
2090,7,1460,2.25,0,0,630,3,0,1.0
2590,8,2590,2.5,0,0,0,4,0,2.0
1550,8,1060,2.5,0,0,490,3,0,2.0
1650,8,1650,2.5,0,0,0,3,0,2.0
1300,7,1300,1.75,0,0,0,3,0,1.0
1610,8,1610,1.75,1,0,0,3,0,1.0
2910,8,1590,2.75,0,0,1320,5,0,1.0
3950,9,2250,3.0,1,0,1700,5,0,1.0
1960,6,1960,1.0,0,0,0,2,0,1.5
1760,7,1330,2.25,1,0,430,3,0,1.0
1470,7,1470,2.25,0,0,0,3,0,2.0
3860,10,2630,3.25,1,4,1230,4,0,1.0
1290,7,1290,1.75,0,0,0,3,0,1.5
1440,7,720,1.75,0,0,720,1,0,1.0
2910,10,2910,2.5,1,0,0,3,0,2.0
1460,7,730,2.0,0,0,730,3,0,1.0
2970,8,2970,2.0,0,0,0,4,0,2.0
1540,8,1540,3.25,0,0,0,3,0,2.0
680,6,680,1.0,0,0,0,2,0,1.0
3300,9,1870,3.0,1,3,1430,5,0,1.0
1330,8,1330,2.5,0,0,0,3,0,3.0
720,7,720,1.0,0,0,0,2,0,1.0
1640,7,1640,2.0,0,0,0,3,0,1.0
1810,7,1240,2.0,0,0,570,3,0,1.0
2620,9,2620,2.5,0,0,0,4,0,2.0
1860,8,1140,2.25,0,0,720,4,0,1.0
2780,9,2780,2.5,0,1,0,3,0,2.0
1160,7,1160,1.5,0,0,0,3,0,1.0
1180,7,1180,1.5,0,0,0,4,0,1.0
1560,6,1560,2.0,0,0,0,4,0,2.0
1680,6,880,2.0,0,0,800,3,0,1.0
710,6,710,1.0,0,0,0,2,0,1.0
2030,7,1450,1.75,0,0,580,4,0,1.0
1010,7,1010,1.5,0,0,0,3,0,1.0
1300,7,1300,2.0,0,0,0,3,0,2.0
3000,9,3000,2.75,0,0,0,4,0,2.0
2930,9,2130,2.25,1,0,800,6,0,2.0
1490,6,1490,1.75,0,0,0,3,0,1.0
1275,6,1275,1.75,0,0,0,4,0,1.0
2700,9,2700,3.25,0,3,0,2,1,3.0
2480,9,2480,2.25,0,0,0,5,0,2.0
2210,9,1430,2.5,0,2,780,5,0,1.0
5290,11,4540,3.25,0,0,750,3,0,2.0
1000,6,1000,1.0,0,0,0,2,0,1.0
1440,7,1440,2.0,0,0,0,4,0,1.0
1780,7,1780,3.0,0,0,0,4,0,1.0
1090,7,1090,1.0,0,0,0,2,0,1.5
1160,7,790,2.0,0,0,370,3,0,2.0
2200,9,2200,2.5,0,0,0,3,0,2.0
3700,8,2750,3.5,0,0,950,5,0,2.0
1390,7,1390,1.0,0,2,0,2,0,1.0
1190,7,1190,1.0,0,0,0,3,0,1.0
1870,8,1470,2.5,0,0,400,3,0,1.0
2320,8,1370,3.0,0,0,950,5,0,1.0
1890,7,1010,1.75,0,0,880,4,0,1.0
2740,7,1640,3.75,0,2,1100,6,0,1.0
1440,8,1440,3.0,0,2,0,3,0,3.5
3560,9,2930,2.5,0,0,630,4,0,2.0
1320,7,1320,2.5,0,0,0,3,0,3.0
5050,11,5050,3.5,0,2,0,5,0,2.0
1020,7,1020,1.0,0,0,0,3,0,1.0
2170,9,2170,2.5,0,0,0,3,0,2.0
940,7,940,1.0,1,0,0,3,0,1.0
1490,7,1490,2.0,0,0,0,3,0,1.5
2330,8,2330,2.5,0,0,0,4,0,2.0
920,7,920,1.0,1,0,0,2,0,1.0
2360,7,1180,1.75,0,0,1180,4,0,1.0
2470,9,2290,3.0,0,0,180,3,0,2.0
5310,10,3600,4.0,1,2,1710,6,0,2.0
1230,7,1230,1.0,0,0,0,3,0,1.0
1790,7,1220,2.25,0,0,570,4,0,1.0
2010,7,2010,1.75,0,0,0,4,0,1.5
2740,7,1390,3.25,0,0,1350,5,0,1.0
1130,7,1130,1.0,0,0,0,3,0,1.0
3140,8,1900,2.75,0,0,1240,4,0,1.0
1520,7,1160,2.25,0,0,360,3,0,1.0
1000,7,740,1.0,0,0,260,3,0,1.0
1400,7,1400,1.5,0,0,0,3,0,1.5
2600,8,2120,2.25,0,0,480,3,0,1.5
1230,7,1230,1.75,0,0,0,2,0,1.5
3120,9,3120,2.5,0,0,0,4,0,2.0
910,6,910,1.0,0,0,0,3,0,1.0
2160,8,2160,2.5,0,0,0,3,0,2.0
2300,7,1170,2.5,0,0,1130,5,0,1.0
2060,8,2060,2.0,0,2,0,4,0,1.0
4110,9,3150,3.25,0,3,960,5,0,2.0
1660,7,1660,2.25,0,0,0,4,0,2.0
2380,9,1650,2.25,0,0,730,3,0,2.0
3760,9,2400,3.25,0,0,1360,4,0,1.5
1940,8,1940,2.5,0,0,0,3,0,2.0
1780,6,1080,1.75,0,0,700,3,0,1.5
1430,7,1030,1.5,0,0,400,4,0,1.0
1580,7,1580,1.75,0,0,0,3,0,1.0
3130,10,3130,2.5,0,0,0,4,0,2.0
1940,8,1940,2.5,0,0,0,3,0,2.0
3330,8,1940,1.75,1,4,1390,3,1,1.0
1460,7,1010,1.75,0,2,450,3,0,1.0
2440,7,2440,2.25,0,0,0,4,0,2.0
2520,7,2040,1.75,0,0,480,4,0,1.0
2440,8,1930,3.0,0,0,510,3,0,2.0
1700,7,1230,1.0,0,2,470,2,0,1.0
2075,8,2075,2.5,0,0,0,3,0,2.0
2480,8,1640,3.25,0,0,840,5,0,2.0
2920,8,2920,2.75,0,0,0,4,0,2.0
900,7,900,1.0,0,0,0,3,0,1.0
1020,7,1020,1.0,0,0,0,3,0,1.0
2120,7,2120,2.5,0,0,0,4,0,2.0
2740,9,2740,2.5,0,0,0,4,0,2.0
1700,7,1200,2.25,0,0,500,3,0,1.0
2440,8,1480,3.0,0,0,960,4,0,1.5
1920,7,1000,1.75,0,0,920,4,0,1.0
1780,8,1780,1.5,0,0,0,3,0,1.0
2540,8,1880,2.5,0,0,660,3,0,1.0
1610,7,1610,2.0,0,0,0,4,0,2.0
3260,9,2820,2.5,0,1,440,4,0,2.0
3580,10,3190,3.75,0,0,390,5,0,2.0
1810,8,1810,1.5,0,0,0,3,0,1.0
2480,8,1480,2.5,0,3,1000,4,0,1.0
2660,8,1930,2.75,1,1,730,4,0,1.0
2620,8,1770,2.5,1,0,850,4,0,1.0
3700,11,2280,3.25,1,0,1420,3,0,2.0
1290,7,1290,2.0,0,0,0,3,0,1.0
1870,8,1870,1.75,1,0,0,3,0,1.0
2000,8,1360,2.5,0,0,640,3,0,1.0
1900,7,1260,1.75,0,0,640,3,0,1.0
1300,6,1300,1.75,0,0,0,3,0,1.0
3230,9,3230,2.5,0,0,0,4,0,2.0
1550,8,1550,2.25,0,0,0,3,0,3.0
4460,10,3460,2.75,0,2,1000,6,0,2.5
1900,7,1900,3.0,0,0,0,4,0,2.0
3300,8,1650,2.5,0,0,1650,3,0,1.0
770,6,770,1.0,0,0,0,3,0,1.0
3090,9,3090,3.5,0,0,0,4,0,2.0
2810,9,2810,2.5,0,0,0,4,0,2.0
1360,7,1360,1.5,0,0,0,2,0,2.0
1650,7,1650,2.0,0,0,0,4,0,1.0
1450,8,1450,2.5,0,0,0,3,0,1.0
830,6,830,1.0,0,0,0,2,0,1.0
1890,7,1890,2.5,0,0,0,3,0,2.0
970,5,970,1.0,0,0,0,3,0,1.0
1540,7,1040,2.0,0,0,500,4,0,1.0
2540,7,2540,2.5,0,0,0,3,0,2.0
1860,6,1860,1.0,0,0,0,3,0,1.0
2040,8,1420,2.5,1,0,620,4,0,1.0
2480,7,1470,2.5,0,2,1010,4,0,1.0
1740,8,1740,2.5,0,0,0,3,0,2.0
3510,9,3510,2.5,0,0,0,3,0,2.0
1460,6,1460,1.0,0,0,0,3,0,1.0
2690,9,2690,2.25,0,0,0,4,0,2.0
2510,7,1600,2.75,0,0,910,5,0,1.0
1750,7,1750,1.75,0,0,0,3,0,2.0
2770,7,1940,2.5,0,0,830,4,0,1.0
1310,7,1310,1.75,0,0,0,3,0,1.0
3270,9,2320,2.5,0,3,950,4,0,1.0
1090,6,1090,1.0,0,0,0,1,0,1.0
3090,8,2420,3.5,0,0,670,4,0,2.0
3190,8,2610,3.25,0,4,580,4,1,2.0
3920,7,3920,4.25,1,0,0,5,0,2.0
1440,7,960,1.0,0,0,480,2,0,1.0
3040,7,3040,2.5,0,0,0,4,0,2.0
1550,7,1550,2.5,0,0,0,3,0,2.0
2790,8,1700,1.5,0,2,1090,3,0,1.0
2750,9,1840,2.5,1,0,910,5,0,1.5
3270,8,2720,2.75,0,0,550,4,0,2.0
2718,8,2718,2.5,0,0,0,4,0,2.0
1952,7,1652,1.5,0,0,300,3,0,1.0
1730,7,1730,1.75,0,0,0,3,0,1.0
1480,8,1280,2.5,0,0,200,3,0,2.0
1310,7,1310,1.0,0,0,0,3,0,1.0
2060,7,1030,1.75,0,0,1030,3,0,1.0
3210,8,2410,4.0,0,0,800,5,0,2.0
1890,8,1260,2.25,0,0,630,4,0,1.0
2340,7,1210,2.25,0,0,1130,3,0,1.0
720,6,720,1.0,0,0,0,2,0,1.0
1010,6,1010,1.0,0,0,0,3,0,1.0
1990,7,1010,2.0,0,0,980,2,0,1.0
1330,7,900,1.5,0,0,430,3,0,1.0
1320,7,1320,2.0,0,0,0,2,0,3.0
1658,8,1658,2.5,0,0,0,3,0,2.0
960,6,960,1.0,0,0,0,3,0,1.0
4370,10,3610,3.5,1,1,760,4,0,2.0
1650,8,1300,1.75,0,0,350,3,0,2.0
2990,8,2100,2.5,0,0,890,4,0,1.0
2020,7,2020,2.5,0,0,0,4,0,2.0
1320,7,1320,2.0,0,0,0,3,0,3.0
4040,9,2020,3.0,1,0,2020,4,0,1.0
1380,8,1380,2.5,0,0,0,3,0,3.0
2820,9,2820,2.5,0,0,0,3,0,2.0
1520,8,1180,2.5,0,0,340,3,0,2.0
3597,7,3597,2.5,0,0,0,5,0,2.0
2120,7,1060,1.75,0,0,1060,4,0,1.0
2610,8,2610,2.5,0,0,0,3,0,2.0
800,7,800,1.0,0,0,0,2,0,1.0
1190,7,1190,1.0,0,0,0,3,0,1.0
3650,9,2330,4.25,0,0,1320,4,0,1.5
1930,8,1930,2.5,0,0,0,3,0,2.0
2740,7,2210,2.0,0,0,530,5,0,1.5
2475,7,2475,2.75,0,0,0,4,0,2.0
2090,8,2090,2.5,0,0,0,3,0,2.0
2370,8,2370,2.25,0,0,0,4,0,2.0
830,7,830,1.5,0,0,0,2,0,2.0
1550,7,1180,1.5,0,0,370,4,0,1.0
2140,8,1410,1.75,0,0,730,4,0,1.0
970,7,970,1.0,0,0,0,2,0,1.0
680,5,680,1.0,0,0,0,2,0,1.0
1130,7,1130,1.0,0,0,0,3,0,1.0
2520,8,2520,2.5,0,0,0,4,0,2.0
760,8,760,1.5,0,0,0,1,0,3.0
1680,7,1130,2.25,0,0,550,3,0,1.0
2410,7,1310,2.75,0,0,1100,6,0,1.0
1070,7,1070,1.0,1,0,0,3,0,1.0
2070,8,2070,2.5,0,0,0,4,0,2.0
700,6,700,1.0,0,0,0,2,0,1.0
2280,7,1340,3.0,0,0,940,4,0,1.0
2260,8,2260,2.5,0,0,0,3,0,2.0
1600,8,1600,2.5,0,0,0,3,0,2.0
1030,7,1030,1.0,0,0,0,3,0,1.0
5820,11,3750,5.0,0,0,2070,4,0,2.0
1340,7,1340,2.25,0,0,0,3,0,2.0
3700,8,3700,5.75,0,1,0,7,0,2.0
4000,10,3080,3.75,0,2,920,6,0,2.0
2120,7,1220,1.0,0,0,900,3,0,1.0
2120,8,2120,2.25,1,0,0,3,0,2.0
2110,8,2110,2.75,0,0,0,4,0,2.0
1030,7,1030,1.0,0,0,0,3,0,1.0
1360,7,1360,2.0,0,0,0,4,0,1.5
1250,7,1250,1.0,0,0,0,2,0,1.0
2600,8,2600,2.75,0,0,0,3,0,1.5
1770,9,1770,1.5,0,4,0,3,0,1.0
840,6,840,1.0,0,0,0,2,0,1.0
2160,8,1660,2.5,0,0,500,4,0,1.0
4080,8,2720,3.0,0,2,1360,5,0,2.0
820,7,820,1.0,1,0,0,2,0,1.0
1980,8,1980,2.0,0,0,0,3,0,3.0
2050,7,1550,3.75,0,0,500,3,0,2.0
4100,9,2500,3.25,0,0,1600,4,0,2.0
3520,9,3520,2.5,0,0,0,4,0,2.0
1790,7,1790,2.5,0,0,0,3,0,2.0
3420,9,3420,2.5,0,0,0,4,0,2.0
1930,7,1930,2.5,0,0,0,3,0,2.0
1550,8,1550,2.0,0,0,0,3,0,1.5
1600,7,830,2.5,0,0,770,4,0,1.0
2720,8,1510,2.5,0,0,1210,4,0,1.0
1970,8,1420,1.5,0,0,550,3,0,1.5
560,4,560,0.75,0,0,0,1,0,1.0
1350,6,1350,1.0,0,0,0,3,0,1.5
2560,8,2560,2.5,0,0,0,4,0,2.0
2240,7,1710,3.0,0,0,530,3,0,2.0
2210,8,2210,2.5,0,0,0,3,0,2.0
2030,7,2030,2.5,0,0,0,3,0,2.0
2440,8,1440,1.5,0,0,1000,4,0,1.0
1580,7,1580,1.5,0,0,0,4,0,2.0
1370,7,1370,1.0,0,0,0,3,0,1.5
2010,8,2010,2.5,0,0,0,4,0,2.0
1390,7,1390,2.0,0,0,0,2,0,2.0
1240,6,1240,1.0,0,0,0,3,0,1.5
960,7,960,1.0,0,0,0,3,0,1.0
1420,7,1100,1.75,0,0,320,3,0,1.0
1560,8,1560,3.0,0,0,0,3,0,3.0
1770,8,1600,2.5,0,0,170,3,0,3.0
3790,10,2810,3.0,0,0,980,3,0,2.0
1470,7,1470,1.0,0,0,0,3,0,1.0
2180,7,2180,2.0,0,0,0,4,0,2.0
7710,12,6090,4.0,1,0,1620,8,0,3.5
2190,7,2190,1.75,0,0,0,3,0,1.0
2420,8,1350,2.25,0,0,1070,4,0,1.0
1520,7,1520,2.0,0,0,0,4,0,1.5
750,6,750,1.0,0,0,0,2,0,1.0
1300,6,1300,1.0,1,0,0,3,0,1.0
2600,8,1600,2.75,0,2,1000,3,0,1.5
1560,7,1560,1.75,0,0,0,4,0,2.0
1710,8,1710,1.75,0,0,0,3,0,1.0
4320,12,4320,3.25,1,0,0,5,0,2.0
1080,6,1080,1.5,0,2,0,2,0,1.0
2300,8,2300,2.5,0,2,0,3,0,2.0
1810,7,1130,1.0,0,0,680,3,0,1.0
2350,8,2350,2.25,0,0,0,4,0,2.0
1260,7,1260,1.75,0,0,0,3,0,1.0
3290,8,3290,2.5,0,0,0,5,0,2.0
2040,8,2040,1.75,0,0,0,3,0,1.0
1720,7,1240,1.75,0,0,480,3,0,1.0
1780,8,1540,2.25,0,0,240,3,0,2.0
1150,7,1150,1.0,0,2,0,3,0,1.0
1890,7,1890,1.5,0,0,0,3,0,1.0
880,7,880,1.0,0,0,0,2,0,1.0
1610,7,1610,2.0,0,0,0,3,0,1.0
1500,7,1500,1.0,0,0,0,2,0,1.0
1960,7,1960,2.25,0,0,0,3,0,1.0
2610,8,1680,1.75,0,0,930,3,0,1.5
2140,8,2140,2.5,0,0,0,3,0,2.0
1410,6,1410,2.25,0,0,0,3,0,1.0
1820,7,1820,2.5,0,0,0,3,0,1.5
2920,10,2920,2.5,0,0,0,4,0,2.0
1870,7,1870,2.25,0,0,0,4,0,2.0
3890,10,3030,3.25,0,3,860,4,1,2.0
2010,8,1360,2.75,0,0,650,3,0,1.0
1500,7,910,1.75,0,0,590,2,0,1.0
770,6,770,1.0,0,0,0,2,0,1.0
2710,8,1720,2.5,1,0,990,5,0,1.0
2050,8,2050,2.5,0,0,0,4,0,2.0
2130,7,2130,2.25,0,0,0,4,0,2.0
2270,7,1340,3.0,0,0,930,5,0,1.0
750,6,750,1.0,0,0,0,2,0,1.0
1960,8,980,2.5,0,0,980,3,0,1.0
3250,8,2360,4.25,1,0,890,4,0,2.0
1430,7,1430,2.5,0,0,0,3,0,2.0
1380,8,1380,3.25,0,0,0,3,0,3.0
1560,8,1560,1.75,0,0,0,2,0,1.0
2070,7,1350,2.25,0,0,720,3,0,1.0
1610,7,1050,1.75,0,0,560,3,0,1.0
2400,8,2400,2.5,0,0,0,4,0,2.0
2080,7,1040,2.0,0,0,1040,3,0,1.0
1460,7,980,1.5,0,0,480,3,0,1.0
1820,7,1080,2.25,0,0,740,5,0,1.0
2370,9,2370,2.5,0,0,0,4,0,2.0
1020,7,1020,1.0,0,0,0,3,0,1.0
1040,7,870,1.0,0,0,170,3,0,1.0
2440,9,2440,2.5,0,0,0,4,0,2.0
4790,12,4790,4.75,0,0,0,4,0,2.0
2340,8,2340,2.5,0,0,0,4,0,2.0
1890,7,1290,1.75,0,0,600,4,0,1.0
3200,9,2650,2.25,0,0,550,3,0,2.0
2440,7,1590,1.5,0,0,850,2,0,2.0
2800,8,1660,2.5,0,0,1140,4,0,1.0
2790,10,1930,2.5,1,0,860,4,0,2.0
660,5,660,1.0,0,0,0,2,0,1.0
1820,7,1100,2.0,0,0,720,4,0,1.0
1990,8,1430,2.0,0,2,560,3,0,1.5
2970,7,1510,2.5,0,0,1460,3,0,1.0
2500,7,1500,1.5,0,0,1000,4,0,1.0
1970,7,1670,1.0,0,0,300,4,0,1.5
2510,8,2510,2.25,0,0,0,3,0,2.0
2390,8,1390,1.75,0,2,1000,4,0,1.0
1090,7,1090,1.0,0,0,0,3,0,1.0
3750,9,2750,3.25,0,2,1000,6,0,2.0
1250,7,850,1.0,0,0,400,2,0,1.0
1240,8,1240,2.25,0,0,0,3,0,3.0
960,6,780,1.0,0,0,180,2,0,1.0
1430,7,1430,2.5,0,0,0,3,0,1.5
540,5,540,1.0,0,0,0,2,0,1.0
1490,7,1190,1.75,0,0,300,3,0,1.0
940,5,940,1.0,0,0,0,3,0,1.0
1420,7,1100,1.75,0,0,320,3,0,1.0
2500,9,2500,2.5,1,0,0,4,0,2.0
1420,6,1420,1.5,0,0,0,3,0,1.0
1280,6,1280,1.5,0,0,0,4,0,1.0
2550,7,1810,1.75,0,0,740,5,0,1.0
1900,7,1900,2.5,0,0,0,3,0,2.0
3440,9,3440,3.5,0,0,0,5,0,2.0
1420,8,1420,2.25,0,0,0,2,0,2.0
1020,7,770,1.75,0,0,250,1,0,1.0
2010,7,1230,1.75,0,0,780,3,0,1.0
2580,7,1630,2.25,0,0,950,3,0,1.0
3320,10,3320,3.25,0,0,0,3,0,2.0
1030,6,1030,1.0,0,0,0,2,0,1.0
2500,8,1830,2.5,0,0,670,4,0,1.0
1390,7,1390,2.5,0,0,0,3,0,2.0
1660,8,1660,2.0,0,0,0,2,0,1.0
1700,8,1700,2.5,0,0,0,2,0,2.0
2000,7,1390,1.75,0,0,610,4,0,1.0
2070,8,2070,2.5,0,0,0,3,0,2.0
1730,7,1730,2.5,0,0,0,3,0,2.0
1950,7,1250,2.5,0,0,700,4,0,1.5
1890,7,1490,1.75,0,0,400,4,0,2.0
860,7,860,1.0,0,0,0,2,0,1.0
1010,7,1010,1.0,0,0,0,3,0,1.0
1830,7,1830,1.5,0,0,0,3,0,1.0
2238,8,2238,2.5,0,0,0,3,0,2.0
890,7,770,1.0,0,0,120,2,0,1.0
1820,8,1820,2.0,0,0,0,3,0,1.0
2350,8,1490,3.0,0,0,860,4,0,1.0
4285,10,4285,4.25,1,0,0,4,0,2.0
1950,7,1950,2.5,0,0,0,3,0,2.0
1790,8,1520,1.0,0,0,270,3,0,1.0
1990,7,1990,3.0,0,0,0,4,0,2.0
850,6,850,1.0,0,0,0,1,0,1.0
1840,8,1840,2.25,0,0,0,3,0,2.0
3100,10,3100,2.5,0,0,0,3,0,2.0
4575,10,3905,4.75,1,2,670,4,0,2.5
2150,8,2150,3.0,1,0,0,4,0,2.0
1260,7,1260,1.75,0,0,0,3,0,1.0
1440,5,1440,2.0,0,0,0,4,0,1.0
1820,7,1640,2.0,0,1,180,4,0,1.5
1280,7,1080,1.5,0,0,200,2,0,2.0
2600,8,1340,3.0,0,0,1260,6,0,1.0
2390,7,2390,1.5,0,0,0,3,0,1.0
1930,8,1930,1.75,0,0,0,3,0,1.0
2000,8,2000,2.25,0,0,0,4,0,1.0
2420,8,1860,2.5,0,0,560,3,0,2.0
3200,9,3200,2.5,0,0,0,5,0,2.0
2500,7,2500,2.5,0,0,0,4,0,2.0
920,6,920,0.75,0,2,0,3,1,1.0
1570,7,1570,1.75,0,0,0,3,0,1.0
1700,7,1700,2.5,0,0,0,3,0,2.0
1630,7,1630,2.25,0,0,0,3,0,2.0
1640,7,820,2.0,0,3,820,3,0,1.0
1970,8,1970,2.5,0,0,0,3,0,2.0
790,6,790,1.0,0,0,0,2,0,1.0
1650,7,1130,1.5,0,0,520,3,0,1.0
3430,9,3430,2.5,1,0,0,4,0,2.0
1290,7,1290,1.0,0,0,0,3,0,1.0
1830,7,1830,1.75,0,0,0,3,0,1.5
2410,9,2410,3.0,0,0,0,3,0,2.0
5840,12,4570,4.5,0,0,1270,5,0,2.0
2160,7,2160,1.75,0,0,0,3,0,1.0
2620,7,1550,2.25,0,0,1070,4,0,1.0
1950,8,1950,1.75,0,0,0,3,0,1.0
1900,8,1430,3.5,0,0,470,3,0,2.0
1200,7,1200,1.0,0,0,0,2,0,1.0
3930,12,3930,3.5,0,0,0,4,0,2.0
1820,7,1640,1.5,0,0,180,3,0,1.5
3030,8,3030,3.25,0,0,0,4,0,2.0
2860,8,2860,2.5,0,0,0,4,0,2.0
1430,7,1130,1.5,0,0,300,2,0,1.0
2990,9,2990,2.5,0,0,0,4,0,2.0
1390,7,1390,1.75,0,0,0,3,0,1.0
1680,8,1680,2.5,0,0,0,3,0,3.0
910,5,910,1.0,0,0,0,3,0,1.5
2020,7,1160,2.0,0,0,860,4,0,1.5
1500,7,1210,2.25,0,0,290,3,0,1.0
2760,8,1600,2.5,0,0,1160,5,0,1.0
2070,7,1160,1.0,0,0,910,4,0,1.0
1310,6,1310,2.0,0,0,0,2,0,2.0
4700,11,4700,4.0,1,0,0,5,0,2.0
3670,10,3670,2.5,0,0,0,4,0,2.0
1850,8,1210,2.5,0,0,640,3,0,1.0
1970,8,1540,1.75,0,0,430,4,0,1.0
1840,7,1090,1.75,0,0,750,4,0,1.0
2230,8,1630,2.25,1,0,600,3,0,1.0
1470,8,1470,3.25,0,0,0,3,0,3.0
1790,8,1790,1.75,0,0,0,4,0,1.0
1900,7,1900,1.75,0,0,0,3,0,1.0
1640,8,1200,1.75,0,0,440,3,0,1.0
2610,8,2610,2.5,0,0,0,4,0,2.0
810,6,810,1.0,0,0,0,2,0,1.0
1550,7,1550,1.5,0,0,0,3,0,1.0
1320,7,1320,1.75,0,0,0,3,0,1.0
1970,7,1270,1.75,0,0,700,3,0,1.0
1450,7,1450,2.5,0,0,0,3,0,2.0
1770,7,1770,2.5,0,0,0,4,0,2.0
6370,12,6370,3.5,0,0,0,4,0,2.0
1420,9,1280,2.5,0,0,140,3,0,2.0
960,7,960,1.0,0,0,0,2,0,1.0
1730,7,1010,1.5,0,0,720,4,0,1.0
2120,7,2120,2.5,0,0,0,4,0,2.0
1460,8,1460,3.0,0,0,0,3,0,3.0
1670,8,1220,2.25,0,0,450,3,0,2.0
1940,7,1440,1.5,0,0,500,3,0,1.0
1270,7,1270,1.0,0,0,0,2,0,1.5
1480,7,1480,1.0,0,0,0,3,0,1.0
2500,7,2500,1.0,0,0,0,4,0,1.5
1440,7,970,2.0,0,0,470,3,0,1.0
1400,6,1400,1.75,0,0,0,4,0,1.5
3400,9,3400,2.5,0,0,0,4,0,2.0
2700,9,2700,2.75,0,0,0,4,0,2.0
4590,10,4590,4.0,1,0,0,5,0,2.0
2080,7,1040,1.0,0,0,1040,2,0,1.0
1280,8,1080,2.25,0,0,200,3,0,2.0
920,6,920,1.0,0,0,0,3,0,1.0
2930,8,1560,2.25,0,0,1370,4,0,1.0
2340,8,2340,2.5,0,0,0,3,0,2.0
4720,9,3960,4.0,0,0,760,5,0,2.0
3330,9,2470,3.75,0,2,860,5,0,2.0
3480,9,1870,3.75,1,4,1610,4,0,1.0
2300,8,1430,2.0,1,0,870,3,0,1.0
2110,9,2110,2.5,0,3,0,3,0,2.0
1990,8,1850,1.75,1,0,140,4,0,1.0
3030,7,2100,2.0,0,1,930,3,0,1.0
2330,9,2330,2.5,0,0,0,4,0,2.0
1580,7,1050,1.5,0,0,530,3,0,1.0
1440,7,1440,2.0,0,0,0,3,0,1.0
5600,10,3440,3.25,0,0,2160,5,0,2.0
2290,9,2290,2.5,0,0,0,4,0,2.0
1370,7,1370,2.0,0,0,0,3,0,1.0
810,6,810,1.0,0,0,0,2,0,1.0
1095,7,1095,1.0,0,0,0,2,0,1.5
1160,7,1160,1.5,0,0,0,2,0,2.0
2830,10,2830,2.5,0,0,0,3,0,3.0
1290,7,1290,1.75,0,0,0,3,0,1.0
1670,7,1670,2.0,1,1,0,3,0,1.0
2440,7,1990,3.5,0,0,450,3,0,2.0
1340,8,1340,1.75,0,0,0,2,0,3.0
1620,7,1620,2.0,0,0,0,4,0,2.0
2470,9,1570,2.75,0,3,900,4,0,1.0
1450,7,1450,2.25,0,0,0,3,0,2.0
2970,9,2970,2.5,0,0,0,3,0,2.0
2120,8,2120,1.5,0,0,0,3,0,1.5
1890,7,1890,1.5,0,0,0,4,0,1.0
3950,10,3950,3.5,0,0,0,4,0,2.0
1660,7,1660,2.0,0,0,0,3,0,1.0
2800,9,2800,2.5,0,0,0,4,0,2.0
1850,8,1850,2.75,0,0,0,3,0,2.0
880,7,880,1.0,0,0,0,2,0,1.0
1950,7,1650,1.5,0,1,300,4,0,1.5
1770,7,1770,2.25,0,0,0,4,0,1.0
2180,8,2180,2.5,0,2,0,4,0,2.0
2120,8,1280,2.5,0,0,840,4,0,1.0
1120,5,1120,1.0,0,2,0,2,0,1.0
2870,9,2870,2.5,0,0,0,4,0,2.0
3830,9,3830,3.5,0,0,0,6,0,2.0
1620,7,1620,1.0,0,0,0,4,0,1.5
2260,9,2260,2.0,0,0,0,2,0,1.0
2030,8,1400,2.75,0,0,630,3,0,1.0
3080,9,3080,2.75,0,3,0,4,0,2.0
2660,8,2660,2.5,0,0,0,3,0,1.0
1700,8,1460,1.0,0,0,240,2,0,1.5
1470,7,1470,2.5,0,0,0,3,0,2.0
1120,7,1120,1.5,0,0,0,3,0,1.0
4300,8,3220,3.25,0,0,1080,5,0,2.0
1340,7,1340,1.75,0,0,0,3,0,1.0
1070,8,1070,1.5,0,0,0,2,0,3.0
1990,7,1990,2.75,0,0,0,5,0,1.5
2290,8,2290,3.0,0,0,0,4,0,2.0
2060,7,2060,2.5,0,0,0,3,0,2.0
2830,8,2830,2.5,0,0,0,4,0,2.0
2480,7,1390,1.75,1,0,1090,4,0,1.0
1820,7,1220,1.75,0,0,600,3,0,1.0
3570,9,3570,2.5,0,0,0,4,0,2.0
1400,7,1400,2.0,0,0,0,4,0,1.5
1820,6,1820,1.0,0,0,0,4,0,1.5
860,6,860,1.0,0,0,0,3,0,1.0
1400,6,1400,1.0,0,0,0,2,0,1.5
1440,7,1440,1.75,0,0,0,3,0,1.0
2040,8,2040,2.5,0,0,0,4,0,1.5
1850,7,1850,1.5,0,0,0,3,0,1.0
2590,8,1970,1.75,0,0,620,3,0,1.0
1810,8,1380,2.5,0,0,430,3,0,3.0
2780,7,2780,2.5,0,0,0,4,0,2.0
600,6,600,1.0,0,0,0,1,0,1.0
7000,12,3500,3.25,0,4,3500,4,1,1.0
2547,9,2547,2.5,0,0,0,4,0,2.0
3660,10,3360,3.25,1,0,300,4,0,2.5
1630,7,1230,2.25,0,2,400,3,0,1.0
1250,7,750,1.75,0,0,500,3,0,1.0
2070,7,1420,1.75,0,0,650,3,0,1.0
3720,10,3720,4.0,0,0,0,5,0,2.0
670,6,670,1.0,0,0,0,2,0,1.0
1860,8,1020,1.75,0,2,840,2,0,1.0
2800,9,2800,2.5,0,0,0,4,0,2.0
2470,8,2470,2.25,0,0,0,4,0,2.0
1610,7,1610,2.0,0,0,0,4,0,1.0
1530,6,910,1.75,0,0,620,4,0,1.0
4390,9,2930,4.0,0,0,1460,5,0,2.0
4500,11,2630,4.25,0,3,1870,4,0,2.0
1360,7,1360,2.0,0,0,0,3,0,1.0
940,6,940,1.0,0,0,0,3,0,1.0
1990,8,1990,2.5,0,0,0,3,0,2.0
2130,8,1500,1.75,0,0,630,2,0,1.0
2070,7,1330,2.75,0,0,740,3,0,2.0
2620,8,2620,2.5,0,0,0,4,0,2.0
1120,7,1120,1.0,0,0,0,1,0,1.0
1620,7,1620,1.5,0,0,0,4,0,1.0
1610,6,900,1.0,0,0,710,3,0,1.0
2420,8,1380,1.75,0,0,1040,3,0,1.0
1430,9,1130,2.75,0,0,300,3,0,2.0
3560,10,3560,2.5,0,0,0,4,0,2.0
1150,7,1150,1.0,0,0,0,4,0,1.5
1020,7,1020,1.0,0,0,0,2,0,1.0
1570,7,1300,1.75,0,1,270,3,0,1.0
1550,7,1150,2.0,0,0,400,3,0,1.0
1700,8,1260,1.75,0,1,440,2,0,1.0
2370,8,2370,2.25,0,0,0,3,0,2.0
1600,8,1600,3.25,0,0,0,3,0,3.0
2130,8,1240,2.25,0,2,890,5,0,1.0
2010,7,1110,1.5,0,0,900,3,0,1.0
1440,6,1440,0.75,0,0,0,4,0,1.0
1780,9,1780,2.5,0,0,0,4,0,2.0
1770,7,1770,2.5,0,0,0,3,0,2.0
2410,7,1600,2.5,0,0,810,5,0,1.0
2210,8,1820,3.25,0,0,390,3,0,2.0
2150,8,2150,2.5,0,0,0,4,0,2.0
2690,7,1420,1.75,1,0,1270,5,0,1.0
2760,10,2000,2.5,0,3,760,3,0,2.0
2830,9,2830,2.5,0,0,0,3,0,2.0
970,7,970,2.0,0,0,0,2,0,1.0
1440,7,1440,2.5,0,0,0,3,0,2.0
1690,7,1690,2.5,0,0,0,3,0,2.0
1390,7,1390,1.5,0,0,0,3,0,2.0
1930,7,1420,2.5,0,0,510,3,0,1.0
2640,7,1770,2.25,1,0,870,5,0,1.0
3080,8,1740,2.0,0,0,1340,3,0,1.0
1340,7,1340,1.5,0,0,0,2,0,1.5
1450,7,1190,1.0,0,0,260,3,0,1.0
1480,7,860,2.0,0,0,620,3,0,1.0
3180,7,1690,3.5,0,3,1490,5,0,1.0
1810,7,1810,2.0,0,0,0,3,0,1.0
1160,7,1160,1.0,0,0,0,3,0,1.0
1240,7,1240,1.0,0,0,0,3,0,1.0
2070,7,1250,1.75,0,0,820,4,0,1.0
2620,8,2620,2.5,0,0,0,3,0,2.0
1190,6,1190,1.0,0,0,0,4,0,1.5
820,7,820,1.0,0,0,0,2,0,1.0
1450,7,1450,2.0,0,0,0,3,0,1.0
2490,9,2490,2.5,0,0,0,4,0,2.0
1080,6,1080,1.0,0,0,0,2,0,1.0
880,6,880,1.0,0,0,0,2,0,1.0
2680,8,2680,2.5,0,0,0,4,0,2.0
3020,7,3020,1.0,0,0,0,5,0,2.0
1630,7,980,1.75,0,0,650,4,0,1.0
2840,6,2720,2.0,0,0,120,6,0,1.5
1780,8,1780,2.25,0,2,0,3,0,2.0
1710,6,1710,1.75,0,0,0,4,0,1.5
2910,7,2010,2.75,0,2,900,3,0,2.0
1380,7,1190,1.0,0,0,190,4,0,1.0
1720,8,1720,2.5,0,0,0,4,0,2.0
1950,8,1950,2.5,0,0,0,4,0,2.0
1845,8,1845,3.0,0,2,0,3,0,2.0
770,6,770,1.0,0,0,0,2,0,1.0
1510,7,1510,1.5,0,2,0,3,0,1.0
3420,11,3420,2.5,0,0,0,4,0,2.0
2110,7,1530,2.5,0,0,580,4,0,1.0
1740,7,1270,1.75,0,0,470,4,0,1.0
2720,9,2720,2.75,0,0,0,4,0,2.0
1390,8,1165,2.25,0,0,225,2,0,2.0
2052,8,2052,2.5,0,0,0,4,0,2.0
2990,9,2990,2.5,0,0,0,4,0,2.0
2630,8,2630,2.5,0,0,0,5,0,2.0
1990,9,1780,2.5,0,0,210,2,0,3.0
2440,7,1540,2.25,0,0,900,4,0,1.0
3220,9,2180,2.5,0,2,1040,4,0,2.0
670,6,670,1.0,0,0,0,2,0,1.0
1400,7,1400,1.0,0,0,0,3,0,1.5
1100,7,900,1.0,0,0,200,2,0,1.0
1670,8,1670,2.5,0,0,0,3,0,2.0
2440,8,1340,1.75,0,0,1100,4,0,1.0
1830,7,1830,2.5,0,0,0,3,0,2.5
1800,8,1800,2.25,0,0,0,4,0,1.0
2242,8,2242,2.5,0,0,0,3,0,2.0
1020,7,850,1.0,0,0,170,3,0,1.0
3430,10,2830,3.5,0,0,600,5,0,2.0
4850,10,4850,4.5,0,0,0,5,0,2.0
2120,9,2120,2.5,0,0,0,4,0,2.0
3180,11,3180,3.0,0,0,0,4,0,2.0
2250,9,2250,2.75,0,0,0,4,0,2.0
2000,7,1200,1.75,0,2,800,5,0,1.0
1720,8,1720,1.75,0,0,0,4,0,1.0
3520,10,3520,2.5,0,0,0,4,0,2.0
2160,7,1430,2.5,0,1,730,3,0,1.0
1160,7,740,1.0,0,0,420,2,0,1.0
3030,9,2360,2.75,0,3,670,4,0,1.5
2740,8,1370,2.75,1,0,1370,5,0,1.0
1260,6,1260,1.0,0,0,0,3,0,1.0
760,6,760,1.0,0,0,0,2,0,1.0
2530,8,2530,2.5,0,0,0,3,0,2.0
1320,8,990,2.5,0,0,330,2,0,2.0
4560,9,2490,3.25,1,0,2070,5,0,1.0
2380,8,2380,2.5,0,0,0,2,0,1.0
800,6,800,1.0,0,0,0,2,0,1.0
3450,9,3450,2.5,0,0,0,4,0,2.0
1092,6,1092,1.0,0,0,0,3,0,1.5
3430,11,3430,2.75,0,0,0,4,0,2.0
1610,9,1080,2.5,0,2,530,3,0,2.0
800,6,800,1.0,0,0,0,2,0,1.0
1570,8,1570,1.0,0,0,0,3,0,1.5
2610,7,1630,2.75,1,0,980,3,0,1.0
980,7,980,1.0,0,0,0,2,0,1.0
1470,7,1470,1.5,0,0,0,4,0,1.0
1570,8,1570,3.0,0,0,0,2,0,3.0
1590,7,1090,1.75,0,2,500,3,0,1.0
1210,8,1020,1.5,0,0,190,2,0,2.0
1910,7,1460,1.75,0,0,450,4,0,1.0
1790,7,840,2.0,0,2,950,4,0,1.0
1150,6,1150,1.0,0,0,0,3,0,1.0
1720,8,1720,2.0,1,0,0,3,0,2.0
1650,7,1650,2.0,0,0,0,3,0,1.5
3560,8,2760,3.25,0,0,800,6,0,1.5
3150,9,3150,2.5,0,0,0,4,0,2.0
2870,9,1440,1.75,0,4,1430,5,0,1.0
3890,10,3890,2.5,0,2,0,5,0,2.0
2860,8,1430,3.0,1,0,1430,6,0,1.0
800,6,800,1.0,0,0,0,2,0,1.0
1400,7,900,1.0,0,0,500,2,0,1.0
2620,9,2620,1.75,0,0,0,4,0,1.5
2020,9,2020,2.5,0,0,0,3,0,1.0
2540,9,2540,2.5,0,0,0,4,0,2.0
3850,10,3850,3.0,1,1,0,3,0,2.0
1700,7,1120,1.0,0,0,580,3,0,1.0
2927,10,2927,2.5,0,0,0,4,0,2.0
1420,7,1180,1.0,0,0,240,2,0,1.0
2130,7,1230,2.5,0,0,900,4,0,1.0
960,7,960,1.0,0,0,0,3,0,1.0
940,6,940,1.0,0,0,0,3,0,1.0
2650,8,1830,2.5,0,0,820,3,0,2.0
1430,7,950,1.0,0,0,480,3,0,1.0
1700,7,1700,2.5,0,0,0,3,0,2.0
1460,6,1460,1.0,0,0,0,5,0,2.0
2520,8,1660,2.75,1,0,860,5,0,1.0
2100,7,2100,2.25,0,0,0,3,0,2.0
1350,8,1350,2.0,0,0,0,2,0,1.0
1510,8,1420,1.75,0,0,90,2,0,3.0
1820,7,1820,2.5,0,0,0,4,0,2.0
1970,7,1970,2.5,0,0,0,3,0,2.0
1240,7,1000,2.0,0,0,240,3,0,1.0
1970,8,1970,2.5,0,0,0,4,0,2.0
1420,7,940,1.5,0,0,480,4,0,1.0
1030,7,1030,1.0,0,0,0,3,0,1.0
920,6,920,1.0,0,0,0,2,0,1.0
590,5,590,1.0,0,0,0,2,0,1.5
790,6,790,1.0,0,0,0,2,0,1.0
5180,10,5180,3.25,0,0,0,4,0,2.0
1360,8,1050,2.5,1,0,310,2,0,2.0
1020,7,1020,0.75,0,0,0,2,0,2.0
1660,7,1660,1.75,0,0,0,3,0,1.5
2590,9,2590,2.5,0,0,0,4,0,2.0
970,6,970,1.0,0,0,0,3,0,1.0
1760,7,1060,2.0,0,0,700,3,0,1.0
1690,7,1020,1.0,0,0,670,3,0,1.0
1680,6,840,1.75,0,2,840,3,0,1.0
1350,6,1350,1.0,0,0,0,3,0,1.0
1540,8,1390,2.5,0,0,150,3,0,3.0
1310,7,870,2.0,0,0,440,3,0,1.0
3350,9,2020,3.0,1,0,1330,4,0,1.0
1050,7,1050,1.0,0,0,0,3,0,1.0
2000,6,1860,2.0,0,0,140,4,0,2.0
1070,7,1070,1.75,0,0,0,2,0,1.5
4340,10,2850,3.5,0,0,1490,4,0,2.0
1780,7,980,2.0,0,0,800,3,0,1.0
4060,8,2810,1.75,0,0,1250,3,0,1.0
1900,7,1400,2.25,0,0,500,4,0,1.0
4060,10,4060,4.5,0,0,0,4,0,2.0
4270,10,3210,3.75,1,0,1060,5,0,2.0
1660,7,1660,1.75,0,0,0,3,0,1.0
1660,9,1400,2.5,0,2,260,3,0,2.0
2720,8,1510,1.75,0,0,1210,4,0,1.0
1160,7,880,2.75,0,0,280,3,0,2.0
2520,7,1320,1.75,0,0,1200,4,0,1.0
1850,8,1150,1.75,0,0,700,3,0,1.0
1050,7,850,1.0,0,0,200,2,0,1.0
2110,8,1290,2.5,0,0,820,4,0,1.0
1060,6,1060,1.0,0,0,0,3,0,1.0
1620,8,1620,2.25,0,0,0,3,0,2.0
990,6,990,1.0,0,0,0,2,0,1.0
1990,9,1990,1.75,0,3,0,3,0,2.0
2030,7,2030,1.75,0,2,0,3,0,2.0
1660,7,1660,1.75,0,0,0,3,0,1.0
1420,7,1420,1.75,0,0,0,4,0,2.0
2910,8,2910,2.5,0,2,0,4,0,2.0
4160,8,2760,3.25,0,0,1400,4,0,2.0
1450,7,1450,1.0,0,0,0,2,0,1.5
1370,8,1370,2.0,0,0,0,2,0,3.0
2170,7,1690,2.5,0,0,480,3,0,1.0
1260,7,1260,1.75,0,0,0,3,0,1.0
1900,8,1900,2.5,0,0,0,3,0,2.0
2920,8,1710,2.25,0,0,1210,3,0,1.0
1750,7,1180,1.0,0,0,570,2,0,1.0
850,5,850,1.0,0,0,0,2,0,1.0
2310,8,2310,1.75,0,0,0,3,0,2.0
1810,9,1810,2.0,0,0,0,3,0,2.0
1370,7,1370,1.5,0,0,0,3,0,1.0
2280,7,2280,2.5,0,0,0,4,0,2.0
1960,7,1960,1.75,0,0,0,5,0,1.0
2470,11,1910,2.5,1,0,560,2,0,3.0
1930,7,1930,2.5,0,0,0,4,0,2.0
960,7,960,1.0,0,0,0,2,0,1.0
2250,7,1250,3.0,0,0,1000,4,0,1.0
2510,9,2510,2.5,0,0,0,4,0,2.0
1220,7,1220,2.0,0,0,0,4,0,2.0
3040,9,3040,2.5,0,0,0,4,0,2.0
5520,9,3570,3.0,1,3,1950,4,0,2.0
3190,8,2630,3.5,0,3,560,3,0,1.0
1460,7,1460,1.0,0,0,0,3,0,1.0
2390,8,2390,2.5,0,0,0,3,0,2.0
2500,8,1810,3.5,0,0,690,4,0,2.0
970,7,970,1.0,0,0,0,2,0,1.0
2990,8,2990,3.0,0,0,0,3,0,2.0
960,7,960,1.0,0,0,0,3,0,1.0
2620,7,1520,2.5,0,0,1100,4,0,1.0
1980,8,1980,2.5,0,0,0,4,0,2.0
1710,8,1710,2.5,0,0,0,3,0,2.0
3300,10,3300,3.25,1,0,0,4,0,2.0
1100,6,960,1.0,0,0,140,3,0,1.0
1610,7,1230,2.0,0,0,380,4,0,1.0
2730,8,2730,2.5,0,0,0,3,0,2.0
5840,11,4410,4.0,1,1,1430,5,0,2.0
2020,7,1520,1.0,0,0,500,3,0,1.5
1580,8,1580,1.0,0,0,0,3,0,2.0
2270,7,2270,2.25,0,0,0,4,0,2.0
1700,7,1300,2.25,1,0,400,3,0,1.0
930,7,930,1.0,0,0,0,2,0,1.0
1000,6,1000,1.75,0,0,0,3,0,1.0
710,7,710,1.0,0,0,0,2,0,2.0
1220,8,1220,2.0,0,0,0,3,0,3.0
1570,8,1570,1.75,0,0,0,3,0,1.5
1780,7,920,1.75,0,0,860,3,0,1.0
1680,8,1380,2.5,0,0,300,3,0,2.0
1740,7,1740,1.0,0,0,0,4,0,1.5
1360,7,1360,1.0,0,0,0,2,0,1.0
2590,9,2590,2.5,0,0,0,3,0,1.0
1940,7,1940,2.0,0,0,0,3,0,1.0
2620,8,2120,1.75,0,4,500,2,1,2.0
2240,8,1740,2.25,0,0,500,4,0,1.0
2910,7,1530,1.75,0,0,1380,3,0,1.0
1530,7,1530,1.75,0,0,0,4,0,1.5
1100,7,1100,1.75,0,0,0,3,0,1.0
1040,6,1040,1.0,0,0,0,2,0,1.0
5330,11,3950,4.0,1,0,1380,6,0,2.0
1710,8,1410,1.5,0,0,300,3,0,1.5
7480,11,5080,6.75,0,2,2400,7,0,2.0
2040,8,2040,2.5,0,0,0,3,0,2.0
2240,7,1120,1.5,0,0,1120,3,0,1.0
2310,8,1410,1.75,0,0,900,3,0,1.0
2240,7,2240,2.5,0,0,0,4,0,2.0
1570,8,1570,2.0,0,0,0,3,0,1.0
1960,8,1960,2.25,0,0,0,3,0,2.0
2140,7,2140,1.75,0,0,0,4,0,1.0
1270,8,1270,2.0,0,0,0,3,0,3.0
1770,7,1770,1.0,0,0,0,4,0,1.5
3360,11,3360,2.5,0,0,0,4,0,2.0
3240,8,1620,2.75,0,2,1620,3,0,1.0
1540,7,1540,2.0,0,0,0,5,0,1.0
2100,8,2100,2.5,0,0,0,3,0,2.0
2080,8,2080,2.5,0,0,0,4,0,2.0
1410,7,1410,2.0,0,0,0,3,0,1.0
1280,7,1280,1.5,0,0,0,3,0,1.0
2260,9,2260,2.0,0,0,0,3,0,1.0
2270,9,2270,2.5,0,0,0,3,0,2.0
2290,7,2290,1.5,0,0,0,3,0,1.0
1660,7,1260,1.0,0,0,400,4,0,1.5
1740,7,1240,2.25,0,0,500,3,0,1.0
1420,7,1420,1.5,0,0,0,3,0,1.0
2310,7,2310,2.75,0,0,0,4,0,2.0
1530,6,1530,1.75,0,0,0,3,0,1.0
3190,9,3190,2.5,0,0,0,4,0,2.0
3030,11,3030,2.5,0,0,0,4,0,2.0
2540,7,2540,2.5,0,0,0,3,0,2.0
1400,8,1400,2.0,0,0,0,3,0,2.0
2070,7,1370,1.5,0,0,700,2,0,2.0
3030,10,3030,2.5,1,0,0,4,0,1.5
1900,9,1250,3.25,0,0,650,4,0,2.0
1230,7,1230,1.75,0,0,0,3,0,1.0
3200,8,2360,3.0,0,0,840,3,0,1.0
900,6,900,1.0,0,0,0,2,0,1.0
1350,8,1350,1.75,0,0,0,2,0,1.0
2420,8,1530,2.5,0,0,890,3,0,1.0
2940,8,1940,2.75,0,2,1000,4,0,1.5
1970,7,1320,2.75,0,0,650,5,0,1.0
2210,7,2210,2.5,0,0,0,4,0,2.0
6840,11,4350,1.75,0,4,2490,2,1,2.5
2330,9,1410,2.5,0,4,920,3,0,2.0
3620,8,1820,1.75,0,0,1800,4,0,1.0
1990,8,1400,1.75,0,0,590,4,0,1.0
1340,8,1340,1.0,0,0,0,5,0,1.5
760,7,760,1.0,0,0,0,1,0,1.0
840,7,840,1.0,0,0,0,2,0,1.0
3370,10,3370,2.75,0,0,0,4,0,2.0
2100,7,2100,2.75,0,0,0,3,0,1.0
1260,6,1080,0.75,1,2,180,2,0,1.5
4350,9,2200,3.25,0,0,2150,4,0,1.0
2320,8,2320,2.25,0,0,0,3,0,2.0
1890,7,1270,3.0,0,0,620,4,0,1.0
1970,7,1500,2.25,0,0,470,4,0,1.5
1120,6,1120,1.0,0,0,0,3,0,1.0
860,7,860,1.0,0,0,0,2,0,1.0
1820,7,1090,2.5,0,0,730,1,0,2.0
1840,7,1840,1.0,0,0,0,5,0,1.5
3100,8,3100,2.75,0,0,0,4,0,2.0
1630,7,1100,1.75,0,0,530,3,0,1.0
2400,8,2400,1.75,0,0,0,4,0,1.0
1530,7,970,1.0,0,0,560,3,0,1.0
2720,8,2720,2.75,0,0,0,4,0,2.0
1350,8,1120,2.75,0,0,230,2,0,2.0
1340,5,700,1.75,0,0,640,2,0,1.0
1330,7,1330,2.0,0,0,0,3,0,1.0
2150,8,2150,2.0,0,0,0,3,0,1.0
6390,10,4560,4.75,1,0,1830,5,0,2.0
1570,6,1570,1.5,0,0,0,3,0,1.5
1020,7,720,2.5,0,0,300,3,0,2.0
1820,7,910,2.0,0,0,910,3,0,1.0
1190,6,1190,1.0,0,0,0,3,0,1.5
1890,7,1890,2.5,0,0,0,3,0,2.0
1890,8,1890,1.75,1,0,0,3,0,1.0
2930,9,2930,2.5,0,0,0,3,0,1.5
1520,7,1520,1.0,0,0,0,3,0,1.5
1970,8,1270,2.0,0,3,700,3,0,2.0
2210,9,2210,2.5,0,0,0,4,0,2.0
2850,7,1850,2.75,0,0,1000,6,0,1.0
1170,7,1170,1.5,0,0,0,3,0,1.0
2690,9,2120,3.75,0,3,570,4,0,2.0
3220,10,3220,2.5,1,0,0,4,0,1.0
2500,7,1320,2.5,0,0,1180,4,0,1.0
1380,7,1380,2.0,0,0,0,2,0,1.0
3260,9,3260,2.5,0,0,0,3,0,2.0
2330,9,2330,2.5,0,0,0,3,0,2.0
2120,7,1200,1.75,0,0,920,5,0,1.0
1920,8,1600,2.5,0,0,320,3,0,2.5
3420,10,3420,3.5,0,0,0,4,0,2.0
2390,8,2090,2.25,0,0,300,3,0,2.0
1300,7,1300,2.0,1,0,0,3,0,1.0
1980,7,1480,1.75,0,0,500,3,0,1.0
1620,7,1110,1.75,1,0,510,3,0,1.0
1940,7,1140,2.0,0,0,800,3,0,1.0
1920,8,1920,2.5,0,0,0,3,0,1.0
3240,9,2060,2.5,0,0,1180,4,0,2.0
3520,8,2760,3.5,0,2,760,3,0,2.0
4150,10,4150,3.25,0,0,0,5,0,2.0
3280,10,3280,2.5,0,0,0,4,0,2.0
1540,7,1160,1.75,0,0,380,3,0,1.0
1410,6,1410,1.0,0,0,0,5,0,1.5
3010,9,3010,2.5,0,0,0,4,0,2.0
2140,7,2020,2.0,0,0,120,5,0,1.5
870,7,870,1.5,0,0,0,2,0,1.0
4280,11,4280,3.5,1,0,0,4,0,2.0
1080,6,720,1.0,0,0,360,2,0,1.0
1650,7,1650,1.75,0,0,0,3,0,1.0
1640,7,1640,2.5,0,0,0,4,0,2.0
930,7,670,2.0,0,0,260,2,0,1.0
2210,7,1460,2.75,0,1,750,3,0,1.0
1710,7,1180,1.5,1,0,530,3,0,1.0
2460,8,2460,2.5,0,0,0,3,0,2.0
1080,7,1080,1.0,0,0,0,3,0,1.0
3310,8,2160,2.5,0,0,1150,3,0,1.0
1850,7,1200,2.5,0,0,650,4,0,1.0
3420,10,2330,3.25,0,0,1090,4,0,2.0
1830,7,1830,2.5,0,0,0,2,0,2.0
4600,10,4600,2.5,0,0,0,4,0,2.0
1590,8,1590,2.5,0,0,0,3,0,2.5
1601,7,1536,2.5,0,0,65,3,0,3.0
1800,7,1680,2.75,0,0,120,5,0,2.0
2140,7,2140,2.75,0,0,0,4,0,2.0
2010,8,1390,2.5,0,0,620,3,0,2.0
2140,7,2140,2.25,0,0,0,3,0,2.0
4140,10,2190,3.25,0,4,1950,5,0,1.0
2798,9,2798,2.5,0,0,0,4,0,2.0
1720,8,1720,2.5,0,0,0,3,0,2.0
1750,8,1750,2.0,0,0,0,3,0,1.0
1660,7,1660,1.0,0,0,0,4,0,1.5
1610,7,1190,2.0,0,0,420,4,0,1.0
1490,9,1490,2.0,0,0,0,2,0,3.0
2390,9,2390,2.5,0,0,0,3,0,2.0
3100,8,2400,3.0,0,0,700,4,0,2.0
850,6,750,1.0,0,0,100,2,0,1.0
940,6,940,1.0,0,0,0,3,0,1.0
2390,7,2390,3.5,0,0,0,5,0,2.0
1370,7,1370,1.5,1,0,0,3,0,1.0
2496,9,2496,2.5,0,0,0,4,0,2.0
2650,10,2650,2.75,0,0,0,4,0,2.0
1910,7,1910,2.25,0,0,0,3,0,1.0
1590,7,1590,1.0,0,0,0,3,0,1.0
4000,9,4000,3.5,0,0,0,5,0,2.0
2470,7,1420,2.5,0,0,1050,4,0,1.0
1500,6,1500,1.0,0,0,0,2,0,1.0
3595,9,3595,2.75,0,0,0,5,0,2.0
1210,8,1210,2.25,0,0,0,3,0,3.0
4060,9,2030,3.0,0,0,2030,4,0,1.0
2420,9,2420,2.5,0,0,0,3,0,2.0
2420,8,2420,2.5,0,0,0,4,0,2.0
800,7,800,1.0,0,0,0,2,0,1.0
2190,9,2190,1.75,1,0,0,3,0,1.0
1440,8,1160,2.5,0,0,280,3,0,2.0
2350,7,2350,2.0,0,0,0,3,0,1.5
2050,8,2050,2.25,0,0,0,4,0,2.0
2400,7,1200,1.5,0,0,1200,3,0,1.0
1420,9,1340,2.0,0,0,80,3,0,2.5
3430,11,3430,3.5,0,0,0,4,0,2.0
1350,7,1350,2.0,0,0,0,3,0,1.0
1100,7,1100,1.0,0,0,0,3,0,1.0
2130,8,2130,2.25,1,2,0,4,0,2.0
5440,12,5440,3.5,0,0,0,4,0,2.0
2750,7,1730,3.0,0,0,1020,5,0,1.0
1400,8,700,1.75,0,0,700,3,0,1.0
2400,6,2400,2.0,0,0,0,4,0,2.0
1250,7,1250,1.0,0,0,0,3,0,1.0
1710,7,1710,2.5,0,0,0,3,0,2.0
2590,8,1590,1.75,0,0,1000,3,0,1.0
2820,7,1860,3.0,0,0,960,4,0,1.5
1310,7,1310,1.75,0,0,0,3,0,1.0
1620,7,980,1.75,0,0,640,3,0,1.0
2540,8,1630,1.5,0,0,910,3,0,2.0
3570,7,3570,2.5,0,0,0,4,0,2.0
1100,6,1100,1.0,0,0,0,3,0,1.0
1008,6,1008,1.5,0,4,0,2,1,1.0
1550,7,1350,1.5,0,0,200,4,0,1.5
1710,7,1710,1.0,0,0,0,3,0,1.0
1490,8,1490,1.75,1,0,0,3,0,2.0
1060,7,1060,1.0,1,0,0,3,0,1.0
2330,8,1320,1.75,0,0,1010,3,0,1.0
2050,9,2050,2.5,0,0,0,3,0,2.0
2010,7,1890,1.5,0,0,120,4,0,1.5
2390,9,1390,2.75,0,0,1000,4,0,1.0
1650,8,1650,2.25,0,0,0,4,0,1.0
2950,9,2550,2.5,1,2,400,4,0,1.0
1530,7,1530,2.25,0,0,0,3,0,2.0
4700,10,3420,3.25,0,0,1280,4,0,2.0
890,7,890,1.0,0,0,0,2,0,1.0
1710,7,1710,2.0,0,2,0,3,0,1.0
1480,8,1180,3.25,0,0,300,3,0,2.0
1610,7,1610,1.75,0,0,0,3,0,1.0
2620,9,2620,2.5,0,0,0,3,0,2.0
3280,9,2040,2.75,1,2,1240,3,0,1.0
2360,7,2360,2.0,0,0,0,3,0,2.0
2350,8,2350,2.5,0,0,0,4,0,2.0
3200,8,1600,2.5,0,3,1600,5,0,1.0
880,7,880,1.0,0,0,0,2,0,1.0
3550,8,3550,2.25,0,0,0,5,0,2.0
2180,6,1730,2.0,0,0,450,4,0,1.0
4730,10,4270,3.5,1,0,460,4,0,1.5
1240,7,1240,1.0,0,0,0,2,0,1.0
1740,7,1740,2.5,0,0,0,3,0,2.0
4490,9,3390,3.5,0,0,1100,4,0,2.0
4500,12,4500,4.0,0,0,0,4,0,2.0
1630,7,1160,1.75,0,0,470,4,0,1.0
2260,8,2260,2.75,0,0,0,4,0,2.0
2040,6,1260,1.75,0,0,780,4,0,1.5
1490,7,1220,2.25,0,0,270,3,0,2.0
1720,7,1720,1.5,0,0,0,3,0,1.5
940,6,940,1.0,0,0,0,3,0,1.0
1210,7,610,1.5,0,0,600,3,0,1.0
1650,7,1650,2.5,0,0,0,3,0,2.0
2510,9,2510,2.5,0,2,0,3,0,2.0
2350,9,2350,2.0,0,0,0,3,0,1.5
3350,9,2550,3.5,0,0,800,4,0,2.0
1230,7,1230,1.75,0,0,0,3,0,1.0
2830,8,2830,2.5,0,0,0,4,0,2.0
2300,8,1150,2.0,0,0,1150,3,0,1.0
1700,7,1150,2.25,0,0,550,3,0,2.0
2700,9,2700,2.5,0,0,0,4,0,2.0
1470,8,1470,2.25,0,0,0,3,0,2.0
1560,7,1560,2.25,0,0,0,3,0,1.0
880,6,880,1.0,0,0,0,3,0,1.0
2600,7,1350,2.75,0,0,1250,3,0,1.0
4660,10,3040,3.5,0,4,1620,3,0,2.0
1760,8,1760,2.25,0,0,0,3,0,2.0
1380,8,1050,2.5,0,0,330,2,0,2.0
2160,7,1390,2.5,0,0,770,4,0,1.0
2860,8,2380,2.75,0,0,480,5,0,2.5
2600,10,2600,2.5,0,0,0,4,0,2.0
1250,6,1250,1.0,0,0,0,3,0,1.0
1080,8,1080,1.0,0,0,0,2,0,1.0
1940,7,1140,1.5,0,0,800,4,0,1.0
2080,7,2080,2.5,0,0,0,3,0,2.0
3030,9,3030,2.5,0,0,0,4,0,2.0
3920,9,3920,3.5,0,0,0,4,0,2.0
2430,7,1430,2.0,0,0,1000,4,0,1.0
1860,8,1860,2.0,0,2,0,3,0,2.0
1120,7,1120,1.0,0,3,0,2,0,1.0
1210,7,1210,1.5,0,0,0,3,0,1.0
2150,7,1200,1.75,0,0,950,3,0,1.0
1220,7,890,1.0,0,0,330,4,0,1.0
2570,7,1320,2.5,0,0,1250,3,0,1.0
1250,7,1250,1.0,0,0,0,3,0,1.0
3710,10,3710,3.25,0,0,0,3,0,2.0
1730,7,1730,1.75,0,0,0,4,0,2.0
1990,8,1990,2.25,0,0,0,4,0,2.0
3580,8,3580,3.25,0,0,0,4,0,1.0
1420,8,940,2.25,0,0,480,3,0,2.0
5844,11,5844,3.5,0,1,0,4,0,2.0
1990,9,1990,2.5,0,0,0,3,0,2.0
770,7,770,1.0,0,0,0,2,0,1.0
1350,7,1350,2.0,0,0,0,3,0,1.0
2270,8,1330,1.75,0,0,940,3,0,1.0
2130,9,2130,2.5,0,0,0,3,0,3.0
2130,7,1600,2.25,0,0,530,4,0,1.0
1030,7,1030,1.5,0,0,0,2,0,2.0
2000,7,1400,2.25,0,0,600,3,0,1.0
2750,9,2750,2.5,0,0,0,4,0,2.0
1010,6,1010,1.0,0,0,0,3,0,1.0
1400,7,1400,1.0,0,0,0,3,0,1.0
2420,9,2420,3.0,0,0,0,4,0,1.0
1670,8,1670,1.75,0,0,0,3,0,1.0
700,6,700,1.0,0,0,0,2,0,1.0
2880,9,1940,2.5,0,0,940,4,0,2.0
2550,9,2550,2.5,0,0,0,3,0,2.0
1830,7,1250,2.25,0,0,580,3,0,1.0
3360,8,3360,2.5,0,0,0,3,0,1.0
1520,8,1220,1.75,0,0,300,3,0,1.0
3330,10,1740,2.75,0,0,1590,5,0,1.0
1680,7,1130,1.5,0,0,550,4,0,1.0
1050,6,950,1.75,0,0,100,3,0,1.5
760,6,760,1.0,0,0,0,2,0,1.0
1650,7,1130,2.5,0,0,520,3,0,1.0
4920,10,3820,4.5,0,3,1100,4,0,2.0
2730,8,2730,2.75,0,0,0,4,0,2.0
1230,7,1230,2.0,0,0,0,3,0,1.0
2640,8,1620,2.75,0,0,1020,4,0,1.0
1190,7,1190,1.75,0,0,0,3,0,1.0
5110,11,5110,4.0,1,0,0,6,0,2.5
1460,7,1460,2.5,0,0,0,3,0,2.0
1790,8,1790,2.25,1,0,0,3,0,2.0
3140,10,2310,3.25,0,0,830,4,0,2.0
880,7,880,1.0,0,0,0,2,0,1.0
2120,9,2120,2.5,1,0,0,3,0,2.0
1990,8,1990,2.5,0,0,0,4,0,2.0
2220,8,1280,2.25,0,0,940,3,0,1.0
1540,7,1260,1.75,0,0,280,4,0,1.0
1370,7,1370,2.0,0,0,0,4,0,1.5
2680,9,2680,2.5,0,0,0,3,0,2.0
4240,10,4240,2.5,0,0,0,4,0,2.0
2020,8,1220,3.0,0,0,800,4,0,1.0
1800,7,1170,1.75,0,0,630,3,0,1.0
1440,7,1440,1.5,0,0,0,2,0,2.0
2230,7,1230,1.0,0,0,1000,3,0,1.0
1160,7,1160,1.75,0,0,0,3,0,1.0
2440,7,1420,2.5,0,0,1020,3,0,1.0
4250,9,4250,3.25,1,0,0,4,0,2.0
1200,7,1200,1.5,0,0,0,3,0,1.0
2600,6,1400,2.0,0,0,1200,5,0,1.5
1600,8,1600,1.75,0,0,0,2,0,1.5
1730,8,1180,2.25,0,0,550,3,0,1.0
2000,7,1000,1.75,0,3,1000,4,0,1.0
3080,7,1610,2.75,0,2,1470,3,0,1.0
1340,8,1340,2.0,0,0,0,2,0,1.0
1240,7,1240,1.5,0,0,0,3,0,1.0
1300,7,1300,1.75,0,0,0,3,0,1.0
1720,7,1720,2.0,0,0,0,3,0,1.0
2190,8,2190,1.75,0,0,0,3,0,2.0
3040,8,2240,3.5,0,1,800,4,0,2.0
770,6,770,1.0,0,0,0,2,0,1.0
1280,7,1080,1.5,0,0,200,4,0,1.5
1220,6,1220,1.5,0,0,0,4,0,1.0
2480,7,1470,2.0,0,0,1010,4,0,1.5
2050,9,2050,1.75,0,0,0,3,0,1.5
2360,7,1180,2.5,0,0,1180,5,0,1.0
1850,8,1850,2.25,0,0,0,3,0,2.0
3510,10,3510,3.0,1,0,0,6,0,2.5
1370,7,1370,1.75,0,0,0,3,0,1.0
1769,9,1769,2.5,0,0,0,3,0,2.0
2620,9,1720,2.75,0,2,900,4,0,1.5
1930,7,1930,1.5,0,0,0,5,0,2.0
990,6,990,1.0,0,0,0,2,0,1.0
2340,9,2340,2.5,0,0,0,4,0,2.0
1580,8,1580,2.5,0,0,0,3,0,2.0
830,6,830,1.0,0,0,0,2,0,1.0
740,7,740,1.0,0,0,0,2,0,1.0
2440,8,2440,2.5,0,0,0,4,0,2.0
3150,8,2370,1.75,0,1,780,3,0,1.0
4980,9,3080,4.25,0,3,1900,4,0,2.0
820,8,760,1.0,0,0,60,1,0,1.0
2230,7,1320,1.75,0,0,910,4,0,1.0
2070,8,2070,2.5,0,0,0,3,0,2.0
2495,8,2495,2.5,0,0,0,3,0,2.0
1970,7,1320,2.5,0,0,650,3,0,1.0
1810,7,1400,1.75,0,0,410,3,0,1.0
1110,7,1110,2.0,0,0,0,3,0,1.0
1340,7,1340,1.0,0,2,0,2,0,1.0
1200,7,1200,1.5,0,0,0,3,0,1.0
1920,8,1920,2.5,0,0,0,3,0,2.0
1610,7,1610,2.5,0,0,0,3,0,3.0
2000,7,1480,2.0,0,0,520,4,0,1.5
1850,6,1760,1.75,0,0,90,5,0,1.5
2090,8,1240,2.75,0,0,850,4,0,1.0
1270,7,1270,1.75,0,0,0,3,0,1.5
1150,7,1150,2.0,0,0,0,3,0,1.0
2080,7,1040,2.5,0,0,1040,4,0,1.0
2350,8,1390,2.25,0,0,960,3,0,1.0
2070,7,1140,1.5,0,0,930,3,0,1.0
1980,7,1480,1.75,0,0,500,4,0,1.0
3150,9,3150,2.75,0,0,0,4,0,2.0
2030,7,1080,1.5,0,0,950,3,0,1.0
1900,7,1200,1.0,0,0,700,4,0,1.0
2410,10,2410,2.5,0,0,0,3,0,2.0
1050,7,1050,1.0,0,0,0,2,0,1.0
770,7,770,1.5,0,0,0,2,0,2.0
1360,6,1360,2.0,0,0,0,2,0,2.0
2840,9,1870,2.5,0,3,970,3,0,1.0
1560,7,1560,2.0,0,0,0,3,0,1.0
1650,7,1150,1.75,0,4,500,3,0,1.5
3770,11,3770,2.5,1,2,0,4,0,2.0
1520,7,1160,2.5,0,0,360,3,0,1.0
1360,7,1360,1.5,0,0,0,4,0,1.0
1770,7,1770,2.5,0,0,0,3,0,2.0
1710,7,1710,1.5,0,0,0,5,0,1.5
1600,7,1600,1.5,0,0,0,3,0,1.0
2190,8,2190,2.75,0,0,0,4,0,2.0
1530,7,1530,2.0,0,0,0,3,0,1.0
2000,7,1300,1.75,0,2,700,4,0,1.0
1860,8,1860,1.5,0,0,0,4,0,1.5
1220,7,1220,1.0,0,0,0,4,0,1.0
1740,7,1060,1.5,0,0,680,3,0,1.0
1680,7,1680,2.5,0,0,0,3,0,2.0
2100,8,1620,2.25,0,2,480,3,0,1.0
2150,7,1460,1.75,0,0,690,5,0,1.0
2160,7,1430,2.75,0,0,730,4,0,1.0
1980,7,1980,2.5,0,0,0,4,0,2.0
2750,9,1720,2.75,0,3,1030,4,0,1.0
2040,8,2040,2.5,0,2,0,3,0,2.0
980,7,980,1.5,0,0,0,3,0,1.0
1080,5,1080,1.0,0,0,0,3,0,1.0
2430,8,1590,2.5,0,0,840,4,0,1.0
930,8,630,2.25,0,0,300,2,0,2.0
1940,9,1940,2.5,1,0,0,4,0,2.0
770,7,770,1.0,0,0,0,2,0,1.0
1870,7,1870,1.75,0,0,0,3,0,1.0
2620,7,2620,2.25,0,0,0,7,0,2.0
1571,8,1571,3.0,0,0,0,3,0,3.0
1950,8,1950,2.5,0,0,0,3,0,2.0
1930,7,1930,1.75,0,0,0,5,0,2.0
1010,6,1010,1.0,0,0,0,3,0,1.0
1430,7,1430,1.0,0,0,0,3,0,1.0
3060,8,1810,2.5,0,0,1250,4,0,1.0
1490,8,1250,1.75,0,1,240,3,0,1.0
910,5,910,1.0,0,0,0,2,0,1.0
1060,6,1060,1.0,0,0,0,2,0,1.0
3290,7,1790,1.75,0,0,1500,5,0,1.0
1340,8,1340,2.0,0,0,0,2,0,1.5
1370,7,1150,1.0,0,0,220,3,0,1.0
1430,7,1430,1.75,0,0,0,3,0,1.0
1950,7,1950,2.0,0,0,0,4,0,1.0
2440,9,2440,2.5,0,0,0,4,0,2.0
1200,6,600,1.0,0,0,600,2,0,1.0
1770,8,1770,1.75,0,0,0,3,0,1.0
6410,12,5610,4.25,0,2,800,4,0,2.5
2793,9,2793,3.0,0,0,0,4,0,2.0
2740,9,2740,2.5,0,0,0,4,0,2.0
4495,9,3580,3.5,0,0,915,5,0,2.0
820,5,820,1.0,0,0,0,2,0,1.0
2000,8,2000,2.0,0,0,0,4,0,2.0
2140,7,2140,1.0,0,0,0,3,0,1.0
1720,7,860,2.0,0,0,860,4,0,1.0
1800,8,1800,2.25,0,0,0,3,0,1.0
2640,8,2640,3.5,0,2,0,4,0,2.0
1790,8,1790,2.25,0,0,0,3,0,2.0
4290,11,2690,3.25,1,3,1600,4,0,1.0
2090,9,2090,2.5,0,0,0,4,0,2.0
2210,9,2210,2.5,0,3,0,3,0,2.0
2300,9,2300,2.75,1,0,0,6,0,1.5
970,7,970,1.0,0,0,0,3,0,1.0
1030,7,1030,1.0,0,0,0,3,0,1.0
1570,7,1400,1.5,0,2,170,4,0,1.0
1600,7,1600,2.5,0,0,0,3,0,2.0
1940,8,1560,1.75,0,0,380,4,0,1.0
1520,8,1520,1.75,0,0,0,3,0,1.0
2340,8,1340,3.0,0,0,1000,4,0,1.0
1650,7,1270,2.5,0,0,380,3,0,2.0
3040,8,1520,2.0,0,0,1520,3,0,1.0
2640,8,1550,2.5,0,0,1090,3,0,1.0
790,6,790,1.0,0,0,0,2,0,1.0
2780,10,2780,1.75,0,0,0,4,0,2.0
1210,8,1000,3.25,0,0,210,3,0,2.0
1445,7,1300,2.25,0,0,145,3,0,2.0
1940,7,1940,3.0,0,0,0,4,0,1.0
2280,7,2280,2.5,0,0,0,4,0,2.0
1380,7,1380,2.0,0,0,0,3,0,1.0
1810,8,1230,1.25,0,4,580,1,1,1.5
1900,8,1900,1.75,0,0,0,3,0,1.0
3830,10,3830,3.25,0,0,0,4,0,2.0
960,7,960,1.75,0,0,0,2,0,1.0
2080,7,1040,1.75,0,0,1040,4,0,1.0
1520,7,1140,1.75,0,0,380,3,0,1.0
1660,7,1660,2.5,0,0,0,2,0,2.0
1980,7,1680,1.5,0,0,300,3,0,1.0
1220,7,1220,1.0,0,0,0,2,0,1.0
1890,8,1460,2.5,0,0,430,3,0,1.0
3630,10,3630,2.5,0,0,0,4,0,2.0
1380,7,1180,1.75,0,0,200,5,0,1.0
710,6,710,1.0,0,0,0,2,0,1.0
2710,6,2710,2.0,0,0,0,3,0,2.0
1290,7,1290,3.0,0,0,0,3,0,3.0
1810,7,950,1.5,0,0,860,3,0,1.0
1960,8,1330,2.25,0,0,630,4,0,1.0
1670,7,1670,2.25,0,0,0,3,0,1.0
1940,8,1440,2.5,0,2,500,3,0,1.0
2760,8,1730,2.5,0,0,1030,5,0,1.5
2810,7,1510,2.75,0,0,1300,2,0,1.0
3810,8,3810,3.75,0,0,0,6,0,2.0
1930,7,1330,2.5,0,0,600,3,0,1.0
2170,7,1370,1.75,0,2,800,4,0,1.0
910,7,910,1.0,0,0,0,3,0,1.0
2260,7,2260,2.25,0,0,0,4,0,2.0
1580,7,1040,2.0,0,0,540,4,0,1.0
2440,8,2440,2.5,0,0,0,3,0,2.0
2690,7,2690,2.5,0,0,0,4,0,2.0
1870,8,1870,2.0,0,0,0,2,0,1.0
1390,8,1390,2.25,0,0,0,3,0,3.0
2570,8,1370,3.0,0,0,1200,4,0,1.0
1730,7,1730,2.0,1,0,0,3,0,1.0
2628,9,2628,2.5,0,0,0,4,0,2.0
2970,10,2970,2.5,1,0,0,4,0,2.0
1740,7,1020,1.5,0,0,720,4,0,1.0
950,6,950,1.0,0,0,0,3,0,1.0
1590,7,910,2.0,0,0,680,2,0,1.0
920,6,920,1.0,0,0,0,1,0,1.5
1440,6,1130,1.75,0,0,310,2,0,1.0
2150,9,2150,2.5,0,0,0,4,0,2.0
760,6,760,1.0,0,0,0,2,0,1.0
1660,8,1660,1.75,1,0,0,3,0,2.0
3700,8,1850,1.75,0,0,1850,5,0,1.0
1030,8,1030,1.0,0,0,0,2,0,1.0
1930,8,1930,2.5,0,0,0,3,0,2.0
3470,9,2480,2.5,0,0,990,4,0,2.0
2280,7,1470,1.75,0,0,810,4,0,1.5
920,7,920,1.0,0,0,0,3,0,1.0
1630,7,1630,1.0,0,0,0,4,0,1.5
1120,6,1120,1.0,0,0,0,2,0,1.0
1480,7,1050,1.0,0,0,430,2,0,1.0
1310,6,910,1.0,0,0,400,4,0,1.0
1600,8,1600,2.5,0,0,0,3,0,2.0
720,6,720,1.0,0,0,0,2,0,1.0
1358,7,1358,2.25,0,0,0,3,0,3.0
1620,8,1620,2.5,0,0,0,3,0,2.0
1860,7,1860,2.5,0,0,0,3,0,2.0
1540,7,890,2.0,0,0,650,3,0,1.0
4290,11,4290,3.0,1,0,0,5,0,2.0
1560,7,1560,1.0,0,1,0,2,0,1.5
1760,7,1000,1.0,0,2,760,2,0,1.0
2520,7,2520,3.0,0,0,0,4,0,2.0
2340,8,2340,2.5,0,0,0,4,0,2.0
750,7,750,1.0,0,0,0,2,0,1.0
1270,7,1270,1.5,0,0,0,3,0,2.0
3530,10,3530,3.25,1,0,0,4,0,2.0
990,7,870,1.0,0,0,120,2,0,1.0
3370,9,3370,2.5,1,0,0,5,0,2.0
2710,9,2710,2.5,0,2,0,4,0,2.0
1680,7,1680,2.25,0,0,0,3,0,2.0
1440,8,1290,1.75,0,0,150,4,0,1.5
2560,10,2560,2.25,0,0,0,3,0,2.0
2540,7,1270,1.75,0,0,1270,4,0,1.0
1995,7,1995,1.75,0,0,0,3,0,2.0
2630,9,1810,2.25,0,0,820,4,0,2.0
2440,7,1220,1.75,0,0,1220,3,0,1.0
2310,8,1730,3.25,0,0,580,3,0,2.0
2770,8,1870,3.75,0,0,900,6,0,1.0
1850,7,1850,2.5,0,0,0,4,0,2.0
930,7,930,1.0,0,0,0,3,0,1.0
1440,5,1440,2.0,0,0,0,4,0,1.0
1780,9,1390,2.25,0,0,390,3,0,1.5
1770,8,1770,1.75,0,0,0,4,0,1.0
1240,7,1240,1.75,0,0,0,3,0,1.0
1510,7,1510,1.0,0,0,0,4,0,1.5
2230,8,1630,1.75,0,0,600,3,0,1.0
2340,6,1200,1.75,0,0,1140,3,0,1.0
2210,8,1170,2.75,0,0,1040,4,0,1.0
2230,8,1260,1.5,0,1,970,3,0,1.0
2790,9,2790,2.5,0,0,0,4,0,2.0
2000,7,1450,1.75,0,0,550,4,0,1.5
4020,10,4020,2.5,0,0,0,4,0,2.0
2280,8,1880,2.5,0,0,400,3,0,2.0
2960,8,1570,1.75,0,0,1390,4,0,1.0
2000,7,1220,2.5,0,0,780,4,0,1.5
1440,7,1440,2.0,0,0,0,3,0,2.0
3610,9,2370,3.5,0,0,1240,4,0,2.0
1400,7,1120,2.5,0,0,280,3,0,1.0
3290,9,3290,3.25,0,0,0,5,0,2.0
3270,10,3270,3.25,0,0,0,4,0,2.0
2810,9,2810,2.5,1,0,0,4,0,2.0
3060,8,2860,2.5,0,0,200,4,0,2.0
7620,11,5980,3.75,1,3,1640,4,0,2.0
2195,7,1060,2.0,0,0,1135,4,0,1.0
1810,7,1240,1.75,0,0,570,3,0,1.0
1250,7,1250,1.75,0,0,0,3,0,1.0
1180,7,1180,2.0,0,0,0,3,0,1.0
2350,9,1560,3.0,1,0,790,3,0,2.0
3020,7,3020,2.5,0,0,0,4,0,2.0
2040,8,2040,2.5,0,0,0,3,0,2.0
1530,7,1530,2.5,0,0,0,4,0,1.5
1610,7,1100,1.75,0,0,510,3,0,1.0
1540,9,1540,2.25,0,0,0,2,0,3.0
1180,7,940,1.0,0,0,240,2,0,1.0
2160,8,1830,2.5,0,0,330,3,0,3.0
1100,6,1100,1.0,0,0,0,2,0,1.5
3010,8,3010,2.75,0,0,0,4,0,2.0
1800,8,1800,2.5,0,0,0,3,0,2.0
1640,7,1130,1.75,0,0,510,3,0,1.0
1370,7,1370,2.5,0,0,0,3,0,2.0
3200,9,2660,2.5,0,0,540,3,0,1.0
1630,7,1630,2.25,0,0,0,3,0,2.0
2130,9,2130,1.75,1,0,0,3,0,1.0
3202,9,3202,2.5,0,0,0,4,0,2.0
2050,7,1050,1.75,0,2,1000,3,0,1.0
1020,8,1020,1.5,0,0,0,2,0,3.0
1940,8,1940,2.5,0,0,0,3,0,2.0
1340,7,1340,1.75,1,0,0,3,0,1.0
840,8,840,1.0,0,0,0,2,0,3.0
1640,7,1640,1.0,0,0,0,3,0,1.0
700,6,700,1.0,0,0,0,2,0,1.0
2310,8,1560,3.5,0,0,750,5,0,2.0
1530,8,1530,2.5,0,0,0,3,0,2.0
1790,7,1790,1.0,0,0,0,3,0,1.0
1440,8,1440,1.75,0,0,0,3,0,1.0
1780,7,1780,2.25,0,0,0,4,0,2.0
1750,9,1750,2.5,0,0,0,3,0,3.0
1230,7,1230,1.25,0,0,0,3,0,1.5
3260,9,3260,2.5,0,0,0,4,0,2.0
1310,7,1310,2.0,0,0,0,4,0,1.0
2420,8,2420,2.5,0,0,0,4,0,2.0
1750,7,1610,2.5,0,0,140,4,0,1.0
2620,9,2620,2.5,0,0,0,3,0,2.0
1810,7,1810,2.25,0,0,0,4,0,2.0
2210,8,2210,2.25,0,0,0,4,0,2.0
2100,7,1140,2.5,0,0,960,5,0,1.0
1300,7,1300,1.75,0,0,0,3,0,1.0
920,7,920,1.0,0,0,0,2,0,1.0
2140,7,1470,2.25,0,0,670,4,0,1.0
1840,7,1840,2.25,0,0,0,3,0,2.0
2500,7,1250,1.75,0,0,1250,3,0,1.0
1430,8,1430,2.5,0,0,0,3,0,3.0
2910,8,2910,2.5,0,0,0,4,0,2.0
1290,6,1290,1.5,0,0,0,3,0,1.0
1150,6,1150,1.0,0,0,0,3,0,1.0
2020,6,2020,3.0,0,0,0,4,0,1.5
1570,6,1570,1.5,0,0,0,4,0,1.0
1130,6,1130,1.0,0,0,0,2,0,1.0
3236,10,3236,2.5,0,0,0,4,0,2.0
1530,7,990,2.0,1,0,540,3,0,1.0
1340,7,1340,1.75,0,0,0,3,0,1.0
3920,11,3920,3.25,0,3,0,4,0,3.0
3010,9,3010,2.75,0,3,0,4,0,2.0
1330,7,1330,1.75,0,3,0,3,0,1.0
1870,8,1870,2.5,0,0,0,3,0,2.0
962,7,962,1.0,0,0,0,2,0,2.0
1790,6,1790,1.0,0,0,0,3,0,1.0
2490,9,1780,3.5,0,0,710,4,0,2.0
1610,7,1020,2.75,1,0,590,4,0,1.0
2850,7,1900,2.25,0,2,950,3,0,2.0
2240,8,1700,3.0,0,0,540,5,0,1.0
900,5,900,1.0,0,0,0,2,0,1.0
2110,8,2110,2.25,0,0,0,3,0,2.0
2190,9,2190,1.75,0,2,0,4,0,1.0
1400,7,1400,1.5,0,0,0,2,0,1.0
1510,7,1510,1.75,0,0,0,3,0,1.0
2220,7,1270,1.5,0,0,950,4,0,1.0
3210,10,3210,2.5,0,0,0,4,0,2.0
1940,8,1940,2.5,0,0,0,4,0,2.0
1310,7,1310,2.0,0,0,0,3,0,1.0
2100,8,1300,2.5,0,0,800,4,0,1.0
1840,9,1840,2.5,0,0,0,3,0,1.0
2250,7,2250,2.0,0,0,0,3,0,1.0
1620,9,1430,1.75,0,0,190,3,0,2.5
2594,8,2594,2.5,0,0,0,3,0,2.0
2290,6,2290,1.75,0,0,0,4,0,1.0
1140,7,900,1.0,0,0,240,4,0,1.0
2610,8,1310,2.75,0,0,1300,4,0,1.0
2500,9,2500,2.5,0,0,0,4,0,1.0
950,6,950,1.0,0,0,0,2,0,1.0
2790,8,2790,3.0,0,0,0,6,0,2.5
2150,6,2150,1.0,0,0,0,3,0,1.0
1210,7,1210,1.75,0,0,0,2,0,1.0
2550,9,2550,1.0,0,0,0,5,0,2.5
2420,8,2420,2.5,0,0,0,3,0,2.0
2700,9,2700,2.5,0,0,0,3,0,2.0
3620,10,3620,2.75,0,0,0,4,0,2.0
2700,7,1540,2.0,0,0,1160,5,0,1.0
1470,10,1470,1.75,0,0,0,3,0,3.0
1340,7,1340,1.0,0,0,0,3,0,1.0
4770,11,3070,3.25,0,0,1700,5,0,1.0
3410,10,2450,2.5,0,3,960,3,0,1.0
4140,10,4140,3.25,1,0,0,4,0,2.0
1720,7,1140,1.75,0,0,580,3,0,1.0
1840,8,1840,1.75,0,0,0,3,0,1.0
1870,8,1870,2.25,0,0,0,3,0,3.0
1420,7,1420,1.75,0,0,0,3,0,1.0
2190,7,1040,2.25,0,0,1150,4,0,1.0
840,6,840,1.0,0,0,0,3,0,1.0
1920,8,1920,2.5,0,0,0,3,0,2.0
1470,7,1470,2.0,0,0,0,4,0,1.0
430,4,430,0.75,0,0,0,1,0,1.0
2060,7,1300,2.25,0,0,760,4,0,1.0
2600,8,1700,1.75,1,0,900,3,0,1.0
3610,10,3610,2.5,0,0,0,4,0,2.0
2360,8,2360,2.5,0,0,0,3,0,2.0
2880,8,2480,2.25,0,0,400,4,0,2.0
2070,8,1490,2.25,0,2,580,3,0,2.0
2980,8,2980,2.5,1,0,0,3,0,2.0
1260,8,1260,2.5,0,0,0,2,0,3.0
2600,7,2600,2.5,0,0,0,3,0,2.0
1670,7,1070,1.75,0,2,600,4,0,1.0
3130,9,2530,2.5,0,4,600,4,0,1.0
1870,7,1870,2.25,0,0,0,3,0,2.0
1570,7,1570,1.75,0,0,0,3,0,1.0
910,5,910,1.0,0,0,0,2,0,1.0
2580,9,2580,2.5,0,0,0,3,0,2.0
920,7,920,1.0,0,0,0,2,0,1.0
1510,8,1510,1.0,0,0,0,3,0,2.0
2020,7,1010,2.75,0,0,1010,4,0,1.0
1280,7,1280,1.75,0,0,0,3,0,1.5
1270,7,1270,2.0,0,0,0,3,0,1.0
3420,9,3030,3.25,0,2,390,4,0,2.0
1180,6,1180,2.0,0,0,0,2,0,2.0
2270,7,1290,2.25,0,0,980,4,0,1.0
2370,7,1380,3.0,0,0,990,4,0,1.0
1850,7,1300,2.25,0,0,550,3,0,1.0
970,7,790,1.0,0,0,180,2,0,2.0
2800,9,2800,3.5,0,0,0,5,0,2.5
2570,8,2570,2.25,0,0,0,4,0,2.0
2070,8,1420,2.5,0,0,650,3,0,1.0
1140,7,1140,2.0,0,0,0,2,0,1.0
1650,7,760,2.0,0,0,890,4,0,1.0
2350,9,2350,2.5,1,0,0,5,0,2.0
1210,7,1210,1.75,0,0,0,3,0,1.0
1310,6,1310,1.75,0,0,0,2,0,1.0
2230,8,1510,2.25,1,0,720,3,0,1.0
1330,5,1330,2.0,0,0,0,4,0,1.0
1260,7,1260,2.0,0,0,0,3,0,1.0
1300,8,1010,2.25,0,0,290,2,0,2.0
1520,7,1160,1.5,0,0,360,3,0,1.0
3720,10,3720,2.5,0,0,0,4,0,2.0
1810,7,1810,1.5,0,0,0,3,0,1.5
2190,7,1490,3.0,0,0,700,5,0,2.0
4760,9,3390,2.25,1,0,1370,4,0,2.5
1790,8,1790,1.75,0,2,0,3,0,1.0
3420,9,2520,3.5,0,0,900,5,0,2.0
1940,6,1220,1.5,0,0,720,5,0,1.5
920,6,920,1.0,0,0,0,3,0,1.0
2270,8,2270,1.75,0,0,0,3,0,1.0
3140,9,1760,3.25,0,0,1380,3,0,1.0
1760,7,1290,2.0,0,2,470,3,0,2.0
3040,7,3040,2.5,0,0,0,4,0,2.0
2590,8,2590,2.5,0,0,0,5,0,2.0
2190,7,1610,2.75,1,0,580,3,0,1.0
2780,7,2780,2.0,0,0,0,6,0,2.5
1960,7,1960,4.25,0,0,0,4,0,2.0
2050,8,2050,2.5,0,0,0,4,0,2.0
1550,7,1550,1.0,0,0,0,3,0,1.0
2820,10,2820,3.5,1,0,0,4,0,2.0
1580,8,1180,2.0,0,2,400,3,0,2.5
2420,7,2420,1.0,1,0,0,4,0,2.0
3290,9,3290,2.5,0,0,0,4,0,2.0
1160,7,1160,1.5,0,0,0,2,0,2.0
1670,8,1670,1.75,0,0,0,4,0,1.0
1650,7,1060,1.75,0,0,590,3,0,1.0
3420,10,1750,2.5,1,0,1670,3,0,1.0
2000,8,2000,3.5,0,0,0,4,0,3.0
1880,7,1880,2.25,0,0,0,4,0,2.0
1630,7,1630,2.5,0,0,0,3,0,1.0
2240,8,2240,2.0,0,0,0,3,0,1.0
1760,7,1760,2.0,0,0,0,3,0,1.0
2979,11,2979,2.5,1,2,0,3,0,2.0
3220,8,3220,2.25,0,0,0,4,0,2.0
750,6,750,1.0,0,0,0,2,0,1.0
2030,7,1110,2.0,0,0,920,5,0,1.0
2220,7,1330,2.25,0,0,890,3,0,1.0
1320,7,1320,1.5,0,0,0,3,0,2.0
1990,7,1990,1.5,0,0,0,5,0,1.0
3320,8,2000,2.25,0,0,1320,4,0,2.0
1270,8,1270,2.5,0,0,0,3,0,3.0
3160,9,3160,2.5,0,0,0,4,0,2.0
1190,7,1190,1.0,0,0,0,2,0,1.5
3180,8,3020,2.75,0,0,160,4,0,2.0
2020,9,1760,2.25,0,3,260,4,0,1.0
3140,9,3140,2.25,0,0,0,4,0,2.0
1960,8,1960,2.5,0,0,0,4,0,2.0
1880,7,940,2.0,0,0,940,5,0,1.0
1220,7,760,1.0,0,0,460,2,0,1.0
700,5,700,1.0,0,0,0,2,0,1.0
1190,7,1190,1.0,0,0,0,3,0,1.0
2550,7,2550,2.5,0,0,0,4,0,2.0
3590,9,3140,3.5,0,2,450,4,0,2.0
2470,8,2470,2.5,0,0,0,3,0,2.0
2900,10,2900,2.5,0,0,0,4,0,2.0
1880,7,1380,1.75,1,0,500,3,0,1.0
1660,8,1660,2.5,0,0,0,3,0,2.0
2267,7,2267,2.5,0,0,0,4,0,2.0
1490,9,1040,2.25,1,0,450,3,0,2.0
2290,7,1980,1.75,0,0,310,5,0,2.0
3150,10,3150,3.75,1,0,0,3,0,2.0
990,6,990,1.0,0,0,0,3,0,1.0
1270,6,880,1.75,0,0,390,3,0,1.0
1820,8,1820,2.0,0,0,0,4,0,1.0
2200,7,1400,2.5,0,0,800,5,0,1.0
1730,6,1730,1.75,0,3,0,3,0,1.0
2460,7,1380,1.75,0,0,1080,5,0,1.0
2160,8,1260,1.75,0,0,900,4,0,1.0
1600,7,1600,1.0,0,0,0,3,0,2.0
780,7,780,1.0,0,0,0,2,0,1.0
1550,7,1550,2.0,0,0,0,3,0,2.0
2190,7,1180,2.0,0,0,1010,4,0,1.0
1320,7,1320,1.0,0,0,0,3,0,1.0
1990,7,1990,2.0,1,0,0,3,0,1.0
2630,9,2630,3.0,0,0,0,4,0,2.0
3090,8,1680,2.5,1,3,1410,4,0,1.0
1490,7,1490,1.5,0,0,0,3,0,1.0
1620,7,860,1.75,0,0,760,4,0,1.0
1560,7,1560,2.25,0,0,0,3,0,2.0
1760,6,1760,1.0,0,0,0,3,0,1.5
2460,7,1620,1.75,0,3,840,4,0,1.5
1790,7,1790,1.75,0,0,0,3,0,1.0
1010,7,1010,1.75,0,0,0,3,0,1.0
1800,9,1800,2.25,0,2,0,2,0,2.0
2650,10,2650,2.5,0,0,0,4,0,2.0
1800,6,900,1.0,0,0,900,2,0,1.0
2180,7,1210,1.75,0,0,970,3,0,1.0
1960,7,980,1.75,0,0,980,3,0,1.0
2390,8,1840,2.5,0,0,550,3,0,1.0
1440,9,960,2.0,0,0,480,2,0,2.0
4030,10,4030,3.75,1,0,0,4,0,2.0
1690,8,1150,2.5,0,0,540,3,0,2.0
2720,8,1790,2.75,0,0,930,4,0,2.0
2708,9,2708,2.5,0,0,0,4,0,2.0
2560,7,2560,2.5,0,0,0,4,0,2.0
1180,7,1180,1.0,0,0,0,4,0,1.5
1350,8,1050,2.25,0,0,300,2,0,2.0
830,7,830,1.5,0,0,0,2,0,2.0
1200,7,1200,1.0,0,2,0,4,0,1.5
1030,7,830,1.5,0,0,200,2,0,1.0
910,5,910,1.5,0,0,0,3,0,1.0
3530,10,3530,2.75,0,0,0,4,0,2.0
1760,7,1760,2.0,0,0,0,3,0,1.0
2990,8,2990,2.75,0,0,0,5,0,2.0
890,6,890,1.0,0,0,0,3,0,1.0
1310,6,1310,1.0,0,0,0,2,0,1.0
2390,10,2390,2.5,0,0,0,4,0,2.0
3240,9,2080,2.25,1,0,1160,4,0,1.0
2260,7,1130,2.0,0,0,1130,3,0,1.0
1330,7,1330,2.0,0,0,0,4,0,1.5
620,6,620,1.0,0,0,0,2,0,1.0
1490,7,1490,3.0,0,1,0,4,0,1.5
2200,7,1120,2.25,0,0,1080,3,0,1.0
3050,8,1650,2.5,1,4,1400,5,0,1.0
2520,9,2520,2.25,0,0,0,5,0,2.0
1980,7,1980,2.0,0,0,0,4,0,2.0
3070,10,2440,2.75,1,0,630,3,0,2.0
1270,7,1270,1.0,0,0,0,3,0,1.0
840,6,840,1.0,0,0,0,2,0,1.0
3160,9,2280,3.25,0,0,880,4,0,2.0
2400,8,2400,2.5,0,0,0,4,0,2.0
4360,10,3360,3.25,0,0,1000,4,0,1.0
3190,8,3190,2.5,0,0,0,5,0,2.0
2400,9,2400,2.5,0,0,0,3,0,1.0
2040,7,1470,1.75,0,0,570,3,0,1.0
1930,7,1930,1.5,0,0,0,4,0,2.0
2160,7,2160,2.25,0,0,0,3,0,2.0
1230,7,1230,1.0,0,0,0,3,0,1.0
1700,7,1700,2.5,0,0,0,4,0,2.0
1890,7,1390,1.75,0,0,500,4,0,1.5
2600,9,2600,2.75,0,0,0,3,0,2.0
1680,7,1680,2.0,0,1,0,3,0,1.0
3410,10,3410,3.5,1,0,0,4,0,2.0
960,6,960,1.0,0,0,0,2,0,1.0
2390,9,1590,2.5,1,0,800,4,0,1.0
1530,7,1200,1.75,0,0,330,3,0,1.0
2000,8,2000,1.5,0,0,0,3,0,1.0
2330,8,2330,2.5,0,3,0,2,0,2.0
2170,7,2170,1.5,0,0,0,4,0,2.0
3260,8,3260,3.5,0,0,0,5,0,2.0
1790,7,1260,1.0,0,0,530,4,0,1.0
1370,7,1370,1.75,0,0,0,3,0,2.0
2800,9,2800,2.5,0,0,0,4,0,2.0
1812,8,1812,2.5,0,0,0,4,0,2.0
2240,8,1910,1.75,0,2,330,3,0,1.5
1710,7,1710,2.25,0,0,0,3,0,2.0
2680,8,2680,3.0,1,2,0,4,0,2.0
2840,8,1600,1.75,0,3,1240,3,0,1.0
1290,7,1290,1.5,0,0,0,3,0,3.0
680,7,680,1.5,0,0,0,2,0,2.0
1220,6,1220,1.0,0,0,0,2,0,1.0
3870,11,3870,2.75,1,0,0,4,0,2.0
1740,7,1740,1.5,0,0,0,3,0,1.0
3180,8,2390,3.5,0,0,790,4,0,2.0
1180,7,1180,1.0,0,0,0,3,0,1.0
2100,7,1340,1.75,0,2,760,3,0,1.0
2140,7,1460,1.75,0,0,680,3,0,1.0
3110,8,3110,2.5,0,0,0,4,0,2.0
1720,8,1720,1.5,0,0,0,3,0,1.5
1550,8,1550,2.25,0,0,0,2,0,2.0
1800,8,1800,2.5,0,0,0,3,0,2.0
1900,8,1900,2.5,0,0,0,3,0,2.0
3280,10,3280,2.5,0,0,0,4,0,2.0
2170,8,1300,2.25,1,0,870,4,0,1.0
1670,7,1300,2.0,0,0,370,3,0,1.0
780,6,780,1.0,0,0,0,3,0,1.0
940,7,940,1.0,0,0,0,3,0,1.5
1390,6,1390,1.0,0,0,0,3,0,1.5
3300,9,2520,4.25,0,2,780,3,0,2.0
1920,8,1920,2.5,0,3,0,3,0,3.0
2434,8,2434,2.5,0,0,0,4,0,2.0
2320,8,2320,2.5,0,0,0,4,0,2.0
1040,7,1040,1.0,0,0,0,2,0,1.0
2040,9,2040,2.5,0,0,0,3,0,2.0
2550,8,2050,4.0,0,2,500,3,0,2.0
1640,7,1640,1.75,0,0,0,3,0,1.0
2060,8,1160,1.75,0,0,900,4,0,1.0
1660,7,1660,2.25,0,0,0,3,0,2.0
1110,7,1110,1.5,0,0,0,3,0,1.0
3674,9,3674,3.25,0,1,0,4,0,2.0
1870,7,1870,2.25,0,0,0,3,0,2.0
2270,8,1340,2.25,0,0,930,4,0,1.0
1160,7,1160,1.0,0,0,0,3,0,1.0
840,7,840,1.0,0,0,0,2,0,1.0
1510,8,1510,3.25,0,0,0,3,0,3.0
1870,8,1870,2.0,0,0,0,4,0,1.0
2660,8,1530,2.0,0,2,1130,3,0,1.0
2600,8,2600,2.5,0,1,0,3,0,2.0
1810,7,1810,2.0,0,0,0,4,0,1.0
2380,7,1850,1.5,0,0,530,3,0,1.0
2530,8,2220,2.0,0,0,310,4,0,1.0
1910,8,1910,1.5,1,0,0,3,0,1.0
1730,5,1730,1.0,0,0,0,4,0,1.5
6200,11,4440,4.75,0,4,1760,5,1,2.0
2520,9,2520,2.25,0,0,0,4,0,2.0
3840,7,2530,3.0,0,0,1310,8,0,1.0
1120,8,1120,2.75,0,0,0,3,0,3.0
1480,7,1480,1.5,0,0,0,3,0,1.0
2980,8,2980,2.5,0,0,0,4,0,2.0
1530,7,1530,1.75,0,0,0,3,0,1.0
1760,7,1080,1.75,0,0,680,4,0,1.0
750,6,750,1.0,0,0,0,2,0,1.0
2570,9,1970,2.0,0,0,600,3,0,1.0
3260,9,2360,2.25,1,0,900,4,0,2.0
2740,9,2740,2.5,0,0,0,3,0,2.0
2734,8,2734,3.5,0,0,0,4,0,2.0
1390,7,1390,1.5,0,0,0,3,0,2.0
2310,8,1790,2.75,1,0,520,4,0,1.0
1670,7,1170,1.0,0,0,500,3,0,1.0
5230,11,4450,3.5,1,0,780,5,0,2.0
1010,7,1010,1.0,0,0,0,2,0,1.0
3130,10,2450,4.5,1,0,680,4,0,3.0
2860,8,2190,2.5,0,0,670,4,0,2.0
1040,6,1040,1.5,0,0,0,2,0,1.0
2420,8,2420,2.25,1,0,0,4,0,2.0
2190,8,2190,2.5,1,0,0,3,0,2.0
1300,7,1300,1.0,0,0,0,3,0,1.0
4285,10,3485,3.5,0,1,800,4,0,2.0
2550,8,1580,2.25,0,0,970,5,0,1.0
2540,9,2540,2.0,0,0,0,3,0,1.0
890,6,890,1.0,0,0,0,3,0,1.0
1320,8,1320,3.0,0,0,0,3,0,3.0
2190,8,1250,2.5,0,0,940,4,0,1.0
2320,8,2320,2.5,0,0,0,4,0,2.0
2100,7,1060,2.0,0,0,1040,4,0,1.0
1710,8,1710,2.5,0,0,0,3,0,2.0
1410,7,1410,1.0,0,0,0,4,0,1.5
2330,9,2330,3.0,0,0,0,3,0,1.0
1500,7,1500,1.5,0,0,0,3,0,1.0
1740,7,1740,1.5,0,0,0,3,0,1.0
1220,7,1220,1.75,0,0,0,3,0,1.0
2580,9,2580,2.0,0,0,0,3,0,1.5
2270,7,1370,1.75,0,0,900,3,0,1.0
2393,8,2393,2.5,0,0,0,3,0,2.0
1550,7,1550,1.75,0,0,0,4,0,1.0
2540,9,2540,2.5,0,0,0,4,0,2.0
2656,9,2656,2.75,0,0,0,4,0,2.0
1820,8,1820,2.25,0,0,0,3,0,2.0
2190,7,1390,1.75,0,2,800,3,0,1.0
2840,8,1960,2.75,0,0,880,4,0,1.5
1540,8,1470,2.5,0,0,70,3,0,3.0
2510,8,1610,2.25,0,0,900,3,0,1.0
1530,7,1530,1.75,0,0,0,3,0,2.0
1720,8,1720,2.5,0,0,0,3,0,2.0
2040,7,2040,2.0,1,1,0,4,0,2.0
1290,7,1050,1.5,0,0,240,2,0,1.0
1220,7,1220,1.0,0,0,0,3,0,1.0
4180,8,2880,3.25,0,0,1300,5,0,2.0
1900,8,1900,2.5,0,0,0,2,0,2.0
2310,7,2310,2.5,0,0,0,4,0,2.0
2090,8,2090,2.25,0,0,0,4,0,2.0
2580,9,2580,2.25,0,0,0,4,0,2.0
2280,8,1380,1.75,0,1,900,5,0,1.0
2190,8,2190,2.25,0,0,0,4,0,2.0
1427,7,1427,2.5,0,0,0,3,0,2.0
1350,7,1180,2.25,0,0,170,2,0,2.0
920,6,920,1.0,0,0,0,3,0,1.0
1140,8,1140,1.75,0,0,0,3,0,2.0
3410,8,3410,2.0,0,0,0,4,0,2.0
2700,9,2700,2.5,0,0,0,3,0,2.0
1830,7,930,1.75,0,0,900,3,0,1.0
1570,7,920,1.75,0,0,650,3,0,1.0
3600,8,2740,3.5,0,0,860,6,0,2.0
2460,9,2460,2.5,0,0,0,3,0,2.0
1930,8,1930,1.5,1,0,0,5,0,1.5
1640,7,950,1.0,0,0,690,4,0,1.0
1600,7,1600,2.0,0,0,0,3,0,1.0
1760,8,1760,2.0,0,0,0,3,0,1.0
2560,7,1890,2.0,0,0,670,4,0,1.0
2200,7,1330,2.5,0,0,870,4,0,1.0
1660,8,1660,2.0,0,3,0,3,0,2.0
1220,7,1060,1.0,0,0,160,3,0,1.0
1590,7,1090,2.25,0,0,500,3,0,1.0
670,6,670,1.0,0,0,0,2,0,1.0
1800,7,1800,1.0,0,0,0,3,0,1.0
2620,8,1520,2.5,0,0,1100,5,0,1.0
2710,10,2710,2.5,0,0,0,4,0,3.0
1000,7,1000,1.0,0,0,0,3,0,1.0
3470,11,3470,2.75,0,4,0,3,1,3.0
1700,8,1700,2.5,0,0,0,3,0,2.0
2320,7,1160,1.75,0,0,1160,5,0,1.0
3000,9,3000,2.5,0,0,0,3,0,2.0
3040,9,3040,2.5,0,0,0,3,0,2.0
1990,9,1990,2.5,0,0,0,3,0,3.0
2100,8,2100,3.5,0,0,0,4,0,2.0
960,6,960,1.0,0,0,0,2,0,1.0
1420,7,1420,1.75,0,0,0,3,0,1.0
800,7,800,1.0,0,0,0,2,0,1.0
1820,9,1820,2.5,0,0,0,3,0,2.0
1430,7,1430,1.0,0,0,0,4,0,1.5
2300,8,1300,2.25,0,0,1000,5,0,1.0
1780,8,1570,2.25,0,0,210,3,0,3.0
2660,7,1380,2.0,0,0,1280,4,0,1.0
4320,11,4320,3.5,1,0,0,5,0,2.0
1830,7,1830,2.5,0,0,0,4,0,2.0
1320,7,1320,2.0,0,0,0,3,0,1.0
2880,9,1660,2.75,1,3,1220,5,0,1.0
2190,7,1190,1.75,0,0,1000,4,0,1.0
1580,6,790,2.0,0,0,790,2,0,1.0
860,6,860,1.0,0,0,0,2,0,1.0
2430,8,2430,2.5,0,0,0,4,0,2.0
5470,11,4590,3.5,0,0,880,5,0,2.0
2270,7,1290,2.75,0,0,980,4,0,1.0
1510,7,1010,1.0,0,0,500,3,0,1.0
1660,7,960,1.75,0,0,700,3,0,1.0
2570,9,2570,2.5,0,0,0,3,0,2.5
1460,7,1460,2.0,0,0,0,3,0,1.0
2750,7,1620,2.25,0,4,1130,3,1,1.0
2130,8,2130,2.0,0,0,0,3,0,1.0
1850,8,1850,1.75,0,0,0,3,0,1.0
1080,7,1080,1.0,0,3,0,2,0,1.0
3280,7,3280,3.0,0,0,0,4,0,2.0
1160,6,1160,1.0,0,4,0,2,1,1.0
1420,8,1420,2.5,0,0,0,3,0,3.0
1160,7,1160,1.0,0,0,0,3,0,1.0
1490,7,1490,1.0,0,0,0,3,0,1.0
2540,8,1540,2.75,0,0,1000,5,0,1.0
550,6,550,1.0,0,0,0,1,0,1.0
2720,9,1870,2.5,1,1,850,4,0,1.0
2632,10,2632,2.0,0,3,0,3,0,2.0
2680,8,2680,2.5,0,0,0,3,0,2.0
2690,10,2690,2.5,0,0,0,3,0,3.0
1990,7,1990,2.25,0,0,0,3,0,2.0
2040,7,2040,1.75,0,0,0,3,0,1.0
2590,8,1980,2.0,0,0,610,3,0,2.0
3610,8,3130,2.75,0,3,480,3,1,1.5
1410,7,960,1.0,1,0,450,3,0,1.0
3100,8,2000,2.75,0,0,1100,4,0,2.0
930,6,930,1.0,0,0,0,2,0,1.0
1870,7,1270,1.75,0,0,600,3,0,1.0
4230,11,4230,3.5,1,0,0,4,0,2.0
990,7,990,1.5,0,0,0,2,0,3.0
2140,7,1190,1.5,0,0,950,4,0,1.0
2690,7,2210,2.75,0,0,480,4,0,2.0
2850,8,1730,2.5,1,0,1120,3,0,1.0
1750,7,1750,2.5,1,0,0,3,0,2.0
4870,12,4870,3.5,1,0,0,4,0,2.0
1840,8,1290,2.25,1,0,550,3,0,1.0
2150,8,1400,1.75,0,0,750,3,0,2.0
3070,8,3070,2.25,0,0,0,4,0,2.0
2980,9,1580,2.25,0,0,1400,5,0,1.0
1690,7,1250,2.25,0,0,440,3,0,1.0
1930,7,1930,2.5,0,0,0,4,0,2.0
1590,7,1090,1.0,0,1,500,3,0,1.0
1650,7,1520,2.5,0,0,130,3,0,2.0
1250,7,960,1.5,0,0,290,4,0,1.0
2470,8,2470,2.75,1,0,0,3,0,2.0
1400,8,1060,2.0,1,0,340,3,0,2.0
1220,7,1220,1.5,0,2,0,2,0,1.0
2020,7,1020,2.0,0,0,1000,3,0,1.0
1850,8,1370,1.75,0,0,480,3,0,1.0
1940,7,1460,2.5,0,0,480,3,0,1.0
2170,8,2170,2.5,0,0,0,3,0,2.0
1160,7,1160,1.75,0,0,0,2,0,2.0
2060,7,1560,2.25,0,0,500,1,0,1.5
2190,7,1370,2.75,0,0,820,5,0,1.0
1990,8,1310,2.5,0,0,680,3,0,2.0
1430,8,1430,2.5,0,0,0,2,0,3.0
1200,7,1200,1.0,0,0,0,3,0,1.0
2400,7,2400,2.0,1,0,0,4,0,1.0
2090,6,1200,1.75,0,0,890,3,0,1.0
1220,6,1220,1.0,0,0,0,3,0,1.0
740,6,740,1.0,0,0,0,2,0,1.0
980,7,830,1.0,0,0,150,2,0,1.0
1580,7,1580,1.75,0,2,0,3,0,1.0
2140,8,1490,1.75,0,0,650,3,0,1.0
1610,7,1610,1.0,0,0,0,3,0,1.5
4370,8,2780,3.5,0,3,1590,4,0,2.0
2100,8,2100,2.5,0,0,0,4,0,2.0
1470,6,1470,2.0,0,0,0,2,0,2.0
2970,8,2970,2.75,0,0,0,5,0,2.0
2780,9,2780,3.25,0,0,0,4,0,2.0
1120,7,1120,1.0,0,0,0,2,0,1.0
4070,10,4070,2.5,0,0,0,4,0,2.0
1610,7,1610,2.5,0,0,0,3,0,2.0
1360,8,1240,3.5,0,0,120,3,0,2.0
2210,8,2210,2.25,0,0,0,3,0,2.0
1010,7,1010,1.75,0,0,0,2,0,1.5
1260,7,1260,2.5,0,0,0,3,0,1.0
1940,8,1940,1.5,0,0,0,5,0,2.0
2730,9,2730,2.5,0,0,0,4,0,2.0
3030,9,3030,2.5,0,0,0,4,0,2.0
3130,8,3130,2.25,0,0,0,3,0,2.0
1830,7,1830,2.5,0,0,0,4,0,2.0
1690,8,1690,2.25,0,0,0,3,0,2.0
2170,7,2170,1.75,0,0,0,3,0,1.0
3940,10,3940,3.5,0,0,0,3,0,2.0
2700,8,1560,2.5,0,0,1140,4,0,1.0
3440,9,3440,2.25,0,0,0,4,0,2.0
3920,9,3000,4.25,0,0,920,5,0,2.0
2170,8,2170,2.5,0,0,0,4,0,2.0
1894,6,1520,1.75,0,0,374,2,0,1.5
1920,6,1920,1.5,0,0,0,3,0,1.0
1510,6,1510,2.0,0,0,0,3,0,1.0
3630,11,3630,2.75,0,0,0,5,0,2.0
690,6,690,1.0,0,0,0,2,0,1.0
1620,7,1170,1.5,0,0,450,2,0,2.0
1830,8,1230,1.75,1,0,600,4,0,2.0
1940,7,1000,1.75,0,0,940,4,0,1.0
1210,8,1210,1.5,0,0,0,2,0,3.0
1220,7,1220,1.0,0,0,0,3,0,1.0
1910,8,1910,2.5,0,0,0,4,0,2.0
1330,6,1330,1.0,0,0,0,3,0,1.5
2100,8,2100,2.5,0,0,0,3,0,2.0
2600,8,1300,1.75,0,0,1300,3,0,1.0
1340,8,1150,2.5,0,0,190,2,0,2.0
1670,9,1350,2.75,0,0,320,3,0,3.0
2980,8,2980,2.5,0,0,0,4,0,2.0
1640,8,1340,1.75,0,0,300,3,0,1.0
2480,8,1960,2.5,0,0,520,3,0,2.0
1520,7,1520,1.0,0,0,0,4,0,1.5
3750,10,3750,2.75,0,4,0,5,0,2.0
2570,8,2570,2.5,0,0,0,4,0,2.0
3570,10,3570,3.75,1,0,0,5,0,2.0
1408,8,1408,2.5,0,0,0,3,0,3.0
1260,8,1260,2.5,0,0,0,3,0,3.0
3360,9,3360,2.5,0,0,0,3,0,2.0
1509,8,1509,2.5,0,0,0,3,0,3.0
1570,7,1100,1.75,0,0,470,4,0,1.0
2310,8,2310,2.5,0,0,0,3,0,2.0
1330,7,1330,2.0,0,0,0,3,0,1.0
1820,7,1820,2.5,0,0,0,4,0,2.0
3690,12,3690,2.75,0,4,0,2,1,2.0
2650,8,2110,2.5,1,0,540,4,0,2.0
1040,7,1040,1.0,0,0,0,2,0,1.0
1480,6,740,1.75,0,0,740,2,0,1.0
3330,11,2610,3.0,1,0,720,5,0,2.0
1300,7,1300,2.0,0,0,0,3,0,2.0
2540,8,2540,2.5,0,0,0,4,0,2.0
1060,8,940,2.25,0,0,120,2,0,2.0
2880,8,2880,2.0,0,0,0,5,0,2.0
2120,7,2120,2.5,0,0,0,3,0,2.0
4970,11,3930,3.5,1,3,1040,4,0,2.0
2660,9,2170,3.25,0,0,490,3,0,2.0
5020,12,3970,3.75,1,1,1050,5,0,2.0
1100,8,900,2.25,0,0,200,2,0,2.0
1800,7,1800,2.25,0,0,0,4,0,2.0
2910,8,2910,2.75,0,0,0,5,0,1.5
910,6,910,1.0,0,0,0,2,0,1.0
1800,7,1690,2.5,0,0,110,3,0,2.0
1530,8,1020,1.75,0,0,510,2,0,1.0
1140,7,1140,1.75,0,0,0,3,0,1.0
2190,7,1330,2.25,0,0,860,3,0,1.0
2260,7,1450,2.25,0,0,810,3,0,1.0
1380,9,1380,2.5,0,0,0,2,0,3.0
2060,8,1460,2.5,0,0,600,3,0,1.0
750,4,750,0.75,0,1,0,2,0,1.0
2500,10,2500,2.5,0,0,0,4,0,1.0
3280,9,2190,2.5,0,0,1090,4,0,1.0
1320,7,1320,1.0,0,0,0,3,0,1.5
1800,8,1800,2.5,0,0,0,3,0,2.0
1830,8,1830,2.0,0,0,0,3,0,1.0
1280,6,1280,1.5,0,0,0,3,0,2.0
2120,8,1220,1.5,0,0,900,3,0,1.0
1270,6,650,1.0,0,0,620,2,0,1.0
5120,10,3290,4.5,0,0,1830,4,0,2.0
1720,7,1720,1.75,0,0,0,3,0,1.5
1320,7,1320,1.75,0,0,0,3,0,1.0
2040,7,1780,1.75,0,0,260,3,0,1.5
2390,8,2390,2.25,0,0,0,4,0,2.0
1810,8,1810,2.0,0,4,0,3,1,2.0
2716,9,2716,2.5,0,0,0,4,0,2.0
2500,8,2500,2.5,0,0,0,4,0,2.0
2060,7,2060,1.5,0,0,0,3,0,1.5
3190,9,3190,2.75,0,0,0,4,0,2.0
1040,7,1040,1.0,1,0,0,2,0,1.0
2795,8,2795,3.0,0,0,0,5,0,2.0
3470,7,3470,3.0,0,0,0,6,0,1.5
1830,8,1230,1.75,0,0,600,3,0,1.0
1330,7,630,2.0,0,0,700,3,0,1.0
1760,7,880,1.75,0,0,880,2,0,1.0
1820,7,1820,1.5,0,0,0,3,0,1.0
2520,8,1820,1.0,0,0,700,4,0,1.5
2420,7,2420,1.75,0,0,0,3,0,2.0
1300,7,1300,1.5,0,0,0,3,0,1.0
2770,8,1570,2.25,0,3,1200,2,0,1.0
1040,7,1040,1.0,1,0,0,2,0,1.0
1220,7,1220,1.0,0,0,0,3,0,1.0
900,7,900,1.0,0,0,0,2,0,1.0
3504,7,3504,2.5,0,0,0,4,0,2.0
1340,7,1340,1.75,0,0,0,3,0,1.0
3210,7,2040,2.0,0,0,1170,4,0,1.5
1470,7,1070,1.75,0,0,400,3,0,1.0
1720,7,860,1.75,0,0,860,4,0,1.0
3520,9,2010,3.25,1,2,1510,4,0,1.0
2500,7,1520,2.25,0,0,980,4,0,1.5
1480,7,1480,1.5,0,0,0,3,0,1.0
990,7,990,1.0,0,0,0,3,0,1.0
1560,7,1200,1.5,0,0,360,3,0,1.0
2080,7,2080,1.75,0,0,0,5,0,1.0
4310,8,2950,4.25,0,0,1360,6,0,2.0
2700,9,2700,2.5,0,0,0,4,0,2.0
1490,6,700,1.75,0,0,790,3,0,1.0
1790,7,1190,2.5,0,0,600,3,0,1.0
1410,7,1410,1.75,0,0,0,3,0,1.0
740,6,740,1.0,0,0,0,2,0,1.0
2500,8,1690,2.5,0,0,810,5,0,1.0
1410,7,1410,1.75,0,0,0,3,0,1.0
1400,8,1400,1.75,0,0,0,3,0,1.0
3570,8,2070,2.0,1,1,1500,3,0,1.0
600,5,600,1.0,0,0,0,2,0,1.0
1170,6,1170,1.0,0,0,0,2,0,1.0
2130,8,2130,2.5,0,0,0,3,0,2.0
4740,10,4740,3.25,0,0,0,4,0,2.0
1050,7,1050,1.0,1,0,0,2,0,1.0
2810,8,2010,4.5,0,0,800,6,0,1.0
1710,7,1710,2.0,0,0,0,4,0,1.0
1120,6,1120,1.0,0,0,0,2,0,1.0
2430,8,2430,2.5,0,0,0,3,0,2.0
1780,7,1780,2.5,0,0,0,4,0,2.0
2120,8,1230,2.5,1,0,890,3,0,1.0
2130,8,2130,2.5,0,0,0,3,0,2.0
3060,9,2410,3.5,0,0,650,4,0,2.0
2090,8,1280,2.25,1,2,810,3,0,1.0
1290,8,1290,2.25,1,0,0,3,0,2.0
2540,8,2540,2.5,0,0,0,3,0,2.0
1540,7,1180,2.0,0,0,360,3,0,1.0
4050,9,2230,3.5,0,2,1820,5,0,1.0
1590,7,1590,2.25,0,0,0,3,0,2.0
1920,6,960,2.75,0,0,960,4,0,1.0
3520,8,2270,1.5,0,0,1250,4,0,1.5
2660,9,1960,2.5,1,0,700,5,0,1.0
1370,7,1370,2.25,0,0,0,3,0,2.0
2090,7,1290,3.0,0,0,800,3,0,1.5
3370,7,2310,2.75,0,1,1060,3,0,1.5
1000,6,1000,1.0,0,0,0,3,0,1.0
2430,8,2430,2.5,0,0,0,4,0,2.0
1520,8,1520,2.0,0,0,0,3,0,1.0
1430,7,1430,1.0,0,0,0,3,0,1.5
1390,6,720,1.75,0,0,670,2,0,1.0
2640,8,2640,2.5,0,0,0,4,0,2.0
880,6,880,1.0,0,0,0,2,0,1.0
2420,8,2420,2.75,0,0,0,4,0,2.0
2600,8,2600,2.25,0,0,0,5,0,1.5
3100,10,3100,3.5,0,0,0,4,0,2.0
3970,9,3970,4.0,0,0,0,4,0,2.0
1700,7,1700,2.5,0,0,0,3,0,2.0
2240,7,2240,2.0,0,0,0,4,0,1.5
2190,8,2190,2.5,0,0,0,3,0,2.0
2370,8,2370,2.5,0,0,0,4,0,2.0
2770,8,2120,2.25,1,0,650,6,0,1.5
1320,7,1320,2.0,0,0,0,3,0,1.0
1720,8,1000,2.5,0,0,720,3,0,1.0
2040,8,1440,1.75,0,0,600,4,0,1.0
2380,8,1500,3.0,0,0,880,4,0,1.0
1250,7,1250,2.0,0,0,0,3,0,1.0
2060,7,1360,1.75,0,0,700,5,0,1.0
3136,8,3136,2.5,0,0,0,3,0,1.5
2110,8,2110,2.75,0,0,0,4,0,1.5
1360,7,1360,1.0,0,0,0,3,0,1.0
2060,7,1030,2.0,0,0,1030,3,0,1.0
980,7,980,1.0,0,0,0,2,0,1.0
1280,7,1000,1.75,0,0,280,2,0,1.0
2620,7,2620,2.25,0,0,0,4,0,2.0
2650,8,2240,1.75,0,1,410,3,0,1.0
2200,9,1610,2.5,0,0,590,3,0,2.0
1490,7,930,1.5,0,0,560,2,0,1.0
1700,7,1700,1.75,0,0,0,4,0,1.0
4230,11,4230,2.25,0,0,0,4,0,2.0
1930,8,1930,1.75,0,0,0,5,0,1.0
1810,8,1810,2.0,0,2,0,3,0,1.0
1680,7,1680,1.0,0,0,0,3,0,1.0
1650,7,1650,1.75,0,0,0,3,0,1.0
710,6,710,1.0,0,0,0,2,0,1.0
1500,7,1370,1.0,0,0,130,3,0,1.5
580,5,580,1.0,0,0,0,2,0,1.0
1000,6,1000,1.0,0,0,0,3,0,1.0
2610,9,2610,2.5,0,0,0,3,0,2.0
1100,7,1100,1.75,0,0,0,3,0,1.0
1670,8,1670,1.75,0,0,0,4,0,1.0
2180,7,2180,3.0,0,0,0,6,0,2.0
2080,8,2080,2.0,0,0,0,3,0,1.0
2050,7,2050,2.5,0,0,0,4,0,2.0
840,6,840,0.75,0,4,0,2,1,1.0
3090,8,2340,2.75,0,2,750,4,0,2.0
1710,7,1710,2.5,0,0,0,4,0,2.0
2100,8,2100,2.5,0,2,0,3,0,2.0
2620,8,1310,2.75,0,2,1310,4,0,1.0
1610,7,1610,2.25,0,0,0,4,0,2.0
2020,7,1220,1.75,0,0,800,5,0,1.0
1730,8,1730,3.0,0,0,0,3,0,3.0
3280,10,3280,2.75,0,0,0,4,0,2.0
2480,8,1620,3.0,0,0,860,3,0,1.0
3030,10,3030,2.5,0,0,0,4,0,2.0
860,9,860,2.25,0,0,0,2,0,2.0
1190,6,1190,1.0,0,0,0,2,0,1.0
2790,9,2790,4.0,0,0,0,4,0,2.0
1400,7,800,1.0,0,0,600,3,0,1.0
2030,8,2030,2.5,1,0,0,4,0,1.0
1180,7,1180,1.0,0,0,0,3,0,1.0
1870,7,1670,1.0,0,0,200,4,0,1.5
1000,7,1000,1.0,0,0,0,3,0,1.0
1220,7,1220,1.0,0,0,0,3,0,1.0
1790,7,1790,1.5,0,0,0,5,0,2.0
2430,7,1450,2.5,0,0,980,4,0,1.0
4500,10,4500,4.0,0,0,0,5,0,2.0
1020,7,1020,1.5,0,0,0,2,0,3.0
1800,6,1470,1.75,0,0,330,3,0,1.0
3840,9,3840,3.5,0,0,0,3,0,2.0
3180,11,2240,3.0,0,2,940,3,0,2.0
1680,8,1340,1.75,0,0,340,3,0,1.0
2910,8,1800,3.0,0,0,1110,4,0,1.0
1760,7,1760,2.0,0,0,0,3,0,2.0
2180,7,2180,2.5,0,0,0,3,0,2.0
2880,8,1690,3.5,0,0,1190,3,0,1.0
2090,8,2090,2.5,0,0,0,4,0,2.0
1900,7,1900,1.75,0,0,0,4,0,1.0
3180,10,3180,3.5,1,0,0,5,0,2.0
3217,8,2587,3.5,0,0,630,4,0,2.0
2310,8,2310,2.75,0,0,0,4,0,3.0
2280,8,1550,2.5,0,0,730,3,0,1.0
2789,7,2789,2.5,0,0,0,4,0,2.0
2890,10,2890,2.25,0,4,0,4,1,3.0
1980,8,1980,2.5,0,0,0,3,0,2.0
2880,7,1440,1.0,0,0,1440,1,0,1.0
2560,8,1860,2.75,0,0,700,4,0,1.0
3210,7,1810,2.75,0,0,1400,4,0,1.0
2870,10,2250,2.25,0,0,620,3,0,2.0
1830,7,1320,2.75,0,0,510,4,0,1.0
1660,7,1660,1.75,0,0,0,3,0,1.0
1010,6,1010,1.0,0,0,0,3,0,1.0
2970,9,2970,2.5,0,0,0,4,0,2.0
840,7,840,1.0,0,0,0,2,0,2.0
1830,7,1830,2.25,0,0,0,4,0,2.0
1290,7,1290,1.75,0,0,0,4,0,2.0
1900,7,1640,1.5,0,0,260,3,0,1.5
2050,7,1580,2.75,0,0,470,3,0,1.5
910,6,910,1.0,0,0,0,3,0,1.0
2330,8,1800,2.75,0,0,530,4,0,1.0
1880,8,1880,2.0,0,0,0,4,0,2.0
2240,8,1120,2.0,1,0,1120,4,0,1.0
2080,8,2080,2.0,0,0,0,3,0,2.0
3310,9,2380,2.5,0,0,930,3,0,2.0
1370,7,1370,1.0,0,0,0,2,0,1.5
1920,8,1920,2.25,0,0,0,3,0,2.0
2500,7,1390,2.75,0,0,1110,3,0,1.0
2070,8,1220,2.0,0,0,850,3,0,1.0
1590,7,1090,1.5,0,1,500,3,0,1.0
1490,7,1020,2.25,0,0,470,4,0,2.0
1640,7,1640,1.0,0,0,0,3,0,1.0
1320,7,1320,1.5,0,0,0,3,0,1.0
1930,7,1930,2.5,0,0,0,3,0,2.0
2970,9,2970,2.5,0,0,0,4,0,2.0
2330,8,1780,2.5,0,0,550,4,0,1.0
890,7,890,1.0,0,0,0,3,0,1.0
2700,9,2700,2.5,0,0,0,4,0,2.0
2990,9,2990,2.5,0,0,0,3,0,2.0
1240,7,1240,1.5,0,0,0,3,0,1.0
2490,9,2490,2.5,0,0,0,4,0,2.0
1320,7,1320,1.0,0,0,0,4,0,1.5
1980,7,1380,2.0,0,0,600,3,0,1.0
3460,10,2850,3.0,0,0,610,3,0,2.0
2620,9,2620,2.5,0,0,0,3,0,2.0
2010,8,2010,2.5,0,0,0,4,0,1.5
3820,10,3820,3.75,0,0,0,4,0,1.0
1550,7,860,1.75,0,0,690,3,0,1.0
2500,8,1780,2.75,0,0,720,4,0,1.0
3450,10,3450,2.5,0,0,0,3,0,2.0
2310,7,1430,2.0,0,0,880,4,0,1.0
1390,7,1390,2.0,0,0,0,3,0,1.0
2120,7,1220,2.5,0,0,900,3,0,1.0
1230,7,1160,2.25,0,0,70,2,0,2.0
2370,8,2370,2.5,0,0,0,3,0,2.0
3110,10,3110,3.5,1,0,0,3,0,1.0
1670,8,1670,2.5,0,0,0,3,0,2.0
810,6,810,1.0,0,0,0,3,0,1.0
5420,11,3890,4.5,0,0,1530,4,0,1.0
3000,7,3000,2.5,0,0,0,4,0,2.0
1800,8,1800,2.0,0,0,0,3,0,2.0
660,6,660,1.0,0,0,0,2,0,1.0
1700,8,1700,1.75,0,0,0,4,0,1.0
2168,8,2168,2.0,0,0,0,3,0,1.5
2130,7,1500,2.5,0,0,630,4,0,1.0
2080,8,1220,2.25,0,0,860,4,0,1.0
1770,7,1770,2.5,0,0,0,4,0,2.0
2520,8,1700,2.25,0,2,820,3,0,2.0
1220,8,1220,1.5,0,0,0,3,0,3.0
2415,9,2415,2.5,1,1,0,3,0,2.0
1260,7,1000,1.0,0,0,260,2,0,1.0
2000,7,2000,3.0,0,0,0,4,0,1.5
1980,7,1980,2.5,0,0,0,4,0,2.0
1520,7,1520,1.75,0,0,0,3,0,1.0
3420,9,3420,2.5,0,0,0,4,0,2.0
2200,7,1710,3.25,0,0,490,3,0,2.0
2500,8,1250,2.0,0,0,1250,6,0,1.0
1410,7,1170,2.25,0,2,240,3,0,1.0
3380,8,1690,1.75,1,0,1690,5,0,1.0
1910,7,1080,1.75,0,0,830,3,0,1.0
1020,6,1020,1.0,0,0,0,2,0,1.0
1920,7,1920,1.75,0,0,0,3,0,1.0
2060,8,1340,2.25,0,0,720,3,0,1.0
1400,7,1400,1.0,0,0,0,3,0,1.0
2437,7,2437,2.5,0,0,0,3,0,2.0
2200,7,1290,2.25,0,0,910,4,0,1.0
2500,8,1300,2.5,0,2,1200,4,0,1.0
1770,7,1170,1.75,0,0,600,4,0,1.0
1800,8,1390,1.75,0,0,410,3,0,1.0
1950,7,1550,2.5,0,0,400,4,0,2.0
1410,8,1410,1.75,0,0,0,3,0,2.0
2690,8,2130,2.5,0,3,560,3,0,1.0
1780,6,890,1.75,0,0,890,4,0,1.0
1460,8,1150,2.5,1,0,310,3,0,1.0
1730,7,1210,2.5,0,0,520,3,0,1.0
480,4,480,0.75,0,0,0,1,0,1.0
2683,9,2683,2.5,0,0,0,4,0,2.0
2270,7,2270,2.0,0,0,0,5,0,2.0
1920,8,1920,2.5,0,0,0,3,0,2.0
1000,7,1000,1.0,0,0,0,2,0,1.0
2190,8,1480,1.75,0,0,710,3,0,1.0
2820,8,1430,2.5,1,0,1390,6,0,1.0
1080,7,1080,1.0,0,0,0,3,0,1.0
1630,7,1630,2.25,0,0,0,3,0,2.0
1270,8,1270,1.5,0,0,0,3,0,3.0
2550,7,1760,1.5,0,0,790,4,0,1.5
1170,6,1170,1.0,0,0,0,3,0,2.0
1550,6,1550,1.5,0,0,0,3,0,1.5
3660,10,3660,3.25,0,2,0,5,0,2.0
1400,8,1400,1.5,0,0,0,2,0,1.0
1920,7,1510,2.0,0,0,410,3,0,1.0
1300,7,1300,1.5,0,0,0,4,0,1.5
1140,6,770,1.0,0,0,370,3,0,1.0
1710,8,1360,3.25,0,0,350,3,0,2.0
1280,8,1090,3.25,0,0,190,3,0,2.0
1120,7,1120,1.75,0,2,0,3,0,1.5
2120,7,1060,1.75,0,0,1060,3,0,1.0
2200,7,2200,2.25,0,0,0,4,0,2.0
3680,9,3680,2.5,0,0,0,3,0,1.5
900,6,900,1.0,0,0,0,3,0,1.0
2270,7,1540,2.25,0,2,730,4,0,1.0
1400,7,1400,2.0,0,0,0,3,0,1.0
1470,8,1470,2.0,0,0,0,4,0,1.0
3720,10,3720,2.5,0,0,0,4,0,2.0
840,6,840,2.0,0,0,0,2,0,1.5
1110,6,1110,1.0,0,0,0,2,0,1.0
2050,8,2050,1.75,1,0,0,2,0,1.0
1520,6,1520,2.0,0,0,0,4,0,1.5
1480,8,1000,1.75,0,0,480,3,0,2.0
1840,8,1390,2.25,0,0,450,3,0,1.0
2414,8,2414,2.75,0,0,0,4,0,2.0
3010,8,2410,2.25,0,0,600,3,0,2.0
1090,6,1090,1.0,0,0,0,3,0,1.0
740,6,740,1.0,0,0,0,2,0,1.0
2090,7,1090,1.75,0,0,1000,4,0,1.0
1340,8,1190,1.5,0,0,150,2,0,2.0
1180,7,1180,1.5,0,0,0,3,0,1.0
1470,7,980,1.75,0,0,490,4,0,1.0
3305,7,2245,2.5,0,0,1060,4,0,1.5
1430,7,1430,1.0,0,0,0,4,0,1.5
2980,9,2230,2.25,0,0,750,3,0,1.0
1630,7,1630,1.75,0,0,0,3,0,1.0
2420,8,1740,3.0,0,0,680,3,0,1.0
1530,8,1530,1.5,0,0,0,3,0,1.0
2210,7,1460,2.75,0,0,750,5,0,1.0
1530,7,1530,1.0,0,0,0,4,0,2.0
2110,8,2110,2.25,0,0,0,4,0,2.0
2210,8,2210,2.5,0,0,0,3,0,2.0
1320,7,1320,1.0,0,0,0,4,0,1.5
2020,7,2020,2.5,0,0,0,3,0,2.0
1050,7,880,1.0,0,0,170,2,0,1.0
2130,7,1100,1.5,0,0,1030,4,0,1.0
2160,7,2160,2.5,0,0,0,4,0,2.0
1400,7,1400,1.5,0,0,0,4,0,2.0
3310,9,3310,2.5,0,0,0,4,0,2.0
1900,7,1900,2.25,0,0,0,3,0,2.0
1440,7,1440,2.0,0,0,0,2,0,1.0
2200,8,2200,2.25,0,0,0,4,0,2.0
1550,8,1550,3.25,0,0,0,3,0,3.0
1610,6,1610,1.0,0,0,0,4,0,1.5
3780,11,2650,3.25,1,1,1130,3,0,1.0
2830,8,1690,2.5,0,0,1140,4,0,1.0
2170,7,2170,2.5,0,0,0,4,0,2.0
3830,10,3120,3.5,1,0,710,4,0,2.0
3370,9,3370,2.5,0,2,0,3,0,2.0
1700,7,850,2.5,0,0,850,4,0,1.0
870,7,870,1.0,0,2,0,2,0,1.0
1900,8,1200,2.5,0,0,700,4,0,1.0
1610,9,1080,2.5,0,1,530,3,0,2.0
2590,8,1640,2.5,0,0,950,4,0,1.0
1380,7,1140,2.5,0,0,240,2,0,2.0
2920,9,1690,2.25,1,0,1230,4,0,1.0
1460,7,1460,1.75,0,0,0,3,0,1.0
2110,7,1110,2.0,0,0,1000,5,0,1.0
3350,9,3350,2.75,0,2,0,4,0,2.0
1420,8,1140,1.5,0,0,280,3,0,2.0
1800,7,900,2.0,0,0,900,4,0,1.0
720,6,720,1.0,0,0,0,2,0,1.0
1315,8,1315,1.75,0,0,0,2,0,2.0
1440,8,1440,2.0,0,0,0,3,0,1.0
2030,9,1130,1.75,0,1,900,4,0,1.0
2010,8,2010,2.25,0,0,0,4,0,2.0
2300,9,1960,1.75,0,0,340,4,0,1.0
1110,8,930,1.5,0,0,180,2,0,2.0
1040,6,1040,1.0,0,0,0,3,0,1.0
2320,9,2320,2.0,0,0,0,3,0,1.5
2340,9,2340,2.5,0,0,0,3,0,1.0
2750,8,1650,2.5,1,3,1100,3,0,1.0
4080,9,4080,3.5,0,0,0,4,0,2.0
2320,7,1320,2.5,0,0,1000,4,0,1.0
1460,7,1170,2.0,0,0,290,3,0,1.0
980,7,980,1.0,0,0,0,3,0,1.5
2360,7,1930,1.5,0,0,430,3,0,2.0
1650,8,1650,2.5,0,0,0,3,0,2.0
2050,8,1050,2.5,0,0,1000,4,0,1.0
1680,8,1680,1.75,0,0,0,3,0,1.0
2160,7,1260,2.5,0,0,900,3,0,1.5
1910,8,1910,2.5,0,0,0,3,0,3.0
1610,7,1060,1.5,0,0,550,3,0,1.0
1440,8,1130,2.25,0,0,310,3,0,1.0
2555,8,2555,2.5,0,0,0,3,0,2.0
2380,7,2380,2.5,0,0,0,4,0,2.0
2770,9,1980,3.25,0,0,790,3,0,2.0
1360,7,1310,2.5,0,0,50,3,0,3.0
2050,8,2050,3.0,0,0,0,4,0,2.0
4200,12,3640,3.5,1,2,560,4,0,2.0
3010,10,3010,4.0,0,0,0,4,0,2.0
1480,7,1480,1.0,0,0,0,3,0,1.0
3440,9,3440,3.5,1,0,0,4,0,3.0
2300,7,1270,1.0,0,0,1030,4,0,1.0
2150,8,2150,2.5,0,0,0,4,0,2.0
4330,10,3630,3.25,0,0,700,3,0,2.0
2470,8,2470,2.5,0,0,0,4,0,2.0
1910,8,1910,2.5,0,0,0,3,0,2.0
1980,8,1980,1.5,0,0,0,3,0,2.0
2870,9,2870,2.5,0,0,0,3,0,2.0
2290,8,1270,1.75,0,0,1020,4,0,1.0
1700,7,1340,1.75,0,0,360,4,0,1.5
2120,7,2120,2.5,0,0,0,4,0,2.0
1150,7,710,1.0,1,1,440,2,0,1.0
1420,7,1420,1.75,0,0,0,3,0,1.0
3870,10,3870,4.0,0,0,0,5,0,2.0
2780,8,2120,3.5,0,0,660,4,0,2.0
1100,7,1100,1.5,0,0,0,3,0,1.0
840,7,840,1.0,0,0,0,2,0,1.0
2080,9,2080,3.0,0,0,0,3,0,1.5
1553,7,1553,2.0,0,0,0,3,0,1.0
910,7,910,1.0,0,0,0,2,0,1.0
1620,7,920,1.75,0,0,700,3,0,1.0
1430,7,1430,2.25,0,0,0,3,0,2.0
1140,6,1140,1.0,0,0,0,3,0,1.0
1440,7,990,1.75,0,0,450,3,0,1.0
850,7,850,1.5,0,0,0,3,0,1.0
2070,6,2070,2.5,0,0,0,3,0,1.0
2400,7,2400,2.25,0,0,0,4,0,2.0
1940,9,1940,2.5,0,0,0,3,0,2.0
2020,7,1010,2.0,0,0,1010,6,0,1.0
1270,8,1000,1.5,0,0,270,2,0,2.0
1700,8,1700,1.75,0,0,0,4,0,1.0
2510,8,2010,1.75,0,0,500,5,0,1.5
2280,8,2280,2.75,0,0,0,4,0,2.0
3200,8,1860,2.5,0,1,1340,4,0,1.5
4050,12,4050,3.25,1,0,0,5,0,2.0
1440,7,960,1.0,0,0,480,2,0,1.0
3830,11,3830,3.75,0,0,0,4,0,2.0
1450,8,1450,1.75,0,0,0,3,0,1.0
2100,9,1510,2.75,0,0,590,3,0,2.0
1960,7,1130,2.25,0,0,830,3,0,1.0
1750,8,1750,2.25,0,0,0,4,0,1.5
2140,7,2140,2.25,0,0,0,3,0,2.0
1660,8,1660,2.5,0,0,0,3,0,3.0
2040,7,2040,2.5,0,0,0,4,0,2.0
2450,9,1800,2.5,0,0,650,3,0,2.0
1160,6,870,0.75,0,0,290,2,0,1.0
1480,7,1220,2.25,0,0,260,3,0,1.0
3080,7,3080,1.75,0,0,0,4,0,1.5
1360,7,1360,1.75,0,0,0,4,0,1.0
3110,8,3110,2.75,0,0,0,4,0,1.0
1680,8,1680,1.5,0,0,0,3,0,1.0
2430,8,1780,1.75,0,0,650,4,0,1.0
1720,7,860,2.25,0,0,860,4,0,1.0
1750,8,960,2.25,0,0,790,5,0,1.0
2470,8,2470,2.25,0,0,0,4,0,2.0
1310,7,1310,1.75,0,0,0,3,0,1.0
4410,11,3570,3.75,0,4,840,4,0,3.0
1899,7,1899,1.75,0,0,0,3,0,2.0
2650,9,2650,2.5,0,0,0,3,0,2.0
1610,7,1610,2.25,0,0,0,2,0,2.0
1310,7,910,1.0,0,0,400,2,0,1.0
1240,6,1240,1.5,0,0,0,3,0,1.0
2180,8,2180,2.5,0,0,0,3,0,2.0
1620,7,1620,2.5,0,0,0,4,0,2.0
1350,7,1350,1.0,0,0,0,4,0,1.5
1780,8,1780,2.5,0,0,0,3,0,2.0
1690,7,1690,1.5,0,0,0,5,0,1.5
2430,8,2430,2.5,0,0,0,5,0,2.0
3450,9,3450,3.0,0,0,0,5,0,2.0
2130,7,2130,2.5,0,0,0,3,0,2.0
2030,8,2030,2.5,0,0,0,3,0,2.0
2760,7,2760,2.5,0,0,0,4,0,2.0
1210,6,1210,1.0,0,0,0,2,0,1.0
3130,8,1580,2.75,0,0,1550,5,0,1.0
2760,7,1430,2.75,0,0,1330,5,0,1.0
4320,8,4320,3.75,0,4,0,5,1,2.0
1720,8,1000,2.5,0,0,720,3,0,1.0
3080,9,3080,3.5,0,0,0,4,0,2.0
2870,8,1730,2.25,1,0,1140,4,0,1.0
2660,7,2660,2.5,0,0,0,4,0,2.0
2210,8,2210,2.5,0,0,0,4,0,2.0
1410,7,820,2.5,0,0,590,3,0,1.0
1400,7,1400,1.5,0,0,0,2,0,2.0
3500,10,3500,3.5,0,0,0,5,0,2.0
1600,6,1080,1.0,0,0,520,3,0,1.5
840,6,840,1.0,0,0,0,2,0,1.0
1660,7,1130,1.75,0,0,530,3,0,1.0
2880,8,1710,2.25,0,0,1170,3,0,1.0
2290,7,2290,2.5,0,0,0,4,0,2.0
1560,8,1560,2.0,0,0,0,2,0,1.0
1650,7,1650,1.75,0,0,0,3,0,1.0
1440,6,720,1.75,0,0,720,3,0,1.0
2370,7,2370,2.25,0,0,0,3,0,2.0
870,8,800,1.5,0,0,70,2,0,2.0
1760,8,1290,2.25,0,0,470,3,0,1.0
2230,7,2230,2.5,0,0,0,3,0,2.0
3700,10,2170,3.0,0,0,1530,3,0,1.0
1140,7,1140,1.0,0,0,0,1,0,1.5
3250,8,3250,2.5,0,0,0,4,0,2.0
3120,7,3120,2.5,0,0,0,4,0,2.0
2330,7,1360,1.75,0,0,970,5,0,1.5
2420,9,2420,2.5,0,0,0,3,0,2.0
1160,7,1160,1.0,0,0,0,3,0,1.0
2000,8,1810,2.5,0,1,190,2,0,3.0
3350,10,3350,3.0,0,0,0,4,0,2.0
3660,10,2660,3.5,0,0,1000,4,0,2.0
2480,8,1240,1.75,0,0,1240,3,0,1.0
2030,8,1380,2.25,1,0,650,4,0,1.0
1480,7,1480,1.75,0,0,0,3,0,1.0
2390,9,2390,2.5,0,0,0,4,0,2.0
2350,9,2150,2.5,1,0,200,4,0,2.0
1840,7,1040,2.0,1,0,800,3,0,1.0
2720,7,1500,2.25,0,0,1220,5,0,1.0
2740,10,1510,2.5,1,1,1230,3,0,2.0
1940,7,1220,2.25,0,1,720,3,0,1.0
1730,8,1730,2.5,0,0,0,3,0,2.0
2310,8,1480,2.75,0,0,830,4,0,1.5
2460,8,2460,2.5,0,0,0,4,0,2.0
1170,8,1170,2.5,0,0,0,2,0,2.0
1458,8,950,1.75,0,0,508,3,0,2.0
3480,10,3480,2.5,0,0,0,4,0,2.0
3270,8,1660,3.5,0,2,1610,4,0,1.0
3090,8,2420,2.5,1,0,670,4,0,2.0
1970,7,1970,1.0,0,0,0,3,0,1.0
930,6,730,1.0,0,0,200,2,0,1.0
1600,8,1240,3.5,0,0,360,3,0,2.0
4030,9,4030,3.25,0,0,0,4,0,2.0
1730,7,1730,2.25,0,2,0,2,1,2.0
2420,7,2420,2.5,0,0,0,3,0,2.0
2660,8,1800,2.5,0,0,860,4,0,2.0
1500,6,1060,1.75,0,0,440,3,0,1.0
4870,10,3650,3.5,0,3,1220,5,0,2.5
3190,8,3190,2.5,0,0,0,4,0,2.0
3290,8,3290,2.75,0,0,0,3,0,2.0
1656,7,1656,2.5,0,0,0,3,0,1.0
2140,7,2140,2.0,0,0,0,3,0,1.0
1600,8,1600,1.75,0,0,0,3,0,1.0
1600,7,1600,2.5,0,0,0,3,0,2.0
4210,12,4210,3.5,1,3,0,5,0,2.0
1060,6,1060,1.0,0,0,0,3,0,1.0
1460,7,1460,2.0,0,0,0,3,0,1.0
3510,9,3510,3.0,0,0,0,4,0,2.0
3490,8,3490,2.5,0,0,0,4,0,2.0
1580,8,1580,2.5,0,0,0,3,0,2.0
2680,9,1480,2.75,1,4,1200,4,0,1.0
2820,9,2820,2.5,0,0,0,4,0,2.0
1650,7,1100,3.5,0,0,550,3,0,2.0
1340,7,1340,1.0,0,0,0,3,0,1.5
3370,10,1920,2.25,0,4,1450,3,1,1.0
2400,8,2400,2.5,0,0,0,4,0,2.0
3133,9,2533,2.25,0,0,600,4,0,2.0
7120,12,5480,6.0,1,4,1640,5,0,2.0
2740,9,2740,2.5,1,0,0,4,0,2.0
2000,7,1100,2.0,0,0,900,3,0,1.0
1050,7,1050,1.0,1,0,0,2,0,1.0
1260,8,1020,2.25,0,0,240,3,0,2.0
2960,9,2960,2.5,0,0,0,4,0,2.0
3630,11,3630,2.75,0,0,0,5,0,2.0
2230,8,1450,2.25,0,2,780,3,0,1.5
2390,7,1290,1.75,0,0,1100,3,0,1.0
1590,7,1590,2.5,0,0,0,3,0,2.0
2650,9,2650,2.5,0,0,0,3,0,2.0
3540,8,2720,3.0,1,0,820,4,0,2.0
1920,8,1500,1.75,0,0,420,4,0,1.0
2850,7,1930,2.5,0,0,920,5,0,1.0
750,6,750,1.0,0,0,0,2,0,1.0
1800,7,1240,1.5,0,0,560,2,0,1.0
2070,7,1590,2.0,1,1,480,3,0,1.0
1020,7,1020,1.0,0,0,0,3,0,1.0
2750,8,1980,2.75,1,0,770,4,0,1.5
1510,8,1510,2.5,0,0,0,3,0,3.0
2620,9,2620,2.25,0,0,0,4,0,1.0
1580,8,1330,1.75,0,2,250,3,0,1.0
2670,9,2330,2.5,0,0,340,4,0,2.0
1980,7,1980,2.5,0,0,0,4,0,2.0
1620,7,1620,1.75,0,0,0,4,0,1.5
2450,8,2450,2.5,0,0,0,4,0,2.0
3080,9,3080,2.75,0,0,0,5,0,2.0
1010,7,1010,1.0,1,0,0,2,0,1.5
460,4,460,1.0,0,0,0,1,0,1.0
2120,8,2120,2.5,0,0,0,4,0,2.0
1490,8,1490,2.0,0,0,0,3,0,1.0
4420,11,3150,3.25,0,4,1270,4,1,2.0
1740,6,1740,1.75,0,0,0,3,0,1.0
1760,8,1560,2.0,0,1,200,5,0,1.0
1670,8,1670,1.5,0,0,0,3,0,1.0
1140,7,1140,1.5,0,0,0,2,0,3.0
1350,6,1350,1.0,0,0,0,2,0,1.0
1120,7,1120,1.5,0,0,0,3,0,1.0
1060,7,1060,1.0,0,0,0,3,0,1.0
2960,10,2440,3.0,0,2,520,3,0,2.0
1580,7,1140,1.5,0,0,440,3,0,1.0
2620,8,2620,2.75,0,0,0,4,0,2.0
1679,9,1679,1.75,0,0,0,2,0,2.0
1400,7,1400,2.5,0,0,0,3,0,2.0
1410,7,1410,1.75,1,0,0,3,0,1.0
3600,6,2400,1.75,1,0,1200,3,0,2.0
2350,8,2350,1.75,0,2,0,4,0,1.0
2220,8,1110,1.5,1,0,1110,3,0,1.0
2180,7,1090,1.75,0,0,1090,4,0,1.0
1230,7,1230,1.0,0,0,0,3,0,1.0
1010,7,1010,1.0,0,0,0,2,0,1.0
1805,7,1805,2.5,0,0,0,3,0,2.0
1520,7,1520,1.0,0,0,0,3,0,1.0
2080,8,1470,2.75,0,0,610,4,0,1.0
1520,7,1520,1.75,0,0,0,3,0,1.0
1300,6,650,1.75,0,0,650,3,0,1.0
1850,7,1850,2.5,0,0,0,4,0,2.0
2700,8,1670,2.5,0,0,1030,4,0,1.0
1160,8,1040,2.5,0,0,120,2,0,2.0
1810,8,1390,1.75,1,0,420,4,0,1.0
1560,6,1060,2.5,0,0,500,6,0,1.0
2120,8,2120,3.0,0,0,0,4,0,2.0
1860,7,1860,1.0,0,0,0,3,0,1.0
1320,8,1320,2.5,0,0,0,3,0,3.0
1150,6,1150,1.0,0,0,0,3,0,1.0
2810,8,2810,2.5,0,0,0,3,0,2.0
1320,7,1090,1.0,0,0,230,3,0,1.0
1270,7,1270,1.0,0,0,0,3,0,1.0
1580,7,1580,1.75,0,0,0,3,0,1.0
2180,7,1020,2.0,0,0,1160,4,0,1.0
1770,7,1770,1.0,0,0,0,3,0,1.0
1820,6,1190,1.75,0,0,630,4,0,1.0
2080,8,2080,1.75,0,0,0,3,0,1.5
1280,6,1280,1.0,0,0,0,3,0,1.5
1510,8,1510,2.0,0,0,0,3,0,1.5
1070,6,1070,1.0,0,0,0,2,0,1.0
1450,7,1450,1.5,0,0,0,3,0,1.0
1040,7,1040,1.0,0,0,0,3,0,1.0
2240,8,2240,2.5,0,0,0,3,0,2.0
2240,7,2240,2.5,0,0,0,3,0,2.0
1970,8,1300,1.75,1,0,670,3,0,1.0
2640,8,1400,1.75,0,4,1240,5,1,1.0
1509,8,1509,2.5,0,0,0,3,0,3.0
4040,9,2020,2.5,0,3,2020,4,0,1.0
2650,7,2650,3.0,0,0,0,6,0,1.0
2260,8,1460,2.5,0,0,800,4,0,1.0
2170,8,2170,1.75,1,0,0,4,0,1.0
1910,8,1910,2.5,0,0,0,4,0,2.0
860,6,860,1.0,0,0,0,2,0,1.0
1050,7,1050,2.0,0,0,0,3,0,1.0
2840,7,1580,2.25,0,0,1260,3,0,1.0
2490,8,2490,2.5,0,0,0,4,0,2.0
1670,7,1670,2.25,0,0,0,3,0,2.0
2870,8,1840,1.75,0,0,1030,3,0,1.5
1270,7,1270,1.0,0,2,0,3,0,1.5
1560,8,1180,3.5,0,0,380,3,0,2.0
2890,8,1830,2.75,0,0,1060,6,0,1.0
1010,6,1010,1.0,0,0,0,3,0,1.0
1830,7,1830,1.75,0,0,0,3,0,1.0
2170,6,1470,2.0,0,0,700,4,0,1.5
1830,8,1390,2.5,0,0,440,3,0,1.0
2260,8,2260,2.5,0,0,0,4,0,2.0
2020,7,1180,2.0,0,0,840,3,0,1.5
2960,9,2160,2.75,0,3,800,5,0,1.0
2720,8,2720,2.75,0,0,0,4,0,2.0
2130,7,2130,2.5,0,0,0,4,0,2.0
2520,9,2520,2.25,0,0,0,3,0,2.0
1320,8,1320,2.5,0,0,0,2,0,1.0
1540,6,770,2.5,0,0,770,3,0,1.0
3160,9,2460,3.25,0,0,700,4,0,2.0
4780,10,3660,3.0,1,0,1120,5,0,1.0
5490,12,5490,6.0,1,0,0,5,0,2.0
3100,9,3100,2.25,0,0,0,5,0,2.0
1840,7,1540,2.0,0,0,300,5,0,1.0
2670,7,2670,3.0,0,2,0,4,0,2.0
1570,9,1240,2.5,0,0,330,3,0,2.5
1260,7,1260,1.0,0,0,0,4,0,1.5
1500,7,1500,1.75,0,0,0,3,0,1.0
920,6,920,1.0,0,0,0,2,0,1.0
1090,6,1090,1.0,0,0,0,2,0,1.0
1608,8,1608,2.5,0,0,0,3,0,2.0
3210,8,3210,2.25,0,0,0,5,0,1.5
1200,7,1200,1.0,0,0,0,2,0,2.0
1870,7,1200,1.75,0,0,670,4,0,2.0
1970,8,1970,1.75,0,0,0,3,0,1.0
3750,9,3750,2.5,0,0,0,3,0,2.0
2080,7,1680,2.5,0,0,400,4,0,1.0
2520,8,1670,2.5,0,0,850,4,0,2.0
1250,7,1040,1.75,0,0,210,2,0,2.0
3700,9,2890,3.5,0,0,810,5,0,2.0
1970,7,1450,2.25,0,0,520,5,0,1.0
1850,8,1850,1.75,0,0,0,4,0,2.0
930,7,930,1.0,0,0,0,2,0,1.0
2230,7,1230,2.5,0,0,1000,4,0,1.0
1420,7,820,1.0,0,0,600,2,0,1.0
1190,7,1190,1.0,0,0,0,2,0,1.0
1180,7,1180,1.0,0,0,0,2,0,1.0
1770,8,1770,2.5,0,0,0,3,0,2.0
3240,10,3240,2.5,0,2,0,3,0,2.0
2370,8,1440,2.25,0,2,930,4,0,1.0
1578,7,1578,2.5,0,0,0,3,0,2.0
960,7,960,1.0,0,0,0,3,0,1.0
1239,7,1239,2.0,0,0,0,3,0,1.0
3420,9,1710,2.25,0,0,1710,3,0,1.0
1170,7,1170,1.0,0,0,0,4,0,1.5
2208,8,2208,2.0,0,0,0,4,0,3.0
2540,7,2540,2.5,0,0,0,4,0,2.0
2640,8,1640,2.0,1,1,1000,2,0,1.0
2790,8,2790,2.5,0,0,0,4,0,2.0
1890,7,1890,1.5,0,0,0,5,0,1.0
4000,9,4000,4.5,0,0,0,5,0,2.0
2240,8,1270,3.0,0,0,970,4,0,1.5
2530,8,2530,2.5,1,0,0,5,0,2.0
2140,8,1960,2.5,0,0,180,3,0,2.0
1220,7,1220,1.0,0,0,0,3,0,1.5
3730,7,2160,3.0,0,0,1570,5,0,1.5
960,5,960,1.0,0,0,0,3,0,1.0
2520,7,1320,2.75,0,0,1200,6,0,1.0
1090,8,1090,2.0,0,0,0,2,0,3.0
1380,8,1380,3.25,0,0,0,3,0,3.0
2660,8,2660,2.5,0,0,0,3,0,2.0
2060,8,1400,3.0,0,0,660,3,0,2.0
1810,8,1810,2.0,0,0,0,3,0,2.0
2830,9,2830,2.5,0,0,0,4,0,2.0
1810,7,1810,2.0,0,0,0,5,0,1.5
1560,7,1560,1.75,0,0,0,3,0,1.0
1860,7,1240,2.25,0,0,620,3,0,1.0
1140,6,1140,1.0,0,0,0,3,0,1.0
3160,7,1880,2.5,0,0,1280,4,0,1.0
1870,7,1210,2.0,0,0,660,3,0,1.0
1700,7,850,1.75,1,0,850,4,0,1.0
3370,10,3370,2.5,0,0,0,3,0,1.0
800,5,800,1.0,0,0,0,1,0,1.5
1810,8,1810,1.5,1,0,0,4,0,2.0
1010,7,1010,1.0,0,0,0,3,0,1.0
1770,8,1770,2.0,0,0,0,3,0,3.0
5860,10,3690,3.5,1,0,2170,4,0,2.0
1990,7,1990,1.75,0,0,0,5,0,1.0
2090,7,2090,2.75,1,0,0,4,0,2.0
2198,8,2198,2.5,0,2,0,3,0,2.0
1400,7,1150,2.0,0,0,250,3,0,1.0
2738,8,2738,3.5,0,0,0,5,0,2.0
2320,9,2320,3.25,0,2,0,4,0,1.5
2280,7,1280,2.75,0,0,1000,3,0,1.0
1780,8,1400,2.0,0,2,380,3,0,1.0
2870,8,2540,2.5,0,0,330,4,0,2.0
1270,6,1270,1.0,0,0,0,3,0,1.0
980,7,840,1.5,0,0,140,2,0,2.0
1240,7,1240,2.0,0,0,0,2,0,2.0
1290,7,1290,1.75,0,0,0,3,0,1.0
1330,6,1330,1.0,0,0,0,2,0,1.0
1120,7,840,2.0,0,0,280,2,0,2.0
2650,9,1770,2.25,0,3,880,3,0,1.0
3440,10,3440,3.5,1,0,0,4,0,2.0
3390,10,3040,3.5,0,0,350,3,0,2.0
2080,7,1040,2.0,0,0,1040,3,0,1.0
1160,7,1160,1.0,0,0,0,2,0,1.0
5660,10,4100,4.25,0,0,1560,4,0,2.0
1590,7,1590,1.75,0,0,0,3,0,2.0
2506,8,2506,2.5,0,0,0,4,0,2.0
2040,7,1200,2.75,0,0,840,5,0,1.0
2110,8,2110,2.5,0,0,0,4,0,2.0
2360,8,2080,2.25,0,0,280,3,0,2.0
1560,7,1560,2.5,0,0,0,4,0,1.5
2790,8,1650,2.5,0,0,1140,3,0,1.0
2020,7,2020,2.0,0,0,0,4,0,2.0
2820,9,2820,2.5,0,0,0,4,0,2.0
2120,8,2120,1.5,0,0,0,4,0,2.0
3600,10,3000,3.25,0,1,600,4,0,2.0
1640,7,1640,2.5,0,0,0,3,0,2.0
2090,8,1200,1.0,0,2,890,3,0,1.0
1420,8,1180,3.5,0,0,240,3,0,2.0
980,6,980,1.0,0,0,0,2,0,1.0
1590,8,1590,1.75,0,0,0,3,0,1.0
2210,9,2210,2.5,0,0,0,4,0,2.0
2530,8,2070,1.75,0,2,460,4,0,1.5
2260,8,1770,2.5,1,0,490,4,0,1.0
2660,7,1670,1.75,0,0,990,5,0,1.5
950,7,950,1.0,0,0,0,2,0,1.0
1370,6,1370,1.0,0,0,0,4,0,1.5
1500,7,1500,2.5,1,0,0,3,0,2.0
1131,7,1131,1.0,0,0,0,2,0,3.0
1140,6,1140,1.0,0,0,0,4,0,1.5
3150,9,3150,3.0,0,0,0,4,0,2.0
1470,7,1180,2.25,0,0,290,3,0,1.0
2240,7,1120,2.0,0,0,1120,4,0,1.0
4220,11,4220,3.75,0,0,0,5,0,2.0
1280,7,1280,1.0,0,0,0,3,0,1.0
3090,10,3090,2.5,0,0,0,3,0,2.0
2300,7,1400,2.75,0,0,900,5,0,1.0
5190,11,3390,4.5,1,2,1800,5,0,2.0
2540,7,1510,2.25,0,0,1030,5,0,1.5
1860,7,1860,2.5,0,0,0,2,0,2.0
1940,7,1150,2.0,0,0,790,3,0,1.5
1360,6,1360,2.5,0,0,0,2,0,2.0
2670,8,2670,2.75,0,0,0,3,0,2.0
1730,8,1730,2.5,0,4,0,3,1,3.0
1950,9,1950,2.5,1,0,0,3,0,2.0
4620,11,3870,4.0,0,0,750,9,0,2.5
1760,7,1300,1.0,0,4,460,2,1,1.0
1860,8,1860,2.25,0,0,0,3,0,2.0
1460,8,1120,1.75,0,4,340,3,1,2.0
3510,11,3510,3.5,0,0,0,4,0,2.0
1750,8,1750,1.5,0,0,0,3,0,2.0
2350,9,2350,2.5,0,0,0,3,0,1.5
2000,8,2000,2.25,0,0,0,3,0,2.0
2700,9,2700,2.75,0,0,0,2,0,1.0
2310,9,2310,2.5,0,0,0,4,0,2.0
1810,7,1810,1.0,0,0,0,2,0,1.5
3740,10,2000,3.25,0,0,1740,4,0,1.0
2060,8,2060,2.5,0,0,0,4,0,2.0
2020,8,1350,2.25,1,0,670,4,0,1.0
1210,7,1210,1.75,0,0,0,2,0,1.5
1480,7,1480,1.75,0,0,0,3,0,1.0
1590,7,1590,1.0,0,0,0,3,0,1.5
3140,8,2080,2.75,0,0,1060,4,0,1.0
1180,7,1180,1.0,0,0,0,3,0,1.0
2410,8,2410,2.75,0,0,0,4,0,2.0
3510,10,3510,3.5,0,0,0,4,0,2.0
3080,10,2230,3.25,0,0,850,4,0,2.0
800,6,800,1.0,0,0,0,2,0,1.0
1010,7,1010,1.0,0,0,0,3,0,1.0
2810,7,1520,1.75,0,0,1290,5,0,1.0
3520,9,2400,3.5,0,0,1120,5,0,2.0
2180,7,1090,1.75,0,0,1090,3,0,1.0
1030,7,1030,2.0,0,0,0,3,0,1.0
4160,10,4160,3.25,0,0,0,4,0,2.0
2440,9,2440,2.5,0,0,0,4,0,2.0
900,7,900,1.0,0,0,0,2,0,2.0
1820,6,1820,1.75,0,0,0,3,0,1.0
1400,7,1400,2.5,0,0,0,3,0,2.0
3740,9,2860,3.5,0,0,880,5,0,2.0
1990,8,1990,2.5,0,0,0,3,0,2.0
2730,8,1550,2.75,0,0,1180,4,0,1.5
1450,7,1450,2.25,0,0,0,4,0,1.0
1800,7,1800,3.0,0,0,0,4,0,2.0
2240,8,2100,2.75,0,0,140,3,0,2.0
1030,6,1030,1.0,0,0,0,2,0,1.5
3560,10,3560,2.5,1,0,0,4,0,2.0
2520,7,1500,2.5,0,0,1020,5,0,1.0
2740,8,2740,2.5,0,0,0,4,0,2.0
1750,8,1750,2.5,0,0,0,3,0,2.0
2590,7,1790,2.0,0,0,800,3,0,1.5
1400,7,1400,1.75,0,0,0,3,0,1.0
2640,9,2640,2.5,0,0,0,3,0,2.0
2650,8,1680,2.5,0,0,970,3,0,1.0
1400,7,1400,1.0,0,0,0,3,0,1.0
1870,9,1870,1.75,0,0,0,3,0,1.0
1200,7,1200,2.25,0,0,0,3,0,2.0
1580,7,1100,1.0,0,0,480,3,0,1.0
3180,8,1810,2.5,0,0,1370,3,0,1.0
2570,11,2570,2.5,0,0,0,3,0,2.0
1690,7,1690,2.5,0,0,0,3,0,2.0
2070,7,1450,2.0,0,0,620,3,0,1.0
2210,7,1210,2.5,0,0,1000,4,0,1.0
1280,8,1280,2.5,0,0,0,3,0,3.0
2313,9,2313,2.5,0,0,0,3,0,2.0
3280,7,1910,2.75,0,0,1370,6,0,1.0
1000,7,1000,1.0,0,0,0,3,0,1.0
1150,6,1150,1.0,0,0,0,3,0,1.0
2090,7,1280,2.25,0,0,810,3,0,1.0
3120,8,3120,2.25,0,0,0,5,0,2.0
1710,8,1710,1.75,1,0,0,3,0,1.0
1390,7,1390,1.0,0,0,0,4,0,1.5
3560,9,3560,2.5,0,0,0,4,0,2.0
2550,8,2550,2.5,0,0,0,4,0,2.0
1470,7,1470,1.5,0,0,0,3,0,1.0
2200,8,1570,2.75,0,3,630,3,0,1.0
2340,9,2340,2.75,1,0,0,3,0,1.0
1190,6,1190,1.75,0,0,0,3,0,1.0
2320,7,1720,2.0,0,0,600,4,0,1.0
2640,7,1840,2.5,0,0,800,5,0,1.5
1200,7,1200,1.75,0,0,0,3,0,1.0
860,6,860,1.0,0,0,0,3,0,1.0
2700,7,1510,1.75,0,0,1190,3,0,1.0
770,6,770,1.0,0,0,0,2,0,1.0
1800,8,1200,1.75,0,0,600,3,0,1.0
1760,8,1760,2.75,0,0,0,2,0,2.0
2880,8,2140,2.5,0,0,740,4,0,1.0
1290,7,1290,1.75,0,0,0,3,0,1.0
1990,7,1080,2.0,0,0,910,4,0,1.0
1760,7,1760,2.5,0,0,0,3,0,2.0
1770,7,1100,2.0,0,3,670,3,0,1.0
1980,8,1590,2.0,0,0,390,3,0,1.5
4110,9,2630,3.25,1,0,1480,3,0,2.0
3560,9,3560,3.25,0,4,0,6,0,2.0
1260,7,1120,1.0,0,0,140,2,0,1.5
1520,7,1520,2.5,0,0,0,3,0,2.0
1870,7,1440,2.25,0,0,430,3,0,1.0
960,7,960,1.0,0,0,0,3,0,1.0
1430,6,1430,1.75,0,0,0,4,0,1.0
1840,7,1220,1.75,0,0,620,4,0,1.0
2520,8,1550,3.0,0,0,970,5,0,1.0
3000,8,3000,2.75,0,0,0,4,0,1.0
1560,8,1560,2.0,0,0,0,3,0,3.0
910,7,910,1.0,0,0,0,3,0,1.0
2290,9,1610,3.0,0,1,680,4,0,2.0
1960,8,1290,2.5,0,1,670,4,0,1.0
830,6,830,1.0,0,0,0,2,0,1.0
1540,7,1090,1.0,0,0,450,3,0,1.0
2650,9,2400,1.5,1,0,250,4,0,2.0
1390,7,960,1.0,0,0,430,2,0,1.0
2590,8,2590,2.5,0,0,0,4,0,2.0
2090,7,1200,1.75,0,2,890,3,0,1.0
1050,6,1050,1.0,0,0,0,3,0,1.0
1240,7,1240,1.5,0,0,0,3,0,1.0
2260,9,2260,2.5,0,0,0,4,0,2.0
2910,9,2910,2.5,1,0,0,4,0,2.0
2641,7,2641,2.5,0,0,0,4,0,2.0
960,7,960,1.5,0,0,0,2,0,2.0
1740,7,1210,2.25,0,0,530,3,0,1.0
2074,8,2074,2.5,0,0,0,3,0,2.0
2510,9,2510,3.25,0,0,0,4,0,2.0
1430,8,1160,3.25,0,0,270,3,0,2.0
2040,7,2040,2.5,0,0,0,4,0,2.0
970,7,970,1.75,0,0,0,2,0,1.0
1930,8,1930,2.0,0,0,0,4,0,1.5
2040,7,1280,1.5,0,0,760,3,0,1.0
2180,7,2180,2.25,0,0,0,5,0,2.0
1510,7,1510,2.0,0,0,0,3,0,2.0
2540,8,1320,2.25,0,0,1220,3,0,1.0
1400,7,1400,1.0,0,0,0,4,0,1.5
2860,8,2860,2.5,0,0,0,3,0,2.0
1790,8,1390,3.5,0,0,400,3,0,3.0
3740,9,2540,3.25,1,0,1200,5,0,2.0
1020,6,1020,1.0,0,0,0,2,0,1.0
1670,7,1150,2.0,0,0,520,3,0,1.0
1550,7,1550,1.0,0,0,0,2,0,1.5
2460,8,1680,2.75,0,1,780,4,0,1.0
1130,7,960,1.0,0,0,170,3,0,1.0
1470,7,1470,1.75,0,0,0,3,0,1.0
1650,7,1650,1.0,0,0,0,4,0,1.0
2280,9,2280,2.5,0,0,0,3,0,2.0
1820,8,1720,2.0,0,0,100,3,0,1.5
2690,7,2690,4.5,0,0,0,4,0,1.5
1500,7,1500,2.5,0,0,0,3,0,2.0
2240,9,2240,2.25,1,0,0,4,0,2.0
2717,8,2717,2.5,0,0,0,4,0,2.0
2790,9,2480,2.5,0,0,310,4,0,2.0
1340,7,1340,1.75,0,0,0,3,0,1.0
2920,10,2030,2.5,0,3,890,4,0,1.0
4570,11,4570,2.5,0,2,0,4,0,2.0
2770,9,2770,2.5,0,0,0,4,0,2.0
2100,7,1060,1.75,0,0,1040,5,0,1.0
2970,9,1770,2.5,0,0,1200,3,0,1.0
1570,8,1570,1.5,0,0,0,3,0,2.0
730,7,730,1.0,0,0,0,1,0,1.0
3730,9,2960,3.0,0,0,770,3,0,1.0
3180,9,3180,2.5,0,0,0,4,0,2.0
3230,9,3230,3.0,0,0,0,4,0,2.0
1470,7,1470,1.75,0,0,0,3,0,1.5
3990,9,2710,3.5,0,0,1280,5,0,2.0
1950,7,1050,1.75,0,0,900,5,0,1.0
1900,7,1200,2.0,0,0,700,6,0,1.0
4500,13,4500,2.5,1,0,0,4,0,1.0
2790,9,2790,2.5,0,0,0,4,0,2.0
3600,9,3600,2.5,0,0,0,5,0,2.0
1360,7,1360,1.5,0,0,0,3,0,2.0
3160,8,1580,2.5,0,3,1580,4,0,1.0
809,7,809,2.5,0,0,0,2,0,2.0
2600,10,1930,2.0,0,4,670,3,0,2.0
3290,8,3290,1.75,0,0,0,5,0,1.5
2280,9,2280,2.5,0,0,0,3,0,2.0
2940,8,1590,1.75,0,2,1350,3,0,1.0
2550,7,2550,2.5,0,2,0,4,0,2.0
1330,7,930,1.0,0,0,400,3,0,1.0
1600,7,1600,1.0,0,0,0,4,0,1.5
840,7,840,1.0,0,0,0,2,0,1.0
2620,8,2620,2.5,0,0,0,4,0,2.0
2220,7,2220,1.75,0,0,0,3,0,1.5
1740,8,1740,3.0,0,0,0,3,0,3.0
3240,9,3240,3.25,0,0,0,4,0,2.0
1310,6,1310,2.0,0,0,0,3,0,1.0
1620,7,1180,2.0,0,0,440,3,0,1.0
1680,8,1680,1.75,0,0,0,4,0,1.0
3240,9,3240,1.0,0,0,0,5,0,2.0
6200,11,5050,4.5,1,1,1150,5,0,3.0
1450,7,1450,1.75,0,0,0,3,0,1.0
3510,8,1850,2.25,1,2,1660,5,0,1.0
2060,7,1030,2.0,0,0,1030,4,0,1.0
840,6,840,1.0,0,0,0,3,0,1.0
1264,8,1264,2.25,0,0,0,3,0,2.0
3450,9,1960,3.0,0,4,1490,3,0,1.0
3550,8,2960,2.25,0,0,590,6,0,1.0
1670,8,1350,3.0,0,0,320,4,0,2.0
2960,9,1950,4.0,0,0,1010,7,0,2.0
2140,8,2140,2.5,1,0,0,3,0,1.0
1700,7,1000,2.0,0,0,700,5,0,1.0
1300,7,1300,1.5,0,2,0,2,0,1.0
740,5,740,1.0,0,0,0,2,0,1.0
1300,7,1300,2.5,0,0,0,3,0,2.0
1060,7,1060,1.0,0,0,0,3,0,1.0
1970,7,1090,2.5,0,0,880,3,0,2.0
1320,7,1320,1.5,0,0,0,3,0,1.0
4300,10,2910,3.25,0,3,1390,5,0,2.0
1660,7,1660,1.75,0,0,0,3,0,1.0
1010,8,710,2.25,0,0,300,2,0,2.0
1060,6,1060,1.0,0,0,0,2,0,1.5
1320,8,1320,1.5,1,0,0,3,0,1.0
950,6,950,1.0,0,0,0,3,0,1.0
1970,8,1030,2.0,0,0,940,4,0,1.0
2030,7,1330,2.5,0,0,700,5,0,1.0
3890,11,3060,4.5,0,3,830,4,0,2.0
1340,7,1340,1.5,0,0,0,3,0,1.5
2250,8,1460,2.25,0,0,790,3,0,1.0
2531,8,2531,2.5,0,0,0,4,0,2.0
670,6,670,1.0,0,0,0,1,0,1.0
2650,8,2650,2.5,0,0,0,4,0,2.0
1720,7,1200,1.0,0,0,520,4,0,1.5
1540,6,1540,1.75,0,0,0,3,0,1.0
3500,7,3500,4.5,0,0,0,6,0,2.0
1310,7,1310,1.0,0,0,0,3,0,1.0
2025,7,2025,2.5,0,0,0,5,0,2.0
1400,5,1400,1.0,0,0,0,3,0,1.5
880,6,780,1.0,0,0,100,2,0,1.0
2030,7,1630,2.5,0,0,400,4,0,1.5
2160,8,1660,3.5,0,0,500,4,0,2.0
1560,6,1560,1.75,1,4,0,3,1,1.5
1540,7,1190,1.5,0,0,350,3,0,1.0
2620,8,2620,2.5,0,0,0,4,0,2.0
2760,9,2760,2.5,0,0,0,4,0,2.0
1610,8,1610,2.5,0,0,0,3,0,2.0
1530,7,1270,2.5,0,0,260,3,0,1.0
1190,7,990,1.0,0,0,200,3,0,1.0
3000,8,2470,2.0,0,2,530,3,0,2.0
1650,7,1150,1.75,0,0,500,4,0,1.0
1490,7,1490,1.0,0,0,0,4,0,1.5
910,7,910,1.0,0,0,0,2,0,1.5
1040,7,1040,1.0,1,0,0,3,0,1.0
1300,7,1300,1.0,0,0,0,3,0,1.0
1380,8,1140,2.25,0,0,240,3,0,2.0
2650,8,2650,2.5,0,0,0,3,0,2.0
2730,9,2730,2.5,0,0,0,3,0,2.0
2940,9,2940,2.25,1,0,0,4,0,2.0
1250,7,1250,1.75,0,0,0,3,0,1.0
3220,9,2900,3.5,1,0,320,5,0,2.0
3010,9,2240,2.75,0,2,770,4,0,2.0
3520,10,3520,2.5,0,0,0,4,0,2.0
910,6,910,1.0,0,0,0,2,0,1.0
2140,9,1900,1.5,0,0,240,3,0,2.0
1400,6,1400,1.0,0,0,0,4,0,1.5
1160,7,1160,1.0,0,0,0,3,0,1.0
1350,7,1350,1.75,1,0,0,2,0,2.0
1690,7,1550,2.0,0,0,140,4,0,1.5
3150,9,3000,2.75,0,0,150,3,0,2.0
1100,7,1100,1.0,0,0,0,3,0,1.0
2480,9,1820,2.5,1,0,660,4,0,1.0
1660,7,1660,2.5,0,0,0,3,0,2.0
3060,9,3060,2.5,0,0,0,4,0,2.0
2210,8,1730,2.25,0,2,480,3,0,1.0
1570,8,1180,2.25,0,0,390,3,0,1.0
2360,8,1780,2.5,0,0,580,4,0,1.0
1690,7,1690,1.75,0,0,0,3,0,1.0
1490,6,1490,2.0,0,0,0,3,0,2.0
1960,7,1320,0.75,0,4,640,4,1,1.0
1370,7,1370,1.0,0,0,0,3,0,1.0
2270,7,1170,1.0,0,0,1100,3,0,1.0
2240,8,2240,2.5,0,0,0,4,0,2.0
700,7,700,1.0,0,0,0,2,0,1.0
2080,7,1190,1.5,0,0,890,3,0,1.0
2650,11,2650,2.5,0,0,0,4,0,2.0
2300,8,1700,2.75,0,0,600,3,0,2.0
1050,6,1050,1.0,0,0,0,3,0,1.0
1900,7,1130,1.75,0,0,770,3,0,1.0
1550,6,1550,1.75,0,3,0,4,0,1.0
2920,9,2120,3.25,0,1,800,5,0,2.0
1320,7,1320,1.75,0,0,0,3,0,1.0
2330,7,1190,2.0,0,0,1140,5,0,1.0
2040,7,1020,1.75,0,0,1020,3,0,1.0
2090,7,2090,2.0,1,0,0,4,0,1.0
1680,6,1680,1.0,0,0,0,4,0,1.5
3370,9,3370,2.25,1,2,0,3,0,2.0
2370,8,2370,2.5,0,0,0,4,0,2.0
2240,8,1770,2.25,0,0,470,4,0,2.0
3040,9,2420,3.5,0,0,620,4,0,2.0
2110,9,2110,2.5,0,0,0,3,0,2.0
2450,7,1980,1.75,0,0,470,3,0,1.0
3790,9,3790,3.5,0,0,0,4,0,2.5
1940,7,1480,1.75,0,1,460,3,1,1.0
1322,7,1322,2.5,0,0,0,3,0,2.0
2400,8,2400,2.25,0,0,0,4,0,1.5
2040,7,1250,2.5,0,0,790,4,0,1.0
1440,7,1440,2.25,0,0,0,3,0,2.0
890,6,890,2.0,0,0,0,2,0,1.0
2382,8,2382,2.5,0,0,0,4,0,2.0
2100,8,2100,2.25,1,0,0,4,0,2.0
1680,7,1240,2.5,0,0,440,3,0,1.0
1690,8,1690,1.75,0,0,0,3,0,1.0
3030,10,3030,2.5,0,0,0,3,0,2.0
970,7,970,1.0,0,0,0,3,0,1.0
1860,7,1860,2.5,0,0,0,3,0,1.0
2920,8,1520,2.75,1,0,1400,5,0,1.0
1200,7,1200,1.5,0,0,0,3,0,1.0
2050,8,1690,2.5,0,2,360,4,0,1.0
3460,8,3460,2.75,0,0,0,4,0,2.0
580,6,580,1.0,0,0,0,1,0,1.0
2050,8,1570,2.5,0,0,480,3,0,1.0
4300,10,4300,4.5,0,0,0,5,0,2.0
1730,9,1320,3.25,0,2,410,3,0,2.0
4920,9,2730,3.25,0,3,2190,6,0,1.0
1960,9,1960,2.75,0,0,0,4,0,1.5
1810,7,1810,2.25,0,0,0,3,0,1.0
1090,7,1090,1.5,0,0,0,3,0,1.0
1550,8,1550,2.25,0,0,0,2,0,2.0
1420,7,1420,1.75,0,0,0,3,0,1.0
2790,9,2790,2.5,0,0,0,3,0,2.0
2860,9,1700,2.0,0,0,1160,3,0,1.0
3510,9,3510,2.75,0,0,0,4,0,2.0
1240,8,1200,1.5,0,0,40,2,0,2.0
3340,9,2240,3.25,0,0,1100,4,0,1.5
1010,6,1010,1.0,0,0,0,4,0,1.5
1440,7,1440,1.0,0,0,0,3,0,1.5
1620,7,1620,2.5,0,0,0,3,0,2.0
1960,7,1050,3.0,0,0,910,4,0,1.0
1210,7,1000,1.0,0,0,210,2,0,1.0
1200,9,1200,2.5,0,0,0,3,0,3.0
1980,8,1980,2.5,0,0,0,4,0,2.0
3800,9,3800,3.0,0,0,0,5,0,1.5
2190,7,2190,2.5,0,0,0,4,0,2.0
2720,10,2070,3.25,0,1,650,4,0,2.0
3060,9,3060,2.5,0,0,0,4,0,2.0
1310,7,1310,1.75,0,0,0,3,0,1.0
3910,9,2710,2.5,0,0,1200,4,0,2.0
1790,8,1790,1.0,0,0,0,3,0,1.5
1010,6,1010,1.0,0,0,0,3,0,1.0
3070,9,3070,2.5,0,0,0,3,0,2.0
1380,7,990,1.75,0,0,390,3,0,1.0
1000,6,1000,1.0,0,0,0,2,0,1.0
1300,8,880,2.5,0,0,420,3,0,2.0
2490,8,2490,2.5,0,0,0,4,0,2.0
2720,8,2240,2.0,0,3,480,4,0,2.0
1680,8,1360,3.25,0,0,320,3,0,2.0
2380,9,1340,2.5,0,2,1040,3,0,1.0
910,7,830,1.0,0,1,80,2,0,1.0
2000,9,2000,2.5,0,4,0,2,0,2.0
2110,7,1100,1.75,0,0,1010,5,0,1.0
2640,8,1680,2.5,0,0,960,3,0,2.0
1500,8,1140,2.5,0,0,360,2,0,2.0
1940,7,1240,2.75,0,0,700,5,0,1.0
2400,7,1510,2.5,0,0,890,4,0,1.0
4010,11,4010,3.25,0,0,0,5,0,2.0
3300,8,2200,3.0,0,0,1100,6,0,2.0
2390,8,2390,2.25,0,0,0,4,0,2.0
2180,7,1380,1.75,0,0,800,6,0,1.5
1710,7,1130,2.25,0,0,580,3,0,1.0
1020,7,720,2.0,0,0,300,3,0,2.0
1320,7,920,1.75,0,0,400,2,0,1.0
2130,8,1500,1.75,1,0,630,5,0,1.0
2860,7,2860,2.25,0,0,0,3,0,2.0
2090,8,2090,2.5,0,0,0,4,0,2.0
1360,7,1360,2.25,0,0,0,3,0,2.0
2360,8,1980,2.5,0,3,380,4,0,1.0
2170,7,1420,2.5,0,0,750,4,0,1.0
3290,9,2730,2.25,0,0,560,3,0,2.0
1330,7,900,1.5,0,0,430,2,0,1.0
6030,11,4440,3.75,1,0,1590,3,0,2.0
2340,8,2340,2.5,0,0,0,4,0,2.0
1510,6,1010,1.0,0,0,500,3,0,1.0
1020,7,1020,1.0,0,0,0,3,0,1.5
1030,7,1030,1.0,0,0,0,2,0,1.5
1010,7,1010,1.0,0,0,0,3,0,1.0
1640,7,1140,2.25,0,0,500,3,0,1.0
1450,8,950,1.0,0,1,500,3,0,1.0
1834,8,1834,2.25,0,0,0,4,0,2.0
3240,6,2160,2.75,0,0,1080,6,0,1.0
1660,7,1660,1.75,0,0,0,3,0,1.0
2080,7,1550,2.25,0,0,530,3,0,1.5
2220,8,2220,1.75,0,0,0,2,0,1.0
1320,7,1320,1.75,0,0,0,3,0,1.0
820,7,820,1.0,0,0,0,2,0,1.0
2670,7,2670,2.5,0,0,0,4,0,2.0
1710,7,1320,2.0,0,0,390,4,0,2.0
2530,8,2530,2.5,0,0,0,4,0,2.0
2095,8,1295,2.5,0,0,800,4,0,1.5
1870,8,1870,2.0,0,0,0,2,0,1.0
1970,8,1100,2.5,0,4,870,3,1,1.0
1230,6,1230,1.0,0,0,0,3,0,1.0
1770,7,1770,1.75,0,0,0,3,0,2.0
2080,8,2080,2.5,0,0,0,4,0,1.0
3360,8,1760,2.75,1,0,1600,4,0,1.0
930,6,930,1.0,0,0,0,2,0,1.0
2250,8,2250,2.5,0,0,0,3,0,2.0
1830,7,1060,1.75,0,0,770,4,0,1.0
3470,9,3470,3.5,0,0,0,3,0,3.0
1240,7,1240,1.0,0,0,0,3,0,1.0
2590,8,2590,2.25,0,3,0,3,0,2.0
3900,10,3900,3.25,0,0,0,4,0,2.0
2060,7,1260,2.5,0,0,800,4,0,1.0
1870,8,1380,2.5,0,0,490,3,0,3.0
1410,8,1140,2.5,0,0,270,3,0,2.0
1660,8,1660,2.0,0,0,0,3,0,1.0
2050,9,1750,3.5,0,4,300,3,1,2.0
2550,8,1980,2.75,0,0,570,3,0,2.0
3950,10,3950,2.5,0,0,0,4,0,3.0
4020,11,4020,3.25,0,0,0,4,0,2.0
1646,7,1646,2.25,0,0,0,3,0,2.0
1560,6,780,1.0,0,0,780,2,0,1.0
1200,7,800,1.75,0,0,400,2,0,1.0
1240,7,1240,1.75,0,0,0,3,0,1.5
2050,8,2050,3.0,0,0,0,4,0,2.0
2250,8,2250,2.25,0,0,0,4,0,2.0
1180,7,1180,1.0,0,0,0,3,0,1.5
1760,7,1160,1.75,0,0,600,3,0,1.0
980,7,980,1.0,0,0,0,2,0,1.0
2200,8,1430,2.25,1,0,770,4,0,1.0
2090,7,1440,2.25,0,0,650,3,0,1.0
1170,7,1170,1.0,0,0,0,3,0,1.5
3210,8,3210,3.75,0,0,0,4,0,2.0
1610,8,1610,2.0,0,0,0,2,0,2.0
2810,9,2810,2.5,0,0,0,4,0,2.0
5830,11,5830,3.5,0,0,0,4,0,2.0
1560,7,1560,1.75,0,0,0,3,0,1.0
2580,8,2580,2.75,0,0,0,3,0,2.0
840,6,840,1.0,0,0,0,3,0,1.0
1970,8,1180,2.25,0,0,790,3,0,1.0
1040,6,1040,1.0,0,0,0,3,0,1.0
2020,8,1420,2.75,0,0,600,4,0,1.0
3050,8,1590,2.5,1,0,1460,5,0,1.0
2570,8,2570,2.0,0,0,0,3,0,1.5
2220,7,1140,1.75,0,0,1080,4,0,1.0
2570,8,2570,2.5,0,0,0,4,0,2.0
2400,9,2400,2.5,0,0,0,3,0,2.0
1550,7,1550,2.5,1,0,0,3,0,2.0
1640,7,910,2.0,0,0,730,3,0,1.0
2940,9,1470,2.25,1,0,1470,4,0,1.0
2560,7,1480,1.75,0,0,1080,4,0,1.0
1660,7,920,1.5,0,0,740,3,0,1.0
2770,8,2770,3.5,0,0,0,4,0,2.0
2650,8,2230,3.5,0,0,420,4,0,2.0
1680,7,1680,2.5,0,0,0,3,0,2.0
2460,8,2460,3.0,0,0,0,4,0,1.0
2270,9,2270,2.5,0,0,0,3,0,2.0
1790,7,1240,2.25,0,2,550,3,0,1.0
2870,10,2870,2.5,0,0,0,3,0,2.0
1489,7,1489,2.25,0,0,0,3,0,2.0
1240,6,1240,1.75,0,0,0,3,0,1.0
970,6,970,1.0,0,0,0,3,0,1.0
1770,8,1770,2.5,0,4,0,2,1,2.0
2300,8,2300,2.25,0,0,0,3,0,2.0
1068,7,1068,1.5,0,0,0,2,0,2.0
1140,7,1140,1.0,0,0,0,2,0,1.0
1540,7,770,2.5,0,0,770,3,0,1.0
1170,6,880,1.0,0,0,290,2,0,1.0
2170,7,1630,1.75,0,0,540,3,0,1.0
4610,11,3310,3.25,0,3,1300,5,0,2.0
1790,7,1040,1.0,1,0,750,2,0,1.0
1250,7,1250,2.25,0,0,0,3,0,1.0
4360,10,4360,4.0,0,0,0,5,0,2.0
1300,7,1300,1.0,0,0,0,4,0,1.0
2120,9,2120,2.5,0,0,0,3,0,2.0
1790,7,1400,1.0,0,0,390,3,0,1.0
2590,10,2590,2.5,0,0,0,4,0,2.0
1590,9,1590,2.5,1,0,0,2,0,2.0
4500,9,3040,3.0,1,2,1460,4,0,2.0
1860,7,1860,2.25,0,0,0,3,0,2.0
1910,6,1910,1.0,0,0,0,4,0,1.5
1470,7,1470,0.0,0,0,0,0,0,2.0
1940,7,970,2.0,0,0,970,5,0,1.0
2350,8,1770,2.0,1,0,580,3,0,1.0
2320,9,2320,2.5,1,0,0,4,0,2.0
2500,8,1960,3.25,1,0,540,4,0,1.5
2340,7,2340,2.5,0,0,0,5,0,2.0
2330,7,1720,2.0,0,0,610,4,0,1.5
2850,9,2530,2.75,1,0,320,4,0,2.5
2180,7,1100,2.0,0,0,1080,3,0,1.0
2420,8,1700,2.5,0,4,720,4,0,1.0
1280,7,1280,1.5,0,0,0,3,0,1.0
2840,7,1420,2.75,0,0,1420,5,0,1.0
3880,10,3880,2.5,0,0,0,4,0,2.0
1650,7,1500,2.25,0,0,150,3,0,1.0
2190,8,2190,1.75,0,0,0,3,0,1.0
2400,7,1200,2.75,0,0,1200,5,0,1.0
2870,9,2870,2.5,0,0,0,4,0,2.0
3100,9,3100,1.75,0,1,0,4,0,1.0
1780,7,1780,2.0,0,0,0,4,0,1.5
1590,8,1590,2.25,1,0,0,3,0,2.0
1940,7,1140,1.5,0,0,800,3,0,1.0
1820,7,1030,1.75,0,0,790,3,0,1.0
1860,8,1860,3.25,0,0,0,3,0,3.0
1030,7,1030,1.5,0,0,0,3,0,1.0
2640,7,2040,2.0,0,0,600,4,0,2.0
1160,7,880,1.0,0,0,280,3,0,1.0
2480,8,2480,2.5,0,3,0,4,0,1.5
1860,7,1860,1.5,0,0,0,3,0,1.0
1640,7,1040,1.75,0,0,600,2,0,1.0
970,6,970,1.0,0,3,0,3,0,1.0
2480,8,2480,3.0,0,0,0,6,0,2.0
2960,9,1940,3.5,0,0,1020,5,0,2.0
2480,9,1630,1.75,1,0,850,4,0,1.0
1180,7,1180,1.0,0,0,0,3,0,1.0
2050,7,2050,2.25,0,0,0,4,0,2.0
2665,9,2665,2.5,0,0,0,4,0,2.0
2180,8,2180,2.5,0,0,0,4,0,2.0
2290,7,2290,2.75,0,3,0,3,0,2.0
1440,7,1440,1.0,0,0,0,3,0,1.0
3200,7,3200,2.5,0,0,0,4,0,2.0
1050,7,1050,1.0,0,0,0,3,0,1.5
1310,7,1310,2.0,0,0,0,3,0,1.0
1830,8,1830,2.75,0,0,0,4,0,2.0
2190,7,1390,2.25,0,0,800,3,0,1.0
2740,9,2060,3.25,0,0,680,4,0,2.0
2360,8,1520,2.25,0,3,840,4,0,2.0
1480,7,1480,1.75,0,0,0,3,0,1.5
980,6,980,1.0,0,0,0,3,0,1.0
3220,9,3220,2.5,1,0,0,4,0,2.0
2000,8,1040,2.5,0,0,960,3,0,1.0
840,6,840,1.0,0,0,0,2,0,1.0
1490,6,700,1.75,0,0,790,3,0,1.0
2190,7,1450,1.75,1,0,740,4,0,1.0
2190,8,1840,2.25,1,0,350,4,0,2.0
2140,8,2140,2.25,0,0,0,4,0,2.0
1420,8,1420,1.0,0,0,0,5,0,1.5
2500,10,2500,2.5,0,0,0,3,0,2.0
1700,8,1320,1.75,0,0,380,4,0,1.0
2900,8,2410,2.75,0,0,490,4,0,1.0
3580,10,2370,3.0,0,0,1210,4,0,2.5
2480,8,2480,2.5,0,0,0,3,0,2.0
4010,8,2090,3.5,1,0,1920,6,0,1.0
990,6,990,1.0,0,0,0,3,0,1.0
1550,6,1550,1.0,0,0,0,4,0,1.0
1670,8,1670,2.0,0,0,0,2,0,1.0
1390,7,930,1.75,0,0,460,3,0,1.0
1790,7,1790,1.75,0,0,0,3,0,2.0
1960,7,1490,2.25,0,0,470,3,0,1.0
4050,11,3360,4.0,1,0,690,4,0,2.0
1340,6,1340,2.0,0,0,0,3,0,2.0
2080,7,1040,1.75,0,0,1040,3,0,1.0
1860,7,1010,1.0,0,0,850,2,0,1.0
2260,8,1880,3.25,0,0,380,3,0,2.0
3830,10,3530,3.5,0,0,300,3,0,2.0
1880,9,1880,2.5,0,0,0,2,0,1.0
2200,8,1200,2.0,0,2,1000,3,0,1.0
3640,9,3640,3.5,0,0,0,4,0,2.0
1480,7,1040,1.75,1,0,440,3,0,1.0
2410,8,2410,2.5,0,0,0,4,0,2.0
1900,7,1300,1.0,0,0,600,3,0,1.0
2150,8,1430,2.5,0,0,720,4,0,1.0
2610,8,2610,2.5,0,0,0,4,0,2.0
2530,8,1520,3.0,0,0,1010,5,0,1.0
1540,8,1540,2.25,0,0,0,3,0,3.0
1880,7,940,1.75,0,0,940,3,0,1.0
1580,7,860,2.0,0,0,720,4,0,1.0
1440,7,1440,1.0,0,0,0,3,0,1.0
2100,8,2100,2.25,0,0,0,3,0,2.0
2680,9,2680,2.5,0,0,0,3,0,2.0
4480,7,3680,4.25,0,0,800,4,0,2.0
1790,8,1790,1.75,1,0,0,5,0,2.0
2530,8,1720,2.5,0,0,810,4,0,1.5
2520,8,1270,2.0,0,0,1250,3,0,1.0
1150,6,1150,1.0,0,0,0,3,0,1.5
1840,7,1840,2.0,1,0,0,3,0,1.0
2250,7,1360,2.5,0,0,890,5,0,1.0
2150,8,2150,2.5,0,0,0,4,0,2.0
1550,7,1550,1.0,0,0,0,2,0,1.0
860,7,860,1.25,0,0,0,2,0,2.0
3920,10,3920,3.5,0,0,0,4,0,2.0
1530,7,1530,1.75,0,0,0,4,0,1.5
2820,9,2820,2.5,0,0,0,4,0,2.0
1200,7,1200,1.0,0,0,0,4,0,1.5
1510,7,870,2.0,0,0,640,4,0,1.0
2240,7,2240,2.5,0,0,0,4,0,2.0
2640,7,1840,2.75,0,0,800,4,0,2.0
3280,10,2320,3.75,1,0,960,4,0,2.0
1600,7,1600,1.0,0,0,0,5,0,1.0
3610,10,2610,1.75,0,2,1000,3,0,1.5
1320,7,1320,1.0,0,0,0,3,0,1.0
2170,7,1460,2.5,0,0,710,4,0,1.0
2440,9,1620,1.75,0,0,820,4,0,1.0
970,7,970,1.0,0,0,0,2,0,1.0
1900,8,1280,2.25,1,0,620,4,0,1.0
1830,6,1830,1.75,0,0,0,5,0,1.5
3220,8,3220,2.5,0,0,0,5,0,2.0
2450,8,2200,2.0,0,4,250,4,0,2.0
2120,7,1280,1.75,0,0,840,3,0,1.0
1960,8,1960,2.0,0,3,0,4,0,1.0
1240,6,1240,1.75,0,0,0,3,0,1.0
2610,7,1610,2.5,0,0,1000,4,0,1.5
1690,8,1420,2.5,0,0,270,3,0,3.0
3350,8,2670,2.5,0,0,680,4,0,2.0
2360,7,2360,2.25,0,0,0,4,0,2.0
1660,7,830,2.0,0,0,830,3,0,1.0
2280,7,1250,1.75,0,0,1030,4,0,1.0
2670,9,2670,2.5,0,0,0,4,0,2.0
1440,7,1210,1.0,0,2,230,2,0,1.0
1170,7,1170,1.0,0,0,0,2,0,1.0
2030,7,1190,2.25,0,0,840,3,0,1.0
1740,8,1740,2.25,0,0,0,3,0,1.0
2520,10,2520,2.5,0,0,0,3,0,2.0
1140,7,1140,1.0,0,0,0,2,0,1.0
3270,9,2110,3.5,0,0,1160,4,0,2.0
1400,7,1400,2.0,0,0,0,4,0,2.0
5530,10,5530,3.0,0,2,0,5,0,1.5
3180,11,3180,2.5,1,0,0,4,0,2.0
1960,8,1960,2.5,0,0,0,3,0,2.0
1270,8,1270,2.5,0,0,0,3,0,2.0
1380,7,1380,1.0,0,0,0,2,0,1.0
3110,8,1790,3.0,0,0,1320,5,0,1.0
3020,8,3020,3.0,1,0,0,6,0,2.0
3990,11,3990,1.75,0,0,0,4,0,2.0
2980,7,1680,3.0,0,0,1300,5,0,1.0
1260,7,1020,2.0,0,0,240,2,0,1.0
2130,7,1530,2.25,0,4,600,2,0,1.5
1900,8,1140,1.75,1,0,760,4,0,1.0
3030,9,3030,2.5,0,0,0,4,0,2.0
800,6,800,1.0,1,0,0,2,0,1.0
1480,8,1480,1.75,0,0,0,3,0,1.5
2620,8,1420,2.0,0,0,1200,5,0,1.0
2820,8,1950,2.25,0,1,870,4,0,1.0
1320,7,1320,2.0,0,0,0,3,0,1.0
1570,6,1570,2.0,0,0,0,4,0,1.0
990,6,990,1.0,0,0,0,2,0,1.0
2150,8,2150,2.5,0,0,0,3,0,2.0
1430,6,1430,1.5,0,0,0,3,0,1.0
1920,8,1920,2.25,0,0,0,4,0,1.0
1080,6,1080,1.0,0,0,0,3,0,1.0
3220,11,3220,2.75,0,0,0,4,0,2.0
2330,9,2330,2.75,0,0,0,4,0,2.0
1220,7,1220,1.0,0,0,0,3,0,1.0
2350,8,2350,2.5,0,0,0,3,0,2.0
1540,7,1540,1.0,0,0,0,3,0,1.0
1510,8,1510,2.0,0,0,0,2,0,1.0
2090,7,1070,2.0,0,0,1020,4,0,1.0
4020,11,4020,3.5,1,0,0,4,0,2.0
2090,8,2090,2.75,0,3,0,2,0,2.0
1560,7,1560,1.0,0,0,0,3,0,1.5
1280,7,730,1.75,0,0,550,2,0,1.0
1640,7,1010,1.75,0,0,630,4,0,1.0
2340,7,1280,2.5,0,0,1060,3,0,1.0
1390,7,1390,1.75,0,0,0,3,0,1.0
3960,11,3960,3.25,0,0,0,4,0,2.0
1140,8,1140,1.75,0,0,0,3,0,2.0
1940,8,1940,2.5,0,0,0,4,0,2.0
2650,8,1760,3.25,0,2,890,3,0,1.0
1490,7,1490,1.75,0,0,0,3,0,1.0
1790,8,1790,2.5,0,0,0,3,0,2.0
1290,6,1170,1.75,0,0,120,3,0,1.0
1600,7,990,2.0,0,0,610,3,0,1.0
1470,8,1090,2.25,0,0,380,3,0,2.0
1010,7,1010,1.0,0,0,0,2,0,1.0
2710,8,1880,2.0,0,0,830,3,0,1.5
3930,8,3070,2.0,0,0,860,5,0,1.5
2810,9,2810,2.5,0,0,0,4,0,2.0
1330,7,1330,1.5,0,0,0,3,0,1.0
2320,8,2320,2.5,0,0,0,3,0,2.0
1720,6,860,1.75,0,0,860,3,0,1.0
2675,8,2675,2.25,0,0,0,3,0,2.0
3420,9,3420,3.5,0,0,0,4,0,2.0
3630,9,2300,2.5,0,0,1330,4,0,1.5
3960,10,3960,3.25,0,0,0,4,0,2.0
2390,8,2390,2.25,0,0,0,4,0,2.0
1630,6,1630,1.0,0,0,0,4,0,1.0
700,6,700,1.0,0,0,0,2,0,1.0
2030,8,1500,2.25,0,0,530,3,0,1.0
3130,9,2290,3.0,0,0,840,4,0,2.5
3180,9,3180,2.75,0,0,0,5,0,2.0
2732,7,2732,5.0,0,0,0,6,0,2.0
1950,7,1950,1.75,0,0,0,3,0,1.0
2430,8,2430,2.5,0,0,0,3,0,2.0
2540,9,2540,2.5,0,0,0,4,0,2.0
2770,9,2770,3.5,1,0,0,5,0,2.0
1750,7,1750,2.5,0,0,0,4,0,2.0
2220,7,1110,1.75,0,0,1110,4,0,1.0
3220,8,3220,2.25,0,0,0,4,0,2.0
1350,7,1350,1.0,0,0,0,3,0,1.5
720,6,720,1.5,0,0,0,2,0,1.0
2490,8,2490,2.0,0,0,0,4,0,1.0
2360,7,1320,1.75,1,0,1040,4,0,1.0
3470,7,2070,2.75,0,0,1400,4,0,2.0
4040,9,4040,3.25,1,0,0,4,0,1.0
820,6,820,1.0,0,0,0,2,0,1.0
1260,8,840,2.5,0,0,420,3,0,2.0
2260,8,2260,2.5,0,0,0,3,0,2.0
1480,7,1480,1.0,0,0,0,3,0,1.5
1500,7,1000,2.5,0,0,500,3,0,1.0
1850,7,1850,2.5,0,0,0,3,0,2.0
1760,7,960,2.0,0,0,800,3,0,1.0
2030,7,1100,2.5,0,0,930,4,0,1.0
2040,8,2040,2.25,0,0,0,3,0,2.0
1510,8,1510,2.0,0,0,0,3,0,1.0
1860,7,1110,1.75,0,0,750,4,0,1.0
1670,7,1670,2.5,0,0,0,3,0,2.0
2720,8,2720,2.75,0,2,0,3,0,3.0
1230,7,1230,1.75,0,0,0,3,0,1.0
3850,9,2910,3.0,0,0,940,5,0,2.0
930,6,930,1.0,0,0,0,2,0,1.0
1600,7,1600,2.5,0,0,0,4,0,2.0
1420,7,920,1.5,0,0,500,3,0,1.0
1580,7,1210,1.75,0,1,370,3,0,1.0
2090,7,1790,2.0,0,0,300,4,0,1.5
1420,7,920,1.0,0,0,500,2,0,1.0
2030,7,2030,1.75,0,0,0,3,0,1.0
2060,8,2060,1.75,0,0,0,4,0,1.0
1650,7,1650,2.5,0,0,0,3,0,2.0
3266,8,3266,3.25,0,0,0,4,0,2.0
1740,7,1740,1.75,0,0,0,4,0,1.0
2480,7,2480,2.5,0,0,0,4,0,2.0
2410,9,2410,2.5,0,0,0,4,0,2.0
6640,12,6640,4.5,0,0,0,4,0,2.0
870,7,870,1.0,0,0,0,2,0,1.0
1040,7,1040,1.0,0,0,0,3,0,1.0
2190,6,2190,2.0,1,0,0,4,0,2.0
2330,8,2330,2.0,0,0,0,3,0,2.5
2090,8,2090,2.5,0,0,0,3,0,2.0
1930,7,1930,2.0,0,0,0,3,0,1.0
2290,9,2290,2.0,0,0,0,3,0,2.0
2720,9,2720,2.5,0,0,0,3,0,2.0
1720,8,1060,2.0,0,0,660,3,0,1.5
2580,8,2580,2.5,0,0,0,4,0,2.0
2790,9,2790,2.5,0,0,0,3,0,2.0
2240,7,1140,2.5,0,0,1100,5,0,1.0
990,7,990,1.5,0,0,0,3,0,1.0
1340,7,1100,1.75,0,0,240,3,0,1.0
2880,7,2880,3.0,0,0,0,6,0,2.0
2300,8,2300,1.75,0,2,0,3,0,1.0
2800,8,2800,3.0,0,0,0,6,0,2.0
4060,10,4060,3.5,1,0,0,4,0,2.0
3180,9,2190,2.75,0,0,990,3,0,2.0
1600,7,1050,1.5,0,0,550,3,0,1.0
2750,7,1500,1.5,0,0,1250,4,0,1.0
3730,10,2760,3.5,0,0,970,5,0,1.0
1970,8,1970,2.75,0,0,0,3,0,2.5
1600,7,1600,2.5,0,0,0,3,0,2.0
1940,7,1270,1.5,0,0,670,4,0,1.5
1630,8,1020,1.75,0,0,610,3,0,2.0
1790,7,1290,2.5,0,0,500,4,0,1.0
950,6,950,1.0,0,0,0,3,0,1.5
2220,8,2220,2.5,0,0,0,4,0,2.0
4100,9,4100,3.75,0,0,0,4,0,2.0
1060,7,1060,2.0,0,0,0,3,0,3.0
1590,7,1060,3.0,0,0,530,3,0,1.0
3210,11,3210,2.5,0,0,0,4,0,1.5
3490,9,3490,3.5,0,0,0,4,0,2.0
1660,7,1130,2.25,0,0,530,3,0,1.0
770,6,770,1.0,0,0,0,2,0,1.0
1000,7,1000,1.0,0,2,0,2,0,1.0
1940,8,1100,2.25,0,0,840,3,0,1.0
1440,8,1440,1.75,0,0,0,3,0,1.0
1590,7,1590,2.5,0,0,0,3,0,2.0
2260,9,1890,1.75,0,2,370,2,0,2.0
1250,7,1250,1.5,0,0,0,3,0,1.0
1540,7,920,1.75,0,0,620,3,0,1.0
2660,8,1860,2.75,0,0,800,4,0,1.5
3080,7,3080,2.0,0,0,0,6,0,2.0
2150,8,2150,2.0,0,0,0,5,0,1.5
1620,7,1620,1.75,0,0,0,4,0,1.0
1680,7,1680,2.5,0,0,0,3,0,2.0
1650,8,1650,2.5,0,0,0,3,0,2.0
1640,7,1640,1.5,0,0,0,3,0,1.0
2070,8,2070,2.5,0,0,0,4,0,2.0
1510,7,1510,2.5,0,0,0,3,0,2.0
1780,7,1080,2.75,0,0,700,3,0,1.0
2140,8,2140,2.75,0,0,0,4,0,2.0
2510,9,1540,2.5,0,2,970,4,0,1.0
1120,7,1120,1.0,0,0,0,2,0,1.0
1460,6,880,1.0,0,0,580,3,0,1.0
2340,8,2340,2.5,0,4,0,5,1,2.0
2210,9,1550,3.5,1,0,660,4,0,1.0
1980,8,1980,2.5,0,0,0,3,0,2.0
4590,11,3590,3.25,0,2,1000,5,0,2.0
2440,9,2440,2.5,0,0,0,3,0,2.0
1410,7,1410,1.0,0,0,0,3,0,1.0
2070,8,2070,2.5,0,0,0,3,0,2.0
1900,7,1340,2.0,0,0,560,3,0,1.0
1420,7,1420,1.0,0,0,0,4,0,1.5
2530,7,1440,2.5,0,0,1090,4,0,1.0
2630,9,2510,2.75,0,0,120,6,0,2.0
3090,9,1600,2.75,1,0,1490,5,0,1.0
3970,9,2860,4.25,0,0,1110,5,0,2.0
1440,7,1440,1.0,0,0,0,3,0,1.0
1800,8,1800,2.5,0,0,0,3,0,2.0
3820,10,3820,3.25,0,0,0,4,0,2.0
1230,7,1230,1.0,0,0,0,3,0,1.0
1430,6,1430,1.0,0,0,0,3,0,1.0
2390,9,2150,2.5,0,0,240,4,0,2.0
3180,10,3180,2.5,0,2,0,3,0,2.0
730,6,730,1.0,0,0,0,2,0,1.0
2570,9,2570,2.5,0,3,0,3,0,2.0
2100,9,2100,2.25,1,0,0,4,0,1.0
4960,11,3760,3.75,1,2,1200,5,0,2.0
1480,7,1480,1.75,0,0,0,3,0,1.5
1710,8,1280,1.75,1,0,430,3,0,1.0
1410,9,900,1.75,0,0,510,2,0,1.5
2010,8,2010,2.5,0,0,0,3,0,2.0
1650,7,1010,1.75,0,0,640,4,0,1.0
4010,9,2850,3.5,0,1,1160,5,0,2.0
860,6,860,1.0,0,0,0,2,0,1.0
2550,9,2550,2.25,0,4,0,3,0,1.0
2140,7,1190,2.75,0,0,950,4,0,1.0
1180,7,990,1.5,0,0,190,2,0,2.0
3490,10,1940,3.75,1,1,1550,5,0,1.0
2650,7,1470,2.75,0,0,1180,3,0,1.0
2070,9,1500,2.25,0,0,570,4,0,3.0
1120,6,1120,1.0,0,0,0,3,0,1.0
2370,9,1670,2.75,1,4,700,3,0,1.0
2920,9,2780,1.75,0,0,140,6,0,2.5
1290,7,1290,2.0,0,0,0,3,0,1.0
2290,9,2290,2.5,1,0,0,4,0,2.0
1560,7,1150,2.0,0,0,410,3,0,1.0
1400,7,1400,1.5,0,0,0,3,0,1.0
2000,7,1680,1.0,0,0,320,3,0,1.0
3680,11,3680,3.5,0,2,0,3,0,2.0
2720,9,1830,3.5,0,0,890,5,0,2.0
3490,11,3490,2.5,1,3,0,4,0,2.0
1840,7,1840,2.5,0,0,0,4,0,2.0
2650,8,2650,2.5,0,0,0,4,0,2.0
1760,9,1760,2.25,0,0,0,3,0,3.0
1910,8,1300,2.25,0,0,610,4,0,1.0
4190,11,3150,3.25,0,0,1040,4,0,2.0
2770,9,2770,2.5,1,0,0,4,0,2.0
1590,7,910,2.0,0,0,680,2,0,1.0
2160,8,2160,1.75,0,0,0,3,0,2.0
1050,5,1050,1.0,0,0,0,3,0,1.0
1610,8,1610,2.5,0,0,0,3,0,2.0
1210,7,1210,2.0,0,0,0,5,0,2.0
1650,7,1650,2.5,0,0,0,3,0,2.0
3370,7,2140,2.0,0,0,1230,5,0,1.5
3010,8,1890,2.75,0,0,1120,3,0,1.0
1740,8,1740,1.75,0,0,0,2,0,1.5
2280,8,2280,2.5,0,0,0,4,0,2.0
2370,9,2370,2.5,0,0,0,4,0,2.0
1090,7,1090,1.75,0,0,0,3,0,1.0
1210,7,1210,1.0,0,0,0,2,0,1.5
1780,9,1780,1.0,0,3,0,2,0,1.0
4070,10,4070,4.25,1,3,0,4,0,2.0
1280,7,1200,1.0,0,0,80,2,0,1.0
950,8,950,1.5,0,0,0,2,0,3.0
1620,8,1620,2.5,0,0,0,3,0,2.0
1490,7,1490,2.0,0,0,0,3,0,1.0
2640,8,1590,2.5,0,0,1050,4,0,1.0
1180,7,1180,1.5,0,0,0,3,0,1.0
2060,7,1180,1.75,0,0,880,3,0,1.5
1950,8,1950,2.25,0,0,0,3,0,1.0
500,5,500,1.0,0,0,0,1,0,1.0
800,6,700,1.0,0,0,100,3,0,1.0
2420,8,2420,2.75,0,0,0,4,0,2.0
1400,7,840,2.0,0,0,560,3,0,1.0
1540,7,1540,1.5,0,0,0,4,0,2.0
1660,7,1180,1.0,0,0,480,4,0,1.5
2640,8,2640,2.5,0,0,0,4,0,2.0
2930,8,2930,2.5,0,0,0,3,0,2.0
2060,8,1220,2.25,0,0,840,4,0,1.0
810,5,810,1.0,0,0,0,2,0,1.0
1440,7,1440,1.5,0,0,0,4,0,1.5
2000,7,1130,1.75,0,0,870,4,0,1.0
1840,9,1840,2.5,0,0,0,4,0,2.0
950,6,950,1.0,0,0,0,2,0,1.0
1040,6,1040,1.0,0,0,0,3,0,1.0
2340,10,2340,2.5,0,0,0,5,0,2.0
1240,6,1000,1.0,0,1,240,2,0,1.0
2060,7,1330,2.5,0,0,730,3,0,1.0
1150,7,1150,1.5,0,0,0,3,0,1.0
2750,10,2750,2.5,1,0,0,4,0,2.0
3380,9,3380,2.75,0,0,0,5,0,2.0
1790,7,1170,2.25,0,0,620,4,0,1.0
1770,8,1770,2.5,0,0,0,3,0,1.0
2140,7,1070,1.75,0,0,1070,3,0,1.0
2070,8,1700,2.25,1,0,370,4,0,1.0
980,7,980,1.0,0,0,0,3,0,1.0
2020,7,1010,2.25,1,0,1010,5,0,1.0
1840,7,1840,2.25,0,0,0,3,0,2.0
1240,7,1240,1.0,0,0,0,3,0,1.0
1120,7,1120,1.0,0,0,0,2,0,1.0
1560,7,1140,2.0,0,0,420,4,0,1.5
2650,8,2650,2.5,0,0,0,3,0,1.0
2240,7,1370,2.5,0,0,870,4,0,1.0
1730,7,1730,1.75,0,0,0,4,0,1.0
3320,7,1750,3.0,0,0,1570,4,0,1.0
1340,7,1340,1.0,0,0,0,2,0,1.0
960,7,960,1.0,0,0,0,3,0,1.0
3500,9,2850,3.5,1,0,650,4,0,2.0
1010,6,1010,1.0,0,0,0,3,0,1.0
1000,6,940,1.75,0,0,60,2,0,1.0
2080,8,1700,2.5,0,3,380,3,0,1.0
1010,7,1010,1.5,0,0,0,3,0,1.0
1500,8,1500,1.0,0,0,0,2,0,1.0
2270,9,2270,2.5,0,0,0,4,0,2.0
1620,7,1200,2.0,0,0,420,3,0,1.0
1740,7,1180,1.5,0,0,560,4,0,1.0
1330,7,1330,1.75,0,0,0,3,0,1.0
1540,8,1200,1.75,0,0,340,3,0,1.0
1800,7,1040,1.0,0,0,760,3,0,1.0
940,6,940,0.75,0,0,0,1,0,1.0
1010,6,1010,1.0,0,0,0,3,0,1.0
3320,8,2220,2.75,0,0,1100,4,0,2.0
1930,8,1930,2.5,0,0,0,4,0,2.0
2500,9,2370,2.75,0,0,130,3,0,2.0
1150,6,1150,1.0,0,0,0,2,0,1.0
2170,8,1820,2.5,0,0,350,4,0,1.0
2380,7,1320,1.75,0,0,1060,3,0,1.5
2550,8,1700,2.75,1,0,850,4,0,1.0
3170,9,3170,2.5,1,0,0,3,0,2.0
2070,7,1130,1.75,0,0,940,3,0,1.0
2200,7,2200,2.5,0,0,0,4,0,2.0
1720,7,1420,1.75,0,0,300,3,0,1.0
2370,7,2370,2.5,0,0,0,4,0,2.0
2010,8,2010,1.75,0,0,0,3,0,1.0
2790,7,1470,2.75,0,0,1320,8,0,1.0
1250,7,1250,1.0,0,0,0,3,0,1.0
2210,7,2210,3.0,0,0,0,4,0,2.0
1890,7,980,2.75,0,0,910,4,0,1.0
2475,7,2475,2.75,0,0,0,4,0,2.0
2010,9,2010,2.0,0,2,0,3,0,2.0
2520,7,1890,2.5,0,0,630,5,0,1.5
1975,7,1975,2.5,0,0,0,4,0,2.0
1850,7,1850,2.5,0,0,0,4,0,2.0
1240,7,1000,3.5,0,0,240,3,0,2.0
1100,7,1100,1.0,0,0,0,2,0,1.0
1750,7,1750,2.0,0,0,0,3,0,1.0
2790,9,2790,2.75,0,0,0,4,0,2.0
1430,7,1430,2.0,0,0,0,2,0,1.0
2670,8,1410,2.5,0,0,1260,5,0,1.0
1280,7,1280,1.0,0,0,0,3,0,1.5
2100,8,1250,2.5,1,0,850,4,0,1.0
1400,6,1400,1.0,0,0,0,3,0,1.0
1530,7,1110,2.0,0,0,420,4,0,1.0
1110,7,1110,1.0,0,0,0,2,0,1.0
970,7,970,1.0,0,0,0,2,0,1.0
1584,7,1584,2.25,0,0,0,3,0,2.0
1970,6,1970,1.5,0,0,0,3,0,1.0
2490,9,2490,2.5,0,0,0,3,0,2.0
1390,6,1390,1.5,0,0,0,3,0,1.0
4600,10,2400,2.75,0,4,2200,4,0,1.0
1890,7,1090,1.75,0,0,800,5,0,1.5
3460,11,3460,3.75,0,0,0,4,0,2.0
2060,7,1200,2.25,0,0,860,4,0,1.0
3300,9,3300,2.5,0,0,0,4,0,2.0
1820,7,1240,1.5,0,0,580,2,0,1.0
2470,9,1890,3.25,1,0,580,4,0,1.5
1680,7,1680,2.0,0,0,0,3,0,1.0
1590,7,1590,2.5,0,0,0,3,0,2.0
1840,7,1340,1.5,0,0,500,3,0,1.5
1280,6,1280,1.0,0,0,0,3,0,1.5
2950,8,1950,2.25,0,0,1000,3,0,1.5
2630,9,2630,2.5,0,0,0,4,0,2.0
1580,9,1580,2.25,0,0,0,3,0,3.0
1630,7,1280,2.5,0,0,350,2,0,2.0
2480,7,2480,2.0,0,0,0,3,0,1.0
2220,7,2220,2.0,0,0,0,6,0,1.0
4210,11,4210,3.5,1,0,0,4,0,2.0
920,7,920,1.5,0,0,0,2,0,2.0
3930,10,3930,3.5,0,0,0,4,0,2.0
1200,6,1200,1.0,0,0,0,3,0,1.5
1260,7,1260,1.5,0,0,0,2,0,1.0
1260,8,1260,2.25,0,0,0,2,0,3.0
1650,7,1230,2.25,0,0,420,3,0,1.0
770,6,770,1.0,0,0,0,2,0,1.0
1560,7,1170,1.0,0,0,390,4,0,1.0
2870,8,1870,2.5,1,0,1000,4,0,1.0
2530,7,1540,3.0,1,0,990,4,0,1.5
2010,7,2010,1.75,1,0,0,3,0,2.0
1990,7,1990,2.5,0,0,0,4,0,2.0
3040,8,1640,2.5,1,2,1400,5,0,1.0
1720,7,1220,1.75,0,0,500,4,0,1.0
1970,7,1970,2.25,0,0,0,4,0,2.0
2660,9,1870,2.5,0,3,790,3,0,3.0
2230,8,2230,2.5,0,0,0,4,0,2.0
2810,8,2810,2.5,0,0,0,3,0,2.0
1670,7,1190,2.25,0,0,480,3,0,1.0
3500,10,3500,3.25,0,0,0,4,0,2.0
1460,8,1460,2.25,0,0,0,3,0,3.0
1170,7,840,1.5,0,0,330,3,0,2.0
2080,7,1040,1.0,0,0,1040,4,0,1.0
1710,7,1590,2.75,0,0,120,3,0,1.0
3120,9,1820,2.0,1,0,1300,3,0,1.0
4470,11,4470,2.5,0,0,0,5,0,2.5
1240,7,1240,1.0,0,2,0,2,0,1.5
3230,9,2520,2.5,0,3,710,4,0,2.0
1530,6,1020,3.0,0,0,510,3,0,1.0
860,6,860,1.0,0,0,0,2,0,1.0
1190,7,1190,2.0,0,0,0,4,0,1.5
3040,7,3040,2.5,0,0,0,3,0,2.0
910,6,910,1.5,0,0,0,3,0,1.0
2800,8,1400,1.75,0,4,1400,3,1,1.0
1360,7,1010,1.5,0,0,350,4,0,1.0
3440,8,2170,2.5,0,4,1270,4,1,2.0
2030,7,1840,1.0,0,0,190,3,0,1.5
1600,8,1600,2.5,0,0,0,3,0,3.0
1570,7,970,1.75,0,0,600,3,0,1.0
3840,10,2590,3.25,0,3,1250,4,0,1.5
860,6,860,1.0,1,0,0,3,0,1.0
1420,7,1420,2.0,0,2,0,2,0,1.5
1670,7,1670,2.0,0,0,0,3,0,1.0
3290,10,3290,2.5,0,0,0,3,0,2.0
840,6,840,1.0,0,0,0,2,0,1.0
1380,7,1380,2.0,0,0,0,3,0,2.0
2680,8,2680,2.5,0,0,0,4,0,2.0
980,6,980,1.0,0,0,0,3,0,1.0
1580,7,1580,2.5,0,0,0,3,0,2.0
2160,9,2160,2.5,0,0,0,3,0,2.0
1330,8,1330,2.5,0,0,0,2,0,3.0
3230,9,3230,3.25,0,0,0,3,0,2.0
2450,10,2450,2.25,0,0,0,4,0,1.0
1660,7,1080,1.75,0,0,580,3,0,1.0
2790,7,2140,2.75,0,0,650,5,0,1.5
1370,7,1200,2.25,0,0,170,2,0,2.0
1700,8,1700,1.5,1,1,0,3,0,1.0
1470,7,1130,1.75,0,0,340,3,0,1.0
1520,6,1020,2.0,0,0,500,4,0,1.0
2600,8,1580,2.75,0,0,1020,4,0,1.0
940,7,940,1.0,0,0,0,2,0,1.0
1000,6,1000,1.0,0,0,0,2,0,1.0
1710,7,1070,1.75,0,0,640,5,0,1.0
2007,9,2007,2.5,0,0,0,4,0,2.0
2550,7,2550,2.5,0,0,0,3,0,2.0
1210,7,1210,2.75,0,2,0,3,0,1.5
2620,8,2620,2.75,0,0,0,4,0,2.0
1670,7,1670,2.5,0,0,0,3,0,2.0
4280,10,3050,3.25,0,0,1230,4,0,2.0
2870,7,1950,3.0,0,0,920,5,0,1.0
1670,7,1390,1.75,0,0,280,4,0,1.0
1080,7,1080,2.0,1,0,0,3,0,1.0
1960,7,1960,1.75,0,0,0,3,0,1.0
1880,8,1180,2.0,0,0,700,3,0,1.0
4090,11,4090,4.0,0,0,0,4,0,2.0
2330,7,1230,2.0,0,0,1100,4,0,1.0
2390,7,1890,1.5,0,0,500,3,0,1.0
3530,10,2570,3.5,0,1,960,4,0,2.0
2180,8,1180,1.75,0,0,1000,4,0,1.0
800,6,800,1.0,0,0,0,3,0,1.5
2390,9,2390,2.5,0,0,0,3,0,2.0
880,6,880,1.0,0,2,0,3,0,1.0
3320,8,2480,3.25,0,0,840,5,0,2.0
1070,7,1070,1.0,0,0,0,3,0,1.0
940,6,940,1.0,0,0,0,3,0,1.0
2300,7,1150,1.75,0,0,1150,3,0,1.0
1350,6,1350,1.75,0,0,0,3,0,1.0
1300,7,1300,1.75,0,0,0,3,0,1.0
1510,7,1070,1.5,0,0,440,4,0,1.0
2120,7,2120,2.25,0,2,0,4,0,2.0
4170,10,4170,3.5,1,0,0,5,0,2.0
1840,7,960,1.75,0,0,880,4,0,1.0
1840,7,1390,2.25,0,0,450,4,0,1.0
3200,8,2100,2.5,0,0,1100,3,0,1.5
1300,7,1300,2.0,0,0,0,3,0,1.0
1990,7,1990,1.75,0,0,0,4,0,1.0
2370,8,2370,2.5,0,0,0,3,0,2.0
2420,8,1680,2.5,0,0,740,4,0,1.0
1620,8,1540,2.25,0,0,80,3,0,3.0
2870,9,2870,2.5,0,0,0,4,0,2.0
2900,8,2900,2.5,0,0,0,4,0,2.0
2220,9,1690,2.25,0,0,530,4,0,1.0
2230,8,1320,2.75,0,0,910,4,0,1.0
980,7,980,1.0,0,0,0,4,0,1.5
1580,7,1000,1.0,0,0,580,3,0,1.0
1280,7,1280,1.0,0,0,0,4,0,1.5
1540,7,770,1.75,0,2,770,3,0,1.0
1470,6,1470,1.0,0,0,0,4,0,1.5
2440,8,2440,2.25,0,1,0,3,0,1.0
1470,7,1470,1.0,0,0,0,2,0,1.0
2550,7,2550,2.5,0,0,0,4,0,2.0
2440,8,2440,2.5,0,0,0,3,0,2.0
1250,7,1250,1.5,0,0,0,3,0,1.0
1260,7,1260,1.75,0,0,0,3,0,1.0
1170,7,1170,1.5,1,0,0,3,0,1.0
2020,10,2020,2.0,0,0,0,3,0,1.0
1290,7,870,1.75,0,2,420,2,0,1.0
2110,8,2110,2.25,0,0,0,4,0,2.0
1390,8,1390,2.0,0,0,0,3,0,2.0
1160,6,1160,1.0,0,0,0,3,0,1.0
2470,7,1350,2.75,0,0,1120,4,0,1.0
1390,8,1390,1.75,0,0,0,2,0,1.5
2220,8,1660,2.5,0,0,560,3,0,1.5
1560,7,1560,1.75,0,0,0,3,0,1.0
1320,7,1320,1.5,0,0,0,3,0,1.0
2180,8,2180,2.5,0,0,0,4,0,2.0
1780,8,1780,1.75,0,0,0,2,0,1.0
1140,6,1140,1.0,0,0,0,3,0,1.5
2700,9,2700,2.75,0,0,0,4,0,2.0
2860,9,2860,2.5,0,0,0,3,0,2.0
1800,8,1800,2.5,0,0,0,3,0,2.0
2830,10,2830,2.5,0,0,0,3,0,2.0
3630,9,2470,3.75,1,0,1160,5,0,1.5
3450,10,3450,3.5,1,0,0,4,0,2.0
2760,8,1800,2.0,0,0,960,4,0,2.0
860,6,860,1.0,0,0,0,2,0,1.0
1200,7,1200,1.75,0,0,0,3,0,1.0
1830,10,1690,2.75,0,0,140,3,0,2.0
3130,9,2570,3.5,1,0,560,5,0,2.0
1820,8,1220,2.25,0,0,600,3,0,1.0
1590,8,1590,2.25,0,0,0,3,0,3.0
2980,9,2980,2.5,0,0,0,5,0,2.0
3720,9,3720,3.0,1,0,0,4,0,2.0
2390,8,1350,1.75,0,0,1040,3,0,1.0
2340,10,2120,2.5,0,0,220,3,0,2.0
1300,7,1300,1.0,0,0,0,3,0,1.0
1910,9,1910,2.5,0,0,0,3,0,2.0
3450,8,2450,3.25,0,0,1000,4,0,2.0
1710,7,1710,2.5,0,0,0,3,0,2.0
1150,6,1150,1.0,0,0,0,3,0,1.0
1510,7,1510,1.0,0,0,0,4,0,1.5
880,7,880,1.5,0,0,0,2,0,2.0
1010,6,890,1.0,0,0,120,2,0,1.0
760,6,760,1.0,0,0,0,2,0,1.0
1500,6,750,1.0,0,0,750,3,0,1.0
2010,8,2010,2.25,0,0,0,3,0,2.0
2170,8,1420,2.25,0,0,750,4,0,1.0
4000,9,4000,3.5,0,0,0,4,0,2.0
1910,9,1910,1.75,0,0,0,2,0,1.0
1340,7,1340,1.0,0,0,0,3,0,1.0
900,7,900,1.0,0,0,0,2,0,1.0
1950,7,1010,1.5,0,0,940,3,0,1.0
1140,6,1140,1.0,0,0,0,2,0,1.0
3030,9,2530,2.5,0,0,500,4,0,2.0
2470,8,2470,2.5,0,0,0,4,0,2.0
1750,7,1210,2.25,0,0,540,3,0,1.0
2410,8,1540,2.25,0,1,870,3,0,1.0
2250,8,2250,2.5,0,0,0,3,0,2.0
2770,8,2770,2.5,0,3,0,3,0,2.0
990,7,990,1.0,0,0,0,3,0,1.0
2610,8,2610,2.25,0,4,0,3,1,1.0
1676,7,1676,2.5,0,0,0,3,0,2.0
1470,7,1470,2.5,0,0,0,3,0,2.0
2010,7,1290,3.0,0,0,720,5,0,1.0
1230,7,1230,2.25,0,0,0,3,0,1.5
3470,9,2370,3.0,0,2,1100,4,0,2.0
720,5,720,1.5,0,1,0,3,0,1.0
3270,9,3270,2.5,0,0,0,5,0,2.0
1980,7,1260,1.0,0,0,720,4,0,1.0
1780,8,1330,2.25,0,0,450,5,0,1.0
1220,7,1220,1.75,0,0,0,3,0,1.0
2020,7,2020,1.5,0,0,0,4,0,1.0
1680,7,1170,1.75,0,0,510,3,0,1.5
2520,8,1260,1.75,0,0,1260,3,0,1.0
1980,8,1980,2.5,0,0,0,3,0,2.0
1930,9,1930,1.75,0,0,0,3,0,1.0
1980,7,1980,2.5,0,0,0,4,0,2.0
2220,9,1790,1.5,0,3,430,3,0,2.0
1250,7,1250,1.5,1,0,0,3,0,1.0
1660,7,1660,2.5,0,0,0,4,0,2.0
1300,7,1300,2.0,0,0,0,4,0,1.0
990,6,990,1.0,0,0,0,3,0,1.0
2330,8,2330,2.25,0,0,0,4,0,2.0
2290,7,1250,1.75,0,0,1040,3,0,1.0
1600,7,1600,2.0,0,0,0,3,0,1.0
1070,7,1070,1.0,0,0,0,3,0,1.0
2530,8,1320,2.25,1,0,1210,4,0,1.0
2770,8,1640,2.75,1,1,1130,3,0,1.0
1460,7,1460,1.0,0,0,0,3,0,1.0
3460,10,3020,3.25,0,1,440,4,0,2.0
1360,7,1060,1.75,0,0,300,5,0,1.0
2050,8,1540,2.75,0,0,510,4,0,1.0
2680,8,2680,2.25,0,0,0,4,0,2.0
1310,6,1310,1.75,0,0,0,3,0,1.0
2440,8,1640,3.0,0,0,800,3,0,2.0
3580,9,3580,2.5,1,0,0,5,0,2.0
670,5,670,1.0,0,0,0,2,0,1.0
3760,8,2470,3.0,0,0,1290,4,0,2.0
600,4,600,1.0,0,0,0,2,0,1.0
1760,7,1760,1.75,0,0,0,3,0,1.0
2050,7,1250,1.75,0,0,800,4,0,1.0
1425,8,1425,2.5,0,0,0,3,0,3.0
3020,8,1730,2.5,1,0,1290,4,0,1.0
1730,8,1730,1.75,0,0,0,4,0,1.0
1340,7,1340,1.75,0,2,0,3,0,1.0
1460,8,1460,1.0,0,0,0,3,0,1.0
690,5,690,1.0,0,0,0,2,0,1.0
2600,8,2600,2.5,0,0,0,4,0,2.0
3280,9,2440,3.5,0,0,840,5,0,2.0
1310,7,1310,1.0,0,0,0,3,0,1.0
2110,8,2110,2.25,0,0,0,3,0,2.0
2160,9,2160,3.5,0,0,0,5,0,3.0
1700,8,1700,2.5,0,0,0,3,0,2.0
1440,7,1440,1.0,0,0,0,3,0,1.5
1260,7,940,2.5,0,0,320,3,0,2.0
1140,7,630,1.5,0,1,510,2,0,1.0
2950,8,2120,2.75,0,0,830,4,0,1.0
2390,9,2390,2.5,0,0,0,4,0,2.0
1600,6,800,1.0,0,2,800,3,0,1.0
1440,8,1440,1.0,0,0,0,3,0,1.5
1110,7,1010,1.0,0,0,100,2,0,1.0
2200,6,2200,3.0,0,0,0,4,0,1.0
2760,7,1380,1.75,0,0,1380,3,0,1.0
1240,7,800,1.0,0,0,440,3,0,1.0
1400,8,1400,2.25,1,0,0,3,0,2.0
1590,8,1590,2.25,0,0,0,3,0,3.0
1640,8,1340,1.75,0,0,300,2,0,1.0
1350,6,860,1.0,0,0,490,3,0,1.0
1580,8,1580,1.75,0,0,0,3,0,1.0
1380,8,1380,3.0,0,0,0,3,0,3.0
1900,8,1900,2.5,0,0,0,4,0,2.0
2700,9,2700,2.5,0,0,0,4,0,2.0
2020,7,1350,2.75,0,0,670,4,0,1.0
1870,7,1870,2.25,0,0,0,4,0,2.0
1910,7,1340,1.75,0,0,570,3,0,1.0
840,7,840,1.0,0,0,0,2,0,1.0
2490,9,1490,2.75,0,2,1000,4,0,2.0
2400,8,2400,2.5,0,0,0,3,0,2.0
1010,7,1010,1.5,0,0,0,2,0,1.0
2250,9,2250,2.25,0,0,0,4,0,2.0
2830,11,2830,2.5,0,0,0,3,0,2.0
2230,7,1330,1.5,0,0,900,4,0,1.5
3190,10,3190,2.5,0,0,0,4,0,2.0
2410,8,2410,2.5,1,0,0,3,0,1.5
1430,7,980,2.0,0,0,450,3,0,1.0
2250,7,2250,2.5,0,0,0,4,0,2.0
1000,6,1000,1.0,0,0,0,2,0,1.0
2580,9,2580,2.5,0,0,0,3,0,2.0
1510,7,1010,2.0,0,0,500,2,0,1.0
3040,8,1430,2.25,0,0,1610,4,0,1.0
2350,7,1600,2.0,0,0,750,3,0,1.0
1900,8,1900,2.5,0,0,0,2,0,2.0
1940,7,1940,2.5,0,0,0,4,0,2.0
1890,7,1890,1.75,0,0,0,3,0,2.0
2450,8,1960,3.5,0,4,490,3,0,2.0
3060,10,2460,3.25,0,0,600,3,0,2.0
900,6,900,1.0,0,0,0,2,0,1.0
1100,7,1100,1.0,0,0,0,2,0,1.0
2560,9,1280,2.25,0,0,1280,3,0,1.0
1330,7,1120,1.0,0,0,210,3,0,1.0
960,6,960,1.0,0,0,0,3,0,1.5
690,5,690,1.0,0,0,0,1,0,1.0
1010,7,1010,1.0,0,0,0,3,0,1.0
1650,8,1650,2.5,0,0,0,3,0,2.0
1430,6,1430,1.75,0,0,0,3,0,1.0
1070,7,720,2.5,0,0,350,3,0,2.0
1410,7,1410,2.0,0,0,0,3,0,1.0
1570,7,980,1.75,0,2,590,3,0,1.0
2020,7,1310,2.5,0,0,710,3,0,1.0
990,6,990,1.0,0,0,0,3,0,1.0
1580,7,1080,2.0,0,0,500,3,0,1.0
1260,7,1260,2.0,0,0,0,3,0,1.0
2920,7,2920,1.75,0,0,0,3,0,1.0
1670,7,1670,3.0,0,0,0,3,0,1.0
1040,6,1040,1.0,0,0,0,3,0,1.0
2000,7,1200,1.75,0,3,800,3,0,1.0
2510,8,1810,2.25,0,2,700,3,0,1.5
1630,8,1320,2.5,1,0,310,3,0,2.0
1220,6,1220,1.0,0,0,0,4,0,1.5
1232,7,1232,2.5,0,0,0,3,0,3.0
1110,7,1110,1.0,0,0,0,3,0,1.0
1540,6,1540,2.0,0,0,0,3,0,1.0
3110,9,3110,2.75,0,0,0,5,0,2.0
2370,8,1650,2.25,0,0,720,3,0,1.0
1360,7,1360,1.75,0,0,0,3,0,1.0
2930,9,2930,2.75,0,0,0,5,0,2.0
1970,7,1590,1.75,0,0,380,3,0,1.0
2770,8,2770,2.5,0,0,0,4,0,2.0
2400,7,1210,2.0,0,0,1190,5,0,1.0
1340,7,1340,2.0,0,0,0,3,0,1.0
1920,7,1470,1.75,1,0,450,4,0,1.0
1150,6,1150,1.0,0,0,0,2,0,1.0
1440,7,1040,1.0,0,0,400,3,0,1.0
1000,7,1000,1.0,0,0,0,3,0,1.0
2710,9,1480,2.75,0,4,1230,3,0,1.5
3340,11,3340,2.75,0,0,0,4,0,2.0
1500,7,1000,1.0,0,0,500,3,0,1.0
3050,9,3050,2.25,0,0,0,3,0,2.0
670,6,670,1.0,0,0,0,2,0,1.0
3240,8,2020,2.5,0,1,1220,5,0,1.0
770,4,770,1.0,0,0,0,2,0,1.0
2181,8,2181,2.5,0,0,0,4,0,2.0
1690,7,1690,2.5,0,0,0,3,0,2.0
4280,11,3400,2.5,1,0,880,4,0,2.0
1220,7,1220,1.75,1,0,0,3,0,1.0
2150,7,1270,2.0,0,0,880,6,0,1.0
1280,7,860,1.75,0,0,420,4,0,1.0
1720,7,860,1.75,0,0,860,2,0,1.0
1640,6,1500,1.0,1,0,140,3,0,1.5
1260,7,1110,1.75,0,0,150,3,0,1.0
1370,9,1370,2.0,0,0,0,4,0,2.0
1420,7,1080,1.75,0,0,340,4,0,1.0
2060,8,1370,2.0,0,1,690,4,0,1.0
1740,7,1230,2.0,0,0,510,3,0,1.0
1690,7,990,2.5,0,0,700,5,0,1.5
3620,9,3620,2.5,0,0,0,4,0,2.0
1330,7,1330,1.0,0,0,0,3,0,2.0
2280,8,1140,2.0,0,0,1140,5,0,1.0
1440,8,1440,2.0,0,0,0,3,0,1.0
840,6,840,1.0,0,0,0,3,0,1.0
1430,6,1430,2.0,0,0,0,5,0,1.5
2990,10,2990,2.5,0,0,0,4,0,2.0
1330,7,1330,1.5,0,0,0,3,0,1.0
1290,7,1290,2.0,0,0,0,3,0,1.0
1350,8,1050,2.25,0,0,300,3,0,2.0
3830,9,3830,3.5,0,0,0,4,0,2.0
2890,8,2890,2.5,0,0,0,3,0,2.0
1150,8,1150,1.0,0,0,0,3,0,1.0
1010,6,1010,1.0,0,0,0,2,0,1.0
1240,7,1240,1.0,0,0,0,2,0,1.0
1620,7,1310,1.75,0,0,310,3,0,1.0
1630,7,1630,1.5,0,0,0,3,0,1.0
4690,10,3680,3.25,0,2,1010,4,0,2.0
1760,7,1230,1.0,0,0,530,4,0,1.0
1330,7,960,1.0,0,0,370,3,0,1.0
2320,8,1420,1.75,0,2,900,3,0,1.0
844,7,844,0.0,0,0,0,0,0,1.0
1310,7,1310,1.0,0,0,0,3,0,1.0
3160,7,1580,2.5,1,0,1580,5,0,1.0
1670,8,1670,2.5,0,0,0,3,0,2.0
1760,7,1160,1.5,0,0,600,3,0,1.0
2840,9,2840,2.5,0,0,0,3,0,2.0
1340,7,1340,1.75,0,0,0,3,0,1.0
2290,7,1490,2.25,0,4,800,4,1,1.0
2570,7,2570,3.0,0,2,0,4,0,2.0
870,6,870,1.0,0,2,0,2,0,1.0
1950,7,1450,1.0,0,0,500,5,0,1.5
1710,7,1710,2.0,0,0,0,4,0,1.5
1450,7,1450,2.0,0,0,0,4,0,1.0
1630,7,1630,2.5,0,0,0,3,0,2.0
2160,8,2160,2.0,0,1,0,4,0,1.5
960,6,960,1.5,1,0,0,3,0,1.0
1170,8,1170,2.5,0,0,0,2,0,2.0
2850,7,2850,5.0,1,0,0,6,0,2.0
1020,7,1020,1.0,1,0,0,3,0,1.0
1370,7,1370,1.0,0,0,0,3,0,1.0
1830,7,1460,2.25,0,0,370,3,0,1.0
2350,8,2350,2.5,0,0,0,3,0,2.0
1370,8,1370,1.0,0,0,0,3,0,2.0
1780,7,1290,1.75,0,0,490,3,0,1.0
2960,9,2190,3.25,0,0,770,4,0,2.0
1088,7,1088,1.5,0,0,0,2,0,2.0
1850,8,1850,2.0,0,0,0,4,0,1.0
1810,8,1450,2.25,0,0,360,3,0,1.0
890,6,890,1.0,0,0,0,3,0,1.0
3120,9,3120,2.5,0,0,0,4,0,2.0
1310,7,950,1.0,0,0,360,2,0,1.0
2220,7,2220,2.5,0,0,0,4,0,2.0
1550,7,1050,1.5,0,0,500,4,0,1.0
780,6,780,1.0,0,0,0,2,0,1.0
830,7,830,1.0,0,0,0,2,0,1.0
1170,6,1170,1.0,0,2,0,2,0,1.0
2170,7,1630,2.5,0,0,540,4,0,2.0
1260,8,1260,2.5,0,0,0,3,0,3.0
2090,8,1510,3.25,0,0,580,3,0,1.0
930,8,930,1.0,0,0,0,2,0,1.0
2900,8,1660,2.5,0,0,1240,4,0,1.0
1820,8,1820,2.25,0,0,0,3,0,2.0
3900,12,3900,2.5,0,0,0,2,0,2.0
1200,6,880,2.0,0,0,320,3,0,1.0
1980,7,1980,2.75,0,0,0,4,0,1.0
4150,10,4150,3.5,0,0,0,4,0,2.0
1560,8,1560,1.75,0,0,0,3,0,1.0
1470,7,1470,1.75,0,0,0,3,0,1.0
3560,10,3560,3.5,0,0,0,4,0,2.0
1020,6,1020,1.5,0,0,0,3,0,1.0
1650,7,1100,1.75,0,0,550,3,0,1.0
1190,7,1190,1.5,0,0,0,3,0,1.0
1050,7,1050,1.0,0,0,0,2,0,1.0
3110,11,2040,2.5,0,4,1070,4,0,2.0
1800,7,1800,2.5,0,0,0,4,0,2.0
2630,7,1470,4.0,0,0,1160,4,0,1.0
1860,7,1170,2.5,0,0,690,4,0,1.5
1710,8,1710,2.5,0,0,0,3,0,2.0
2750,8,2750,1.75,0,0,0,6,0,2.0
1480,6,840,1.75,0,0,640,2,0,1.0
1730,7,1380,1.0,0,0,350,2,0,1.0
3210,10,3210,2.5,0,0,0,4,0,2.0
1460,7,1460,1.5,0,0,0,4,0,1.0
1240,7,1240,1.5,0,0,0,3,0,1.0
1850,7,1060,1.75,0,0,790,2,0,1.0
2280,8,2280,2.5,0,0,0,4,0,2.0
3620,8,3220,2.0,1,0,400,3,0,2.0
2830,8,1830,2.75,0,3,1000,3,1,1.0
1160,7,1160,1.0,1,0,0,3,0,1.0
2130,8,2130,2.5,0,0,0,3,0,2.0
2130,8,2130,2.5,0,0,0,4,0,2.0
1460,7,960,1.75,0,0,500,2,0,1.0
1510,7,1510,2.0,0,0,0,3,0,2.0
2580,7,1620,2.75,0,0,960,4,0,1.0
2030,7,1330,1.5,0,0,700,3,0,1.0
2590,9,2590,2.5,0,0,0,4,0,2.0
1880,7,1880,2.0,0,0,0,3,0,2.0
1120,6,1120,1.0,0,0,0,2,0,1.0
2700,8,2100,2.75,0,0,600,4,0,2.0
3148,9,3148,2.5,0,3,0,4,0,2.0
1200,7,950,1.0,0,0,250,3,0,1.0
820,7,820,1.0,0,0,0,2,0,1.0
1630,7,1630,2.0,0,0,0,4,0,1.5
2790,8,2790,2.5,0,0,0,4,0,2.0
1240,7,1150,2.25,0,0,90,2,0,2.0
970,6,970,1.0,0,0,0,2,0,1.0
1160,7,1160,1.5,0,0,0,2,0,2.0
2300,8,1600,2.5,0,2,700,4,0,1.0
1900,8,1220,1.75,0,0,680,3,0,1.0
1350,7,1350,1.0,0,0,0,3,0,1.5
1000,8,1000,1.75,0,0,0,2,0,1.0
790,8,700,1.5,0,0,90,2,0,2.0
2470,7,2470,2.5,0,3,0,4,0,2.0
1590,5,1590,2.75,0,0,0,2,0,1.5
3050,8,1550,2.5,0,0,1500,4,0,1.0
2660,8,1920,3.5,0,0,740,4,0,2.0
1100,7,1100,2.0,0,0,0,2,0,1.5
2380,8,1530,2.25,0,0,850,4,0,2.0
1210,6,1210,1.0,0,0,0,3,0,1.0
740,5,740,1.0,0,0,0,2,0,1.0
3890,8,2390,3.75,0,2,1500,3,0,1.0
1220,7,1220,1.0,0,0,0,3,0,1.0
2170,8,2170,2.5,0,0,0,3,0,2.0
1900,7,1200,1.75,0,0,700,2,0,1.0
1480,7,1480,1.0,0,0,0,3,0,1.5
3590,9,3140,3.5,0,2,450,4,0,2.0
4380,8,2780,3.5,0,0,1600,3,0,2.0
1760,7,1760,1.75,0,0,0,3,0,1.0
2230,8,2230,2.5,0,0,0,4,0,2.0
2420,7,1670,2.75,0,0,750,4,0,1.0
1840,7,1270,2.25,0,0,570,3,0,1.0
1610,7,1190,2.5,0,0,420,3,0,1.0
1710,7,1710,1.75,1,0,0,4,0,1.0
1930,7,1440,2.5,0,3,490,3,0,1.0
1200,7,1200,1.0,0,0,0,3,0,1.5
1500,8,1240,3.5,0,0,260,3,0,2.0
1920,7,1920,2.5,0,2,0,4,0,2.0
4610,11,4610,4.25,0,4,0,5,0,2.0
1860,9,1240,2.5,0,0,620,3,0,2.0
2080,6,2080,1.75,0,0,0,3,0,1.0
1000,7,1000,1.5,1,0,0,3,0,1.0
1890,7,1350,2.25,0,0,540,4,0,1.5
1740,7,1020,1.0,0,0,720,4,0,1.0
2180,7,1420,2.5,0,0,760,4,0,1.5
4200,11,3600,4.0,1,2,600,3,0,2.0
3220,8,3220,2.5,0,0,0,4,0,2.0
1290,7,1290,1.0,0,0,0,2,0,1.5
2220,8,1700,2.25,0,0,520,3,0,1.0
3200,7,2160,2.5,1,0,1040,5,0,1.0
1440,7,1440,1.75,1,0,0,4,0,1.0
1440,7,1440,2.5,0,0,0,3,0,1.0
3050,9,3050,2.5,0,0,0,4,0,2.0
1340,8,1340,2.0,0,0,0,2,0,1.0
1350,7,1350,2.0,0,0,0,3,0,1.0
3130,8,3130,2.5,0,0,0,4,0,2.0
2430,8,1730,2.5,0,0,700,3,0,2.0
2400,7,1450,2.75,0,0,950,5,0,1.0
1160,7,1160,1.5,0,0,0,3,0,1.0
1040,7,860,1.0,0,0,180,3,0,1.0
2630,8,2630,2.5,0,0,0,4,0,2.0
1030,6,1030,1.5,0,0,0,3,0,1.0
5250,10,5250,4.5,0,0,0,4,0,2.0
1020,7,1020,1.0,0,0,0,3,0,1.0
1220,6,1220,1.75,0,0,0,2,0,1.0
1990,8,1990,2.25,0,0,0,4,0,1.0
2710,9,2710,2.5,0,0,0,4,0,2.0
2440,7,2440,2.75,0,1,0,4,0,2.0
2460,9,2460,2.5,0,0,0,3,0,2.0
1660,7,1660,1.75,0,0,0,3,0,2.0
2056,7,2056,2.5,0,0,0,3,0,2.0
2150,7,1290,2.5,0,0,860,4,0,1.5
2100,8,1660,3.0,0,0,440,3,0,2.0
2420,7,1640,2.25,0,0,780,3,0,1.5
2920,7,1800,2.75,0,0,1120,5,0,1.5
1840,8,1840,1.75,0,0,0,3,0,1.0
1790,7,1790,2.0,0,0,0,3,0,1.0
3990,9,2400,3.25,0,0,1590,5,0,2.0
2740,9,2740,2.5,0,0,0,4,0,2.0
1830,7,1830,3.0,0,0,0,4,0,2.0
2190,8,2190,2.75,0,0,0,4,0,2.0
5670,11,5670,4.5,0,2,0,4,0,2.0
2350,8,2000,2.0,0,1,350,6,0,2.0
3870,10,2530,4.5,0,0,1340,4,0,2.0
1230,9,1050,1.25,1,0,180,2,0,2.0
2470,8,2470,3.0,0,0,0,6,0,2.0
720,6,720,1.5,0,0,0,2,0,1.0
1810,8,1440,3.5,0,0,370,3,0,2.0
1680,7,1080,2.5,0,0,600,3,0,1.0
2630,10,2200,3.5,0,0,430,4,0,2.0
1330,8,1330,1.75,0,0,0,3,0,1.0
3000,8,1970,3.0,0,3,1030,4,0,1.5
570,5,570,1.0,0,0,0,1,0,1.0
3040,8,1890,2.25,0,0,1150,6,0,1.0
2970,7,1510,2.5,0,0,1460,3,0,1.0
1550,6,1550,1.0,0,0,0,4,0,1.5
2550,8,2550,2.75,0,0,0,5,0,1.5
1450,6,750,2.0,1,0,700,2,0,1.0
2340,8,1810,1.0,0,0,530,5,0,2.0
4160,12,3690,3.25,1,2,470,3,0,3.0
2168,7,2168,2.0,0,1,0,3,0,2.0
2570,9,2570,2.25,1,0,0,4,0,2.5
3440,10,3440,3.25,1,0,0,4,0,2.0
4080,10,4080,3.5,0,3,0,3,0,1.5
4410,12,3420,3.5,1,2,990,4,0,2.0
2300,8,1300,2.25,0,0,1000,3,0,1.0
2780,8,2780,2.5,0,0,0,5,0,2.0
3630,10,3630,2.75,0,0,0,4,0,2.0
3170,10,2340,3.5,1,0,830,4,0,2.0
1980,7,1280,1.0,0,0,700,3,0,1.0
1330,7,1330,1.5,0,0,0,3,0,1.0
2100,8,1400,2.75,0,0,700,4,0,1.0
2320,8,2320,2.5,0,0,0,4,0,2.0
1090,7,1090,1.0,0,0,0,3,0,1.0
1190,7,1190,1.0,0,0,0,3,0,1.0
4030,10,4030,3.5,0,0,0,4,0,2.0
3740,9,3060,3.0,0,0,680,4,0,2.0
3710,9,2340,2.75,1,3,1370,5,0,1.5
1570,8,1570,2.25,0,0,0,3,0,3.0
1620,7,830,1.75,0,0,790,3,0,1.0
2483,8,2483,3.0,0,0,0,4,0,2.0
1260,7,1260,2.0,0,0,0,3,0,2.0
1160,8,1000,2.25,1,0,160,2,0,2.0
4040,9,2900,2.5,0,0,1140,3,0,2.0
1370,6,1120,1.0,0,0,250,6,0,1.5
1470,7,980,2.5,0,0,490,4,0,2.0
2490,8,2490,2.25,0,0,0,4,0,2.0
910,6,910,1.0,0,0,0,2,0,1.0
1260,6,1260,1.0,0,0,0,3,0,1.0
1200,6,1200,1.0,0,0,0,3,0,1.5
2280,8,2280,2.5,0,0,0,4,0,2.0
2840,7,1420,1.75,0,0,1420,3,0,1.0
2510,8,2510,2.25,1,0,0,5,0,2.0
2160,8,2160,2.5,0,0,0,3,0,2.0
3820,9,2850,2.75,0,0,970,4,0,2.0
2770,9,2770,2.5,0,0,0,4,0,2.0
1670,7,1670,2.5,0,0,0,3,0,2.0
4890,9,3590,3.5,0,0,1300,5,0,2.0
2530,7,1700,2.75,1,0,830,4,0,1.0
2130,8,1530,3.5,0,2,600,3,0,2.0
1910,9,1910,1.75,1,0,0,5,0,2.0
1510,8,1510,1.5,0,0,0,2,0,2.0
1790,7,1050,1.75,0,0,740,4,0,1.0
1230,6,1230,1.75,0,0,0,3,0,1.0
1580,8,1580,2.0,0,0,0,2,0,1.0
2140,7,1620,1.75,0,0,520,3,0,1.5
2290,7,1690,4.0,0,0,600,4,0,1.5
840,6,840,1.0,0,0,0,2,0,1.0
1120,8,760,2.0,0,0,360,2,0,2.0
2720,8,2720,2.5,0,0,0,4,0,2.0
1730,8,1730,2.5,0,0,0,3,0,2.0
3550,7,3550,2.75,1,0,0,5,0,2.0
2130,7,2130,2.25,0,0,0,4,0,1.0
1410,7,740,2.0,0,0,670,3,0,1.0
1140,8,1140,1.0,0,0,0,3,0,1.0
1430,7,1430,1.75,0,0,0,3,0,1.0
1280,7,1280,1.0,0,0,0,3,0,1.0
910,5,910,1.0,0,0,0,2,0,1.0
1370,8,1150,2.0,0,0,220,2,0,2.0
1380,7,1380,2.25,0,0,0,3,0,2.0
2570,9,2570,2.5,0,0,0,4,0,2.0
2689,9,2689,2.5,0,0,0,4,0,2.0
1940,7,1290,1.75,0,0,650,3,0,1.0
2820,8,1920,2.25,0,0,900,4,0,1.0
1480,7,1480,2.5,0,0,0,3,0,2.0
3830,9,3830,3.25,0,0,0,5,0,2.0
2670,10,1720,2.75,0,0,950,3,0,1.0
1800,6,1800,1.75,0,0,0,4,0,1.5
1290,7,1290,1.0,0,0,0,3,0,1.5
2070,7,1340,2.5,0,0,730,5,0,1.0
1800,7,1200,1.5,0,0,600,3,0,1.0
2810,7,1710,2.25,0,1,1100,4,0,1.0
1450,7,1450,2.0,0,0,0,3,0,2.0
850,6,550,0.75,0,2,300,2,0,1.0
2060,7,1190,2.5,0,0,870,4,0,1.0
1170,7,1170,1.0,0,0,0,2,0,1.0
2960,10,2260,2.25,0,3,700,3,0,1.0
3320,8,1660,3.0,0,0,1660,6,0,1.0
2350,8,2350,2.5,0,0,0,4,0,2.0
1700,7,1700,2.5,0,0,0,4,0,2.0
830,6,830,1.0,0,0,0,2,0,1.0
1670,7,1100,2.0,0,0,570,3,0,1.0
1010,6,1010,1.75,0,0,0,1,0,1.0
1020,6,780,1.0,0,0,240,3,0,1.0
1180,10,780,1.75,0,0,400,2,0,2.0
1680,8,1120,2.5,0,0,560,2,0,2.0
5270,10,4010,3.25,1,1,1260,5,0,2.0
3700,11,2620,2.5,1,4,1080,4,0,1.0
2400,8,2400,2.5,0,0,0,4,0,2.0
2350,8,1810,2.0,1,0,540,3,0,1.5
810,6,810,1.0,0,0,0,2,0,1.0
2390,7,1290,2.75,0,0,1100,5,0,1.0
2630,8,2630,2.5,0,0,0,4,0,2.0
2680,8,2680,2.5,0,0,0,3,0,2.0
1900,8,1900,2.5,0,0,0,2,0,2.0
2900,8,2900,2.75,0,0,0,5,0,2.0
2480,8,2480,3.0,0,0,0,6,0,2.0
1780,8,1450,2.25,0,0,330,3,0,1.0
4040,10,4040,2.5,0,0,0,4,0,2.0
2870,9,2070,3.5,0,3,800,4,0,2.0
1250,7,1250,2.0,0,0,0,3,0,3.0
1370,8,1370,3.25,0,0,0,3,0,3.0
1850,8,1320,1.75,0,0,530,3,0,1.0
1430,7,1430,2.0,0,0,0,3,0,1.0
2080,7,2080,2.5,0,0,0,3,0,1.0
2440,10,2440,2.5,0,0,0,3,0,2.0
2620,9,2620,2.75,0,0,0,5,0,2.0
1020,7,1020,1.0,0,0,0,3,0,1.0
1990,8,1990,2.5,0,0,0,3,0,2.0
1300,7,1300,1.0,0,0,0,2,0,1.0
790,6,790,1.0,0,0,0,3,0,1.0
2760,9,2760,2.75,0,0,0,5,0,2.0
1290,7,950,2.0,0,0,340,2,0,1.0
3670,9,1950,1.75,1,2,1720,3,0,1.0
1720,7,1720,2.5,0,0,0,3,0,2.0
3130,9,3130,2.5,0,0,0,4,0,2.0
1390,7,1390,1.0,0,0,0,3,0,1.0
2140,8,1960,2.5,0,0,180,3,0,2.0
1710,8,1140,2.5,0,0,570,3,0,2.0
1489,7,1489,2.5,0,0,0,3,0,2.0
1050,8,960,1.5,0,0,90,2,0,2.0
2760,9,2120,3.5,0,0,640,3,0,2.0
1150,6,1150,1.0,0,0,0,4,0,1.5
2440,8,2440,2.5,0,0,0,4,0,2.0
3847,9,2299,2.75,0,2,1548,5,0,1.0
1820,7,1000,3.0,0,0,820,4,0,1.0
1260,7,1260,1.5,1,0,0,3,0,2.0
1020,8,1020,1.5,0,0,0,2,0,3.0
1150,7,860,2.0,0,0,290,2,0,1.0
1030,7,1030,1.0,0,0,0,3,0,1.0
1100,7,1100,1.0,0,0,0,3,0,1.0
1180,6,1180,1.0,0,0,0,3,0,1.5
1000,7,1000,1.0,0,0,0,3,0,1.0
850,6,850,1.0,0,0,0,1,0,1.0
3020,10,2230,3.5,1,0,790,5,0,2.0
1480,7,1480,1.0,0,0,0,3,0,1.0
4200,10,4200,3.25,0,0,0,4,0,2.0
1860,7,1080,1.5,0,0,780,4,0,1.0
4310,10,3140,3.5,0,2,1170,3,0,2.0
2120,8,1770,2.5,0,0,350,3,0,2.0
1510,7,1230,2.0,0,2,280,3,0,1.0
1610,8,1610,1.75,0,0,0,3,0,1.0
1670,7,1670,1.75,0,0,0,2,0,1.0
1030,6,1030,1.0,0,0,0,2,0,1.0
1500,8,1220,2.25,0,0,280,3,0,2.0
2390,8,1450,2.75,0,0,940,3,0,1.0
3760,9,2950,3.5,0,0,810,4,0,2.0
1820,8,1820,2.25,0,0,0,3,0,2.0
2530,7,1210,2.25,0,0,1320,4,0,1.0
1970,8,1970,1.75,0,0,0,3,0,1.0
1450,7,1450,2.0,0,0,0,4,0,1.0
1410,8,1410,1.5,0,0,0,3,0,1.0
1310,6,1160,1.0,0,0,150,4,0,1.5
2700,8,2700,2.75,0,0,0,4,0,2.0
3000,8,3000,2.0,0,2,0,1,0,2.5
2860,8,2160,2.5,0,0,700,5,0,2.0
860,6,860,2.0,0,0,0,2,0,1.0
1710,8,1110,2.5,0,0,600,4,0,1.0
1730,7,1400,1.75,0,0,330,3,0,1.0
4240,10,4240,4.5,1,0,0,4,0,2.0
1850,8,1660,1.5,1,0,190,4,0,2.0
1760,7,880,1.75,0,0,880,4,0,1.0
1340,7,1340,2.0,0,0,0,3,0,1.5
3890,10,3890,3.75,0,0,0,4,0,2.0
990,7,990,1.0,0,0,0,2,0,2.0
2870,8,1790,2.0,0,1,1080,3,0,1.5
1430,7,1190,2.5,0,0,240,3,0,1.0
4240,10,3550,3.25,0,3,690,4,0,2.0
1240,7,1150,2.25,0,0,90,2,0,2.0
1790,7,1790,2.5,0,0,0,4,0,2.0
1040,7,870,1.5,0,0,170,2,0,1.0
1760,7,1760,1.5,0,0,0,4,0,1.5
5360,9,3270,3.5,0,0,2090,4,0,1.0
1750,7,1490,2.0,0,0,260,3,0,1.0
2170,9,1550,2.75,0,0,620,3,0,1.5
2730,8,1670,3.0,0,0,1060,5,0,1.0
1230,7,1230,1.0,0,0,0,3,0,1.0
2550,9,2550,2.5,0,0,0,4,0,2.0
1590,6,1590,1.75,0,0,0,3,0,1.5
1440,6,720,1.0,0,0,720,3,0,1.0
1060,7,1060,1.0,0,0,0,3,0,1.0
2340,6,2340,2.0,0,0,0,4,0,1.5
1220,7,1220,1.5,0,0,0,3,0,1.5
2780,8,2780,2.5,0,0,0,4,0,2.0
2620,9,2620,2.5,0,0,0,4,0,2.0
1240,7,1240,2.0,0,0,0,3,0,1.0
1600,8,1360,3.25,0,0,240,3,0,2.0
1400,5,1400,1.75,0,0,0,5,0,1.0
1120,6,1120,1.0,0,0,0,2,0,1.5
1110,6,740,1.0,0,0,370,2,0,1.0
1700,7,1130,1.5,1,0,570,3,0,1.0
2400,8,2400,2.5,0,0,0,4,0,2.0
2890,8,1790,2.25,0,4,1100,3,0,2.0
1810,7,1110,2.0,0,0,700,4,0,1.0
4670,11,4670,2.5,0,0,0,5,0,2.0
1830,7,1010,1.75,0,2,820,3,0,1.0
2210,7,1510,2.25,0,0,700,3,0,1.0
960,6,960,1.0,1,1,0,2,0,1.0
1090,8,960,2.5,0,0,130,3,0,2.0
1930,8,1430,1.75,0,2,500,2,0,1.0
2710,9,2710,2.75,0,0,0,4,0,2.0
2240,7,1490,2.25,0,0,750,5,0,1.0
770,6,670,1.0,0,0,100,3,0,1.0
1460,7,1460,1.75,0,0,0,3,0,1.0
2760,8,1760,3.0,0,0,1000,4,0,1.0
1730,7,1010,2.0,0,0,720,4,0,1.0
1070,8,1070,1.5,0,0,0,2,0,3.0
1410,7,1290,2.25,0,0,120,3,0,2.0
1220,6,1220,1.0,0,0,0,3,0,1.0
3480,8,3480,3.0,1,0,0,5,0,2.0
1400,6,1100,1.75,0,2,300,3,0,1.0
3350,10,2260,4.25,0,0,1090,5,0,2.0
1490,7,1490,1.75,1,0,0,3,0,1.0
1740,8,1740,2.25,0,0,0,4,0,1.0
2030,7,2030,1.75,0,0,0,5,0,2.0
1880,8,1880,2.25,0,0,0,4,0,2.0
670,5,670,1.0,0,0,0,2,0,1.0
1020,6,1020,1.0,0,0,0,4,0,1.5
3350,9,2640,2.5,0,0,710,4,0,2.0
2540,8,1760,2.5,0,0,780,5,0,2.0
3290,9,3290,2.5,0,0,0,4,0,2.0
1720,7,1720,2.5,0,0,0,3,0,2.0
1380,7,1380,1.0,0,0,0,3,0,1.0
2300,9,2300,2.75,0,0,0,4,0,2.0
1180,7,1180,1.0,0,0,0,2,0,1.0
2960,9,2960,2.5,0,0,0,4,0,2.0
2530,8,2530,2.5,0,0,0,3,0,2.0
1590,7,1590,1.75,0,0,0,2,0,1.0
1120,6,1120,1.0,0,0,0,3,0,1.0
4410,11,4410,4.0,0,0,0,5,0,2.0
1620,7,1620,2.5,0,0,0,2,0,2.0
810,7,810,1.0,0,0,0,3,0,1.0
3120,9,3120,2.5,0,0,0,4,0,2.0
3370,7,3200,2.5,0,0,170,3,0,2.0
1960,8,1600,2.25,0,0,360,3,0,1.0
790,6,790,1.0,0,0,0,2,0,1.0
940,6,940,1.0,0,0,0,2,0,1.0
1210,6,1210,1.5,0,0,0,3,0,1.0
1230,7,1230,2.0,0,0,0,3,0,1.0
1400,7,1400,1.0,0,0,0,3,0,1.0
2150,8,1610,3.5,0,0,540,3,0,2.0
1490,8,1490,1.75,0,0,0,3,0,1.0
4050,7,4050,7.5,0,0,0,9,0,2.0
1230,7,1230,1.0,1,0,0,3,0,1.0
2880,10,2880,2.5,0,0,0,3,0,2.0
950,7,950,1.0,0,0,0,3,0,1.0
3490,10,2320,1.75,1,3,1170,2,0,1.0
1810,8,1350,1.5,0,1,460,4,0,1.0
960,7,960,1.0,0,0,0,2,0,1.0
1590,7,1590,1.5,0,3,0,4,0,1.0
2960,9,2210,2.75,0,3,750,4,0,2.0
3830,11,3830,2.5,1,0,0,3,0,2.0
2980,9,2150,3.25,1,0,830,4,0,2.0
2170,9,1610,3.0,1,0,560,4,0,2.0
1780,7,1210,1.75,0,0,570,3,0,1.0
1430,6,1010,1.0,0,0,420,3,0,1.5
1820,7,1150,1.75,0,0,670,4,0,1.0
1990,10,1990,2.5,0,0,0,4,0,2.0
2990,8,2990,2.5,0,0,0,3,0,2.0
1020,7,1020,1.0,0,0,0,3,0,1.0
710,6,710,1.0,0,0,0,2,0,1.0
2430,8,2430,2.5,0,0,0,4,0,2.0
2040,7,1360,1.75,0,0,680,3,0,2.0
2610,8,2130,1.75,0,2,480,3,0,2.0
1750,8,1440,1.5,0,0,310,2,0,1.5
2190,8,2190,2.25,0,0,0,4,0,2.0
1380,7,1380,2.0,0,0,0,5,0,1.5
2480,9,2480,2.5,0,0,0,3,0,2.0
1370,9,1370,1.75,0,0,0,3,0,3.0
1170,7,1170,2.0,0,0,0,3,0,1.0
1990,8,1990,2.5,0,0,0,3,0,2.0
2140,8,2140,2.5,0,0,0,4,0,2.0
2130,7,1330,1.75,0,3,800,3,0,1.0
1510,7,1510,1.0,0,0,0,3,0,1.0
1640,7,1140,1.0,1,0,500,2,0,1.0
2160,9,2160,2.5,0,0,0,4,0,2.5
1740,8,1740,2.5,0,0,0,3,0,2.0
2180,7,1290,1.75,0,0,890,4,0,1.0
2110,6,2110,3.0,0,0,0,3,0,1.0
2340,9,2340,2.5,0,0,0,4,0,2.0
2960,7,1480,2.5,0,0,1480,5,0,1.0
780,7,780,1.0,0,0,0,2,0,2.0
2060,7,2060,1.5,0,0,0,2,0,1.5
1520,7,1180,3.0,0,0,340,3,0,1.0
1190,7,1190,2.0,0,0,0,4,0,1.5
1190,8,1190,1.5,0,0,0,2,0,3.0
710,7,710,1.0,0,0,0,2,0,2.0
2390,9,2390,2.5,0,0,0,4,0,2.0
2440,8,1840,2.75,0,0,600,3,0,2.0
1010,6,1010,1.0,0,0,0,2,0,1.0
1220,7,1220,2.0,0,0,0,3,0,1.0
1400,7,1400,1.75,0,0,0,3,0,1.0
3270,9,3270,2.5,0,0,0,4,0,2.0
2160,8,1390,1.75,0,0,770,3,0,1.0
2600,8,1400,2.0,0,2,1200,4,0,1.0
1120,8,820,2.5,0,0,300,3,0,2.0
1900,7,1300,2.25,0,0,600,3,0,1.0
2590,8,2590,2.5,0,0,0,3,0,2.0
2110,8,1410,1.75,0,3,700,4,0,1.0
1350,7,950,1.0,0,0,400,3,0,1.0
1150,7,1150,1.0,0,0,0,2,0,1.0
2050,9,2050,2.5,0,0,0,3,0,2.0
1240,7,1240,1.75,0,0,0,2,0,1.0
3691,8,3691,2.5,0,1,0,4,0,2.0
3540,10,3540,3.5,0,0,0,4,0,2.0
1050,8,960,1.5,0,0,90,2,0,2.0
1530,7,1040,1.75,0,0,490,3,0,1.0
940,7,940,1.0,1,0,0,3,0,1.0
1510,7,1510,2.0,0,0,0,3,0,2.0
4270,10,2680,2.5,0,0,1590,4,0,1.0
1572,8,1572,2.5,0,0,0,3,0,2.0
1090,7,1090,2.5,0,0,0,2,0,2.0
2290,7,2150,1.0,0,4,140,4,0,1.5
3740,10,3740,3.0,0,2,0,3,0,2.0
2870,9,1350,2.0,0,0,1520,3,0,1.0
2980,7,2070,4.0,0,0,910,5,0,1.5
1030,7,1030,1.0,0,0,0,3,0,1.0
1580,7,1580,2.5,0,0,0,3,0,2.0
1610,7,1610,2.25,0,0,0,3,0,2.0
1920,7,1160,1.0,0,0,760,5,0,1.0
3650,10,2050,3.5,0,0,1600,3,0,1.0
1390,7,1050,1.0,0,0,340,4,0,1.0
1680,7,1180,2.25,0,0,500,3,0,1.0
2340,8,1730,3.5,0,2,610,4,0,2.0
790,6,790,1.0,0,0,0,2,0,1.0
1350,8,1050,2.25,0,0,300,3,0,2.0
1550,8,1550,2.25,0,0,0,3,0,2.0
1590,7,1090,1.75,0,0,500,3,0,1.0
1760,7,980,2.0,0,0,780,3,0,1.0
1090,6,1090,1.0,0,0,0,3,0,1.0
1990,7,1340,2.75,0,0,650,3,0,1.0
1020,6,1020,1.0,0,0,0,3,0,1.0
2070,8,1370,2.5,1,0,700,4,0,1.0
1250,7,1250,1.75,0,0,0,3,0,1.5
2190,7,1110,2.0,0,0,1080,5,0,1.0
1870,7,1250,2.5,0,0,620,3,0,1.0
1660,7,1660,1.5,0,0,0,4,0,1.0
1040,6,1040,1.5,0,0,0,3,0,1.0
1350,8,1350,2.0,0,0,0,2,0,3.0
2550,7,2550,2.5,0,0,0,4,0,2.0
2630,8,2630,2.25,0,0,0,5,0,2.0
1550,8,1550,2.25,0,0,0,4,0,2.0
2590,9,2590,3.25,1,2,0,5,0,1.0
4130,11,4130,3.75,0,0,0,4,0,2.0
2110,8,2110,3.25,0,0,0,4,0,2.0
2310,9,2310,2.5,0,0,0,4,0,2.0
2910,8,2910,2.75,0,0,0,4,0,2.0
2580,9,2580,2.5,0,0,0,3,0,2.0
2250,8,1510,2.25,0,0,740,3,0,2.0
2600,7,2600,2.5,0,0,0,5,0,2.0
3170,9,3170,2.5,0,0,0,4,0,2.0
1390,6,790,1.75,0,0,600,2,0,1.0
1770,6,1770,2.0,0,0,0,4,0,1.0
2245,8,2245,2.5,0,0,0,4,0,2.0
1510,7,1120,1.5,0,0,390,3,0,1.0
1833,9,1833,3.0,0,0,0,3,0,3.0
2170,7,1220,2.25,0,0,950,4,0,1.0
3000,8,3000,2.5,0,0,0,4,0,2.0
3010,8,3010,2.5,0,0,0,4,0,2.0
2090,7,2090,1.75,0,0,0,3,0,1.0
1010,8,1010,1.5,0,0,0,3,0,2.0
2890,8,2890,2.5,0,0,0,4,0,2.0
2100,7,1340,1.75,0,0,760,4,0,1.0
1980,7,1330,1.75,0,0,650,4,0,1.0
700,7,700,1.0,0,0,0,2,0,1.0
2090,7,2090,2.5,0,0,0,3,0,2.0
1480,7,1080,1.0,0,0,400,4,0,1.0
2590,8,2590,2.5,0,0,0,4,0,2.0
1080,6,1080,1.0,0,0,0,3,0,1.0
2440,8,2440,3.5,0,1,0,4,0,3.0
1640,7,1190,1.75,0,0,450,3,0,1.0
2520,7,1510,2.25,0,0,1010,4,0,1.5
1630,7,930,1.0,0,0,700,3,0,1.0
2360,8,2360,2.25,0,0,0,4,0,2.0
2380,8,2380,2.25,0,0,0,4,0,2.0
2720,8,2720,2.5,0,0,0,3,0,2.0
1640,7,1140,2.25,0,0,500,3,0,1.0
1840,10,1700,2.75,0,0,140,3,0,2.0
1770,7,1770,2.5,0,0,0,3,0,2.0
1470,6,1470,1.5,0,0,0,3,0,2.0
1560,7,1560,2.5,0,0,0,3,0,2.0
3270,10,2000,2.25,1,0,1270,4,0,1.0
2150,8,2150,2.5,0,0,0,3,0,2.0
2940,8,2940,4.5,0,0,0,6,0,1.5
3080,9,3080,3.5,0,0,0,4,0,2.0
1010,7,1010,1.0,0,0,0,3,0,1.0
960,6,960,1.0,0,0,0,2,0,1.0
2690,9,1720,3.25,0,3,970,4,0,2.0
1390,7,1390,1.5,0,0,0,3,0,1.0
1200,7,600,2.0,0,0,600,2,0,1.0
1370,7,1370,1.5,0,0,0,3,0,1.0
2190,7,1190,1.75,0,2,1000,5,0,1.0
2790,9,2790,2.5,0,0,0,4,0,2.0
2760,8,2760,3.5,0,0,0,5,0,2.5
3430,8,3430,2.75,0,0,0,4,0,1.5
3170,10,3170,2.75,0,0,0,4,0,2.0
940,7,940,1.0,0,0,0,3,0,1.0
730,4,730,1.0,0,1,0,2,0,1.0
1930,6,1930,2.0,0,0,0,5,0,1.5
1480,6,1120,1.0,0,0,360,3,0,1.5
1810,9,930,1.75,1,4,880,3,0,1.0
1470,6,1470,2.0,0,0,0,3,0,1.0
3540,9,3540,2.0,0,3,0,5,0,2.0
1560,7,1560,3.25,0,0,0,4,0,1.0
1460,7,1460,1.0,0,0,0,3,0,1.0
2800,8,2800,3.0,0,0,0,4,0,2.0
2190,8,2190,1.75,0,0,0,4,0,2.0
1470,7,1160,2.25,0,0,310,3,0,1.0
2590,7,1750,1.75,0,0,840,5,0,1.0
1340,8,1340,2.0,0,0,0,2,0,2.0
2230,8,1430,2.25,0,0,800,3,0,1.0
2790,8,2790,3.5,1,0,0,4,0,1.5
2260,7,1130,2.0,0,0,1130,4,0,1.0
2420,7,1210,2.0,0,0,1210,3,0,1.0
2320,8,1620,2.5,1,0,700,3,0,2.0
2240,7,2240,3.0,0,0,0,3,0,2.0
2470,9,2470,2.5,0,0,0,4,0,2.0
3310,9,2380,3.25,0,0,930,4,0,2.0
1900,7,1900,1.75,0,0,0,4,0,1.0
1810,7,1810,1.75,0,0,0,3,0,1.0
2550,8,2550,2.5,0,0,0,3,0,2.0
540,5,540,1.0,0,0,0,1,0,1.0
1270,7,1270,1.75,0,0,0,3,0,1.0
2820,11,2820,2.5,0,0,0,3,0,2.0
1480,7,1480,1.75,0,0,0,3,0,1.0
2160,7,2160,2.5,0,0,0,4,0,2.0
2140,7,2140,2.25,0,0,0,4,0,2.0
1540,7,1540,2.0,0,0,0,3,0,1.0
3760,11,3760,3.5,0,0,0,4,0,2.0
1330,7,1330,1.75,1,0,0,3,0,1.0
650,5,650,0.75,0,0,0,2,0,1.0
2370,9,2370,2.5,0,0,0,3,0,2.0
3110,9,3110,2.5,0,0,0,3,0,2.0
3180,9,2070,3.0,0,0,1110,4,0,2.0
2160,7,2160,1.0,0,0,0,3,0,1.5
770,7,770,1.0,0,0,0,2,0,1.0
2290,7,1690,1.75,0,2,600,4,0,1.5
3010,9,3010,2.5,0,0,0,4,0,2.0
3720,10,3720,4.5,0,0,0,4,0,2.0
2000,7,2000,2.75,0,0,0,4,0,2.0
1990,8,1990,2.5,0,0,0,4,0,2.0
2040,8,1740,1.75,0,0,300,3,0,1.5
2910,9,2120,2.75,0,2,790,4,0,1.0
2840,7,1620,2.5,0,0,1220,5,0,1.0
2490,9,2490,2.5,0,0,0,4,0,2.0
2130,8,1210,2.5,0,0,920,3,0,1.0
1690,7,1210,1.5,0,0,480,3,0,1.0
1400,6,1100,1.75,0,0,300,3,0,1.5
790,6,790,1.0,0,0,0,2,0,1.0
2950,9,2950,2.5,0,0,0,4,0,2.0
1530,7,1020,1.75,0,2,510,3,0,1.0
2260,9,2260,2.0,0,0,0,4,0,1.0
1640,7,1640,2.0,0,0,0,4,0,1.0
1440,7,1440,1.75,0,0,0,3,0,1.0
1670,7,1670,1.5,0,0,0,3,0,1.0
1800,7,1800,1.5,0,0,0,3,0,1.0
2310,8,1310,2.75,1,0,1000,4,0,1.0
1710,7,1040,2.25,0,0,670,4,0,1.0
1870,7,1870,2.0,0,0,0,4,0,1.5
1900,6,950,2.0,0,0,950,4,0,1.0
870,7,820,1.0,0,0,50,2,0,1.0
1580,7,1580,2.25,0,0,0,3,0,1.0
1440,7,1440,2.25,0,0,0,3,0,2.0
2600,8,2600,1.75,1,0,0,4,0,1.5
1250,7,1250,1.0,0,0,0,2,0,1.0
1540,8,1540,1.75,0,0,0,3,0,1.0
1630,7,1630,1.0,1,0,0,3,0,1.0
1070,7,1070,1.75,0,0,0,3,0,1.0
3410,8,2130,2.75,0,0,1280,7,0,1.5
2710,8,2710,2.75,0,0,0,5,0,2.0
3750,10,3750,3.25,0,0,0,4,0,2.0
3540,9,3540,2.5,1,0,0,4,0,2.0
2420,9,2420,2.5,1,0,0,4,0,1.0
1860,8,1860,2.5,0,0,0,3,0,2.0
1230,8,1230,2.25,0,0,0,2,0,3.0
3700,11,3700,3.5,1,0,0,4,0,2.0
2800,7,1400,2.5,0,0,1400,6,0,1.0
1660,7,1660,1.0,0,0,0,3,0,1.0
1760,7,1760,2.0,0,0,0,4,0,1.5
4930,12,4930,4.25,0,0,0,4,0,2.0
2490,8,1790,3.0,0,3,700,3,0,2.0
1440,7,1440,2.5,0,0,0,3,0,2.0
1140,6,990,1.0,0,0,150,2,0,1.0
1990,8,1990,2.25,1,0,0,4,0,2.0
2068,7,2068,2.5,0,0,0,4,0,2.0
3830,9,3830,3.75,0,0,0,3,0,2.0
2840,8,2840,3.5,0,0,0,4,0,3.0
2100,8,1280,1.75,0,0,820,4,0,1.0
1904,7,1904,2.5,0,0,0,4,0,2.0
1330,8,1140,1.5,0,0,190,3,0,2.0
2090,7,1290,2.25,0,0,800,3,0,1.0
1570,8,1260,3.25,0,0,310,3,0,2.0
1040,6,1040,1.0,0,0,0,2,0,1.0
880,6,880,1.0,0,0,0,3,0,1.0
5210,10,4940,3.25,0,4,270,5,0,2.5
3310,10,3310,4.0,1,0,0,5,0,2.0
2040,8,2040,1.75,0,0,0,3,0,1.0
1510,7,1510,1.75,0,0,0,3,0,1.0
790,6,790,1.0,0,0,0,2,0,1.0
720,6,720,1.0,0,0,0,2,0,1.0
1250,7,950,1.0,0,0,300,2,0,1.0
1650,7,1650,2.5,0,0,0,3,0,2.0
2110,7,1110,3.0,0,2,1000,3,0,1.0
1850,7,1100,1.75,0,0,750,3,0,1.0
1960,7,1960,1.5,0,2,0,4,0,1.5
1250,7,830,2.75,0,0,420,3,0,2.0
5960,10,4770,3.5,0,2,1190,5,0,2.0
1450,7,950,1.75,0,0,500,4,0,1.0
3330,10,3330,2.5,1,0,0,4,0,2.0
2780,10,2780,2.5,0,0,0,4,0,2.0
1250,7,1250,1.75,0,0,0,5,0,1.0
2920,8,1850,1.75,0,0,1070,3,0,1.0
2550,7,2550,2.25,0,0,0,6,0,2.0
2110,8,2110,2.5,0,0,0,4,0,2.0
780,6,780,1.0,0,0,0,2,0,1.0
860,6,860,1.0,0,0,0,2,0,1.0
1340,7,1340,1.5,0,0,0,3,0,1.0
3330,10,3330,2.25,0,0,0,3,0,2.0
2080,8,1220,2.5,0,2,860,4,0,1.0
2300,8,2300,2.5,0,0,0,3,0,1.0
1040,7,1040,1.0,0,0,0,2,0,1.0
2350,7,1250,1.75,0,0,1100,4,0,1.0
2980,10,2140,3.25,0,3,840,4,0,2.0
1980,7,1030,1.0,0,0,950,3,0,1.0
1180,7,1180,1.0,0,0,0,3,0,1.5
2850,8,2370,3.25,0,0,480,5,0,2.0
1890,7,1460,1.75,0,0,430,3,0,1.0
1750,7,1750,2.5,0,0,0,4,0,2.0
3140,9,2570,2.5,0,1,570,4,0,1.0
3240,8,3240,2.5,0,0,0,3,0,2.0
2170,7,1410,2.5,0,0,760,3,0,1.0
3320,11,2950,3.25,0,0,370,4,0,3.0
1620,7,1620,1.0,0,0,0,4,0,1.0
1820,8,1820,1.75,0,0,0,3,0,1.0
2000,7,1250,1.0,0,0,750,4,0,1.5
1400,7,1400,1.5,0,0,0,3,0,1.0
720,7,720,1.0,0,0,0,1,0,1.0
1630,7,930,1.75,0,0,700,4,0,1.0
1270,7,1270,1.0,0,0,0,4,0,1.5
1870,7,1870,1.5,0,0,0,4,0,2.0
1730,7,1430,1.0,0,0,300,3,0,1.0
3550,8,1830,2.25,1,0,1720,4,0,1.0
720,6,720,1.0,0,0,0,1,0,1.0
800,7,800,1.0,0,0,0,2,0,1.0
1510,7,980,1.75,0,0,530,3,0,1.0
2560,8,1760,2.25,0,0,800,4,0,1.0
2450,9,1630,1.75,1,2,820,4,0,1.0
930,6,930,0.75,0,0,0,1,0,1.0
1310,6,1310,1.75,0,0,0,3,0,1.0
1950,7,1150,1.75,0,4,800,4,1,1.0
1250,7,1250,1.0,0,0,0,3,0,1.0
1350,7,1350,1.0,1,0,0,3,0,1.0
1210,7,1210,1.75,0,0,0,3,0,1.0
1540,7,1540,3.0,0,0,0,4,0,1.5
1040,6,800,1.0,0,0,240,3,0,1.0
1880,7,1010,1.75,0,0,870,4,0,1.0
5430,10,5430,3.0,0,0,0,4,0,2.0
3460,7,2860,3.75,0,0,600,8,0,2.0
940,6,940,1.0,0,0,0,3,0,1.0
1240,7,1240,1.5,1,0,0,3,0,1.0
4040,9,3220,4.5,0,0,820,4,0,2.0
2460,7,1450,1.75,0,0,1010,4,0,1.5
2900,10,2900,3.0,0,0,0,3,0,2.0
1270,8,1270,1.5,0,0,0,3,0,3.0
1570,7,1570,2.0,0,0,0,4,0,1.0
3980,9,3980,2.75,0,2,0,4,0,2.0
1650,8,1650,1.75,0,0,0,3,0,3.0
790,6,790,1.0,0,0,0,2,0,1.0
2430,8,2430,3.0,0,0,0,4,0,2.0
1060,6,1060,1.0,0,0,0,2,0,1.0
2940,8,1690,3.0,0,0,1250,7,0,1.0
1110,7,1110,1.0,1,0,0,3,0,1.0
3160,8,3160,3.25,1,0,0,5,0,2.0
1670,8,1670,1.75,0,2,0,3,0,1.0
2010,7,2010,2.5,0,0,0,3,0,2.0
1790,7,1790,2.0,0,2,0,4,0,2.0
4690,9,3040,4.0,1,0,1650,5,0,2.0
970,6,970,2.0,0,0,0,2,0,1.0
4640,10,3210,3.5,0,2,1430,4,0,2.0
1460,7,1460,2.0,0,0,0,3,0,1.0
1460,7,940,2.0,0,0,520,3,0,1.0
1020,7,1020,1.0,0,0,0,3,0,1.0
2370,8,1620,2.5,0,3,750,3,0,1.0
3220,8,3220,2.5,0,0,0,5,0,2.0
1330,7,1330,1.75,0,0,0,3,0,1.0
2830,9,2830,2.5,0,0,0,3,0,2.0
2650,7,2650,2.5,0,0,0,4,0,2.0
880,7,880,1.0,0,0,0,2,0,1.0
1490,6,1490,1.5,0,0,0,3,0,1.0
1400,6,1400,1.5,0,0,0,3,0,1.0
2200,7,1270,1.75,0,0,930,3,0,1.0
2470,7,2470,2.5,0,0,0,4,0,1.0
2730,9,2730,2.25,0,0,0,3,0,2.0
2290,7,2290,3.0,0,0,0,6,0,2.0
1740,7,1740,2.5,0,0,0,4,0,2.0
1100,7,1100,1.0,0,0,0,3,0,1.0
710,6,710,1.0,0,0,0,2,0,1.0
880,6,880,1.0,0,0,0,3,0,1.0
1280,6,1280,1.5,0,0,0,3,0,2.0
1050,7,1050,1.75,0,0,0,3,0,1.0
960,7,960,1.75,0,0,0,3,0,1.0
3360,9,3360,1.5,0,0,0,5,0,2.0
1490,7,1140,1.75,1,0,350,3,0,1.0
1400,6,1400,1.5,0,0,0,3,0,1.0
3370,8,2840,2.5,0,2,530,3,0,2.0
1150,6,1150,1.5,0,0,0,3,0,1.0
2650,9,2650,2.5,0,0,0,4,0,2.0
1212,7,1212,2.5,0,0,0,3,0,3.0
1160,7,1160,1.0,0,0,0,1,0,1.0
3660,9,2840,3.5,0,0,820,4,0,2.0
1740,7,1740,2.75,0,3,0,3,0,1.0
1140,6,1140,1.0,1,0,0,2,0,1.5
3050,8,1800,1.75,0,0,1250,4,0,1.0
1960,7,1670,2.5,0,0,290,3,0,2.0
1110,7,1110,1.5,0,0,0,2,0,1.0
1650,8,1650,1.75,0,0,0,4,0,1.0
1070,7,1070,1.0,0,0,0,2,0,1.0
1490,8,1490,1.75,0,0,0,3,0,1.0
2510,9,2510,2.25,0,0,0,5,0,1.0
1420,7,820,1.75,0,0,600,3,0,1.0
4680,10,3360,3.5,1,0,1320,4,0,2.0
3160,8,2100,2.75,0,0,1060,4,0,1.5
2300,8,2300,2.75,0,0,0,3,0,2.0
3010,8,2560,3.0,0,4,450,4,0,2.0
2740,9,2740,2.0,0,2,0,3,0,1.0
1600,7,1600,1.75,1,0,0,3,0,1.0
1450,8,1450,2.5,0,0,0,3,0,1.0
2190,8,1430,2.5,1,0,760,4,0,1.0
1470,8,1200,1.0,0,0,270,3,0,1.0
2660,7,1670,3.0,0,0,990,5,0,1.5
3520,9,3520,2.75,0,0,0,4,0,2.0
2520,8,2520,1.5,0,0,0,3,0,1.0
2430,10,2430,1.75,0,4,0,2,0,1.0
1760,7,1760,2.25,0,0,0,4,0,2.0
2250,8,2250,2.5,0,0,0,3,0,2.0
2890,7,1310,3.75,0,0,1580,5,0,1.0
2400,7,2400,3.0,0,0,0,3,0,2.0
1640,7,1640,2.5,0,0,0,3,0,2.0
2100,6,2100,2.5,0,0,0,4,0,1.5
3160,10,2180,3.25,0,2,980,5,0,2.0
2200,7,1100,1.75,0,0,1100,2,0,1.0
2510,9,2510,2.5,0,0,0,4,0,2.0
1540,7,770,2.25,0,0,770,3,0,1.0
890,7,890,1.0,0,0,0,3,0,1.0
2600,8,1810,2.25,0,0,790,4,0,1.0
950,6,950,1.0,0,0,0,1,0,1.5
670,3,670,0.0,0,0,0,1,0,1.0
1130,7,1130,1.0,0,0,0,2,0,1.0
1540,7,1070,1.75,0,0,470,3,0,1.0
1330,7,1330,1.5,0,0,0,3,0,1.0
1160,5,580,2.0,0,0,580,3,0,1.0
4280,9,3900,2.75,1,0,380,4,0,2.0
2160,8,2160,2.5,0,0,0,4,0,2.0
1650,8,1290,2.5,0,0,360,3,0,1.0
1700,8,1700,2.5,0,0,0,3,0,2.0
1320,8,1320,2.0,0,0,0,3,0,2.0
2160,7,2160,2.5,0,0,0,4,0,2.0
1340,8,1340,2.5,0,0,0,3,0,2.0
2760,7,1380,2.0,0,0,1380,5,0,1.0
1930,7,1300,1.75,0,2,630,3,0,1.0
1160,7,1160,1.0,0,0,0,3,0,1.0
1800,7,1420,1.75,0,0,380,2,0,1.0
1500,7,1060,2.5,0,0,440,3,0,1.0
1410,8,1090,2.5,0,0,320,2,0,2.0
2110,7,2110,2.5,0,0,0,4,0,2.0
1606,8,1606,2.25,0,0,0,3,0,3.0
2090,7,2090,2.0,0,1,0,2,0,2.0
1470,8,1470,2.5,0,0,0,3,0,3.0
3970,10,2180,2.75,0,0,1790,6,0,1.0
820,5,820,1.0,0,0,0,2,0,1.0
770,7,770,1.0,0,0,0,2,0,1.0
1060,8,940,2.25,0,0,120,2,0,2.0
1570,7,1570,1.5,0,0,0,3,0,1.0
5720,10,4170,4.25,1,0,1550,6,0,2.0
2770,8,1970,3.5,0,0,800,4,0,2.0
2770,7,1490,2.75,0,0,1280,5,0,1.0
920,6,920,1.0,0,0,0,3,0,1.0
2020,6,2020,2.5,0,0,0,4,0,1.5
1770,7,1130,1.75,0,0,640,3,0,1.0
1260,6,1260,2.0,0,0,0,3,0,2.0
2370,8,2370,2.5,0,0,0,3,0,3.0
1030,7,790,1.0,0,2,240,2,0,1.0
1980,8,1300,2.25,0,0,680,3,0,1.0
1710,7,1010,2.75,0,0,700,3,0,1.0
2240,7,2240,2.5,0,0,0,3,0,2.0
1900,7,1900,1.5,0,0,0,3,0,1.0
670,6,670,1.0,0,0,0,2,0,1.0
2910,8,1510,2.75,0,0,1400,5,0,1.0
1190,6,1190,1.0,0,0,0,3,0,1.0
2390,8,2390,2.5,0,0,0,4,0,2.0
1660,8,1660,2.25,0,0,0,4,0,1.0
1010,6,1010,1.0,0,0,0,2,0,1.0
2380,8,2380,2.5,0,2,0,2,0,1.0
1530,7,1530,1.75,0,0,0,4,0,1.5
1350,7,1350,1.75,0,0,0,3,0,3.0
2750,8,2750,2.5,0,0,0,4,0,2.0
1270,6,1270,2.0,1,0,0,3,0,1.0
2370,11,2370,1.5,0,0,0,2,0,2.0
2170,7,1220,2.5,1,0,950,4,0,1.0
4750,10,3350,3.5,0,2,1400,5,0,2.0
1360,8,1360,2.5,0,0,0,3,0,2.0
3180,11,3180,2.5,0,0,0,3,0,2.0
1900,7,1900,2.0,0,0,0,3,0,1.0
1620,7,1620,2.5,0,0,0,2,0,2.0
1600,8,1600,2.5,0,0,0,3,0,2.0
2460,8,1520,2.5,0,0,940,3,0,1.0
1780,7,1780,2.25,0,0,0,3,0,2.0
1020,7,1020,1.75,0,0,0,3,0,1.5
870,6,870,1.0,0,0,0,2,0,1.0
1070,6,1070,1.0,0,0,0,2,0,1.0
1850,8,1850,2.5,0,0,0,4,0,2.0
2380,7,1750,3.5,0,0,630,4,0,2.0
890,6,890,1.0,0,0,0,2,0,1.0
2150,7,1090,2.5,0,0,1060,4,0,1.0
1340,7,1340,3.25,0,0,0,3,0,3.0
780,7,780,1.0,0,0,0,2,0,1.0
2910,8,2910,2.75,0,0,0,5,0,1.5
2490,8,1400,2.75,0,0,1090,4,0,1.0
3640,8,3640,3.0,0,0,0,5,0,2.0
1159,7,1159,1.5,0,0,0,2,0,1.0
1780,8,1780,1.0,0,0,0,4,0,1.5
3810,8,3810,3.75,0,0,0,6,0,2.0
1400,7,1100,2.0,0,0,300,4,0,1.0
1370,6,1370,1.0,1,0,0,2,0,1.0
1080,6,1080,2.0,0,0,0,2,0,1.0
990,6,990,1.0,0,0,0,3,0,1.5
4440,11,4440,3.5,0,0,0,4,0,2.0
2060,7,2060,2.0,0,0,0,4,0,2.0
2460,8,2460,2.5,0,0,0,3,0,2.0
2040,7,1160,2.0,0,0,880,4,0,1.0
1765,7,1765,2.25,0,0,0,3,0,2.0
2350,8,1780,2.0,0,0,570,3,0,1.5
1830,7,1830,1.0,0,0,0,3,0,1.0
1660,7,1350,1.0,0,0,310,3,0,1.5
1880,7,1640,2.5,0,0,240,6,0,1.0
1390,7,1390,1.75,0,0,0,3,0,2.0
2190,8,2190,1.5,0,3,0,4,0,1.0
2320,8,2320,2.5,0,0,0,4,0,2.0
1560,7,1560,2.5,0,0,0,4,0,2.0
1510,7,930,2.0,0,0,580,3,0,1.0
2050,8,2050,2.25,1,0,0,4,0,2.0
2020,7,2020,2.5,0,0,0,3,0,2.0
1520,7,920,1.0,0,0,600,2,0,1.0
2170,7,1270,1.75,0,0,900,4,0,1.0
2600,9,2600,2.5,0,0,0,3,0,1.0
1580,7,1030,1.5,0,0,550,4,0,1.0
2570,8,2570,2.5,0,0,0,4,0,2.0
1940,7,1100,2.25,0,0,840,1,0,2.0
3160,8,3160,2.25,0,0,0,5,0,2.0
1640,8,1640,1.75,1,2,0,3,0,1.0
1990,8,1990,2.0,0,0,0,3,0,2.0
3440,9,2560,3.25,0,0,880,3,0,2.0
2140,7,2140,2.5,0,0,0,4,0,2.0
2180,7,2180,1.0,0,0,0,4,0,1.5
2980,9,2980,2.5,1,0,0,4,0,2.0
1540,6,1540,1.75,0,0,0,3,0,2.0
3010,9,3010,2.75,0,0,0,4,0,2.0
3460,9,3460,2.75,0,0,0,5,0,2.0
1830,7,1150,1.75,1,1,680,3,0,1.0
1500,7,830,2.0,0,0,670,4,0,1.0
1370,7,1090,2.5,0,0,280,3,0,1.0
1660,7,1110,2.25,0,0,550,4,0,1.0
4070,11,4070,3.5,0,0,0,4,0,2.0
4250,9,2380,2.25,1,2,1870,4,0,1.0
2360,8,2360,2.0,0,0,0,3,0,1.0
3910,11,2550,3.25,0,2,1360,4,0,2.0
1900,7,1280,1.75,0,0,620,3,0,1.0
2070,8,1690,2.25,0,0,380,3,0,1.0
1010,7,1010,1.0,0,0,0,3,0,1.0
1200,6,1200,1.0,0,0,0,2,0,1.0
2410,8,1820,2.5,0,0,590,3,0,1.0
2910,9,1940,2.5,0,4,970,2,1,2.0
3530,10,3530,4.0,0,0,0,4,0,2.0
1100,5,1100,1.0,0,0,0,3,0,1.0
2570,8,2570,2.5,0,0,0,4,0,2.0
3210,10,3210,2.75,0,1,0,3,0,2.0
1650,7,1090,1.0,0,0,560,2,0,1.0
3040,10,3040,3.0,0,0,0,4,0,2.0
1450,7,1450,2.25,0,0,0,3,0,2.0
1480,8,1480,1.5,0,0,0,2,0,1.0
2800,9,1650,2.25,0,0,1150,4,0,1.0
1930,8,1930,2.25,0,0,0,4,0,2.0
3570,9,2630,3.0,0,3,940,4,0,1.5
2110,8,2110,2.5,0,0,0,4,0,2.0
970,7,970,1.0,0,0,0,3,0,1.0
700,6,700,1.0,0,0,0,2,0,1.0
800,6,600,1.0,0,0,200,2,0,1.0
2680,9,2680,2.5,0,1,0,3,0,2.0
2110,8,2110,2.5,0,0,0,3,0,2.0
1290,7,1150,1.0,0,0,140,3,0,1.0
2110,7,1420,2.5,0,0,690,4,0,1.0
700,7,700,1.0,0,0,0,1,0,1.0
1610,7,1610,2.25,0,0,0,2,0,2.0
850,6,850,0.75,0,2,0,1,0,1.0
1500,8,1500,1.5,0,0,0,3,0,2.0
3700,9,3700,3.5,0,0,0,5,0,2.0
1320,8,1180,2.5,0,0,140,2,0,2.0
820,5,820,1.0,0,0,0,2,0,1.0
1070,7,1070,1.5,0,0,0,2,0,1.0
3020,7,1860,2.0,0,0,1160,5,0,1.5
1720,7,1720,1.75,0,0,0,4,0,1.0
2150,8,1240,2.75,1,0,910,4,0,1.0
3060,10,3060,2.5,1,0,0,3,0,2.0
1800,7,1080,1.75,0,0,720,4,0,1.0
1680,8,1680,2.0,0,0,0,2,0,1.0
3160,8,1580,2.75,0,0,1580,4,0,1.0
1740,7,1740,2.5,0,0,0,3,0,2.0
1440,7,1040,1.0,0,0,400,4,0,1.0
1800,8,1800,2.25,0,0,0,4,0,2.0
2610,8,2610,2.5,0,0,0,4,0,2.0
1960,7,1400,1.75,0,0,560,3,0,1.0
3530,9,3530,2.0,0,0,0,5,0,1.5
1780,7,990,1.75,0,0,790,3,0,1.0
2370,8,2370,2.5,0,0,0,4,0,2.0
1040,9,900,1.5,0,0,140,3,0,2.0
1500,7,1500,2.25,0,0,0,4,0,2.0
1550,7,1250,1.75,0,0,300,3,0,1.0
1770,8,1770,2.75,0,0,0,3,0,2.0
1620,7,1620,1.0,0,0,0,4,0,1.5
2660,8,1980,3.5,0,0,680,5,0,2.0
2000,7,2000,2.5,0,0,0,3,0,2.0
4580,11,3080,3.25,0,3,1500,4,0,2.0
3070,9,3070,2.5,0,0,0,4,0,2.0
1130,6,830,1.0,0,0,300,3,0,1.0
2130,7,1430,2.25,0,0,700,4,0,1.0
2380,9,2380,2.5,0,0,0,3,0,1.5
3740,9,3740,2.25,0,0,0,5,0,1.5
970,6,970,1.0,0,0,0,3,0,1.0
4010,11,2600,2.5,1,3,1410,3,0,1.0
1190,7,1190,1.5,0,0,0,3,0,1.0
860,6,860,1.0,0,0,0,3,0,1.0
800,7,800,1.5,0,0,0,2,0,2.0
1820,8,1220,2.25,0,0,600,3,0,1.0
1850,8,1850,1.5,1,0,0,3,0,1.0
3560,9,3560,3.75,1,0,0,4,0,2.0
1990,7,1130,2.0,0,0,860,3,0,1.0
2690,8,1930,3.5,0,2,760,5,0,2.0
4010,10,4010,3.5,1,0,0,4,0,2.0
1390,7,1390,1.0,0,0,0,3,0,1.0
3370,8,2470,3.5,0,2,900,4,0,2.0
2300,7,2300,2.5,0,0,0,4,0,2.0
2490,8,2490,2.5,0,0,0,4,0,2.0
1200,6,1200,1.0,0,2,0,2,0,1.0
1690,7,1690,2.5,0,0,0,3,0,2.0
1830,8,1830,2.5,0,0,0,3,0,2.0
1490,8,1490,1.75,0,0,0,3,0,1.0
1990,8,1990,2.5,0,0,0,3,0,2.0
1930,7,1330,2.5,0,0,600,4,0,1.0
1060,7,1060,1.5,0,0,0,3,0,1.0
1370,8,1370,1.75,0,0,0,3,0,3.0
1920,8,1920,2.25,0,0,0,3,0,2.0
1160,7,1160,1.0,0,0,0,2,0,1.0
2020,7,2020,2.25,0,0,0,3,0,2.0
2210,7,1460,1.75,1,0,750,4,0,1.0
1400,7,1400,2.5,0,0,0,3,0,1.0
1190,7,1190,1.0,0,0,0,3,0,1.0
2480,7,1620,1.5,0,0,860,3,0,1.5
1390,7,1390,1.5,0,0,0,2,0,3.0
3470,8,3470,2.5,0,0,0,5,0,2.0
1910,7,1910,1.5,0,0,0,3,0,1.5
1280,6,1280,1.5,0,0,0,3,0,2.0
1660,5,930,1.0,0,0,730,4,0,1.0
870,7,870,1.0,0,0,0,2,0,1.0
1380,7,1140,2.5,0,0,240,2,0,2.0
860,6,860,1.0,0,0,0,3,0,1.0
2370,8,2370,2.5,0,0,0,4,0,2.0
720,6,720,1.0,0,0,0,2,0,1.0
760,6,760,1.0,0,0,0,2,0,1.0
5300,10,4570,2.5,0,2,730,4,1,2.0
1820,7,1300,2.0,0,0,520,4,0,1.0
2134,8,2134,2.5,0,0,0,3,0,2.5
1680,9,1680,2.5,0,0,0,2,0,3.0
1940,7,1430,2.25,0,0,510,4,0,1.0
2340,9,2340,1.75,0,2,0,3,0,2.0
2350,7,2350,2.5,0,0,0,4,0,2.0
2870,8,2870,2.5,0,0,0,4,0,2.0
1220,7,1220,1.0,0,0,0,2,0,1.0
1600,7,1600,1.0,0,0,0,3,0,1.0
1050,7,1050,1.0,0,0,0,2,0,1.0
2490,8,2040,2.5,0,0,450,4,0,2.0
1230,7,910,2.25,0,0,320,3,0,1.0
1860,8,1860,2.0,0,0,0,3,0,1.5
2460,9,2460,2.5,0,0,0,4,0,2.0
990,7,990,1.0,0,0,0,3,0,1.0
1100,8,1100,1.5,0,0,0,2,0,3.0
3300,8,3300,2.5,0,0,0,4,0,2.0
1420,7,1420,2.0,0,0,0,2,0,1.0
1400,7,1400,1.0,0,0,0,3,0,1.5
1920,7,1340,1.75,0,0,580,3,0,1.0
2470,7,1600,2.25,0,0,870,4,0,1.0
1250,7,1250,1.75,0,0,0,3,0,1.0
2720,10,2720,2.5,0,0,0,4,0,2.0
3570,8,2400,2.5,0,0,1170,3,0,1.0
3190,9,3190,3.5,0,0,0,4,0,2.0
1430,7,1430,2.0,1,0,0,3,0,1.0
1990,8,1410,2.5,0,0,580,3,0,1.5
2876,9,1970,3.0,1,2,906,5,0,1.0
1470,7,1470,1.5,0,0,0,4,0,1.5
2450,8,1650,2.25,0,2,800,4,0,1.0
1070,7,720,2.5,0,0,350,3,0,2.0
2390,8,2390,2.75,0,0,0,4,0,2.0
3340,8,2580,3.5,0,0,760,5,0,2.0
1480,7,1480,2.0,0,0,0,4,0,1.5
2710,8,1650,3.5,0,0,1060,3,0,2.0
1570,7,1090,2.5,0,0,480,3,0,1.0
3730,10,2460,3.25,0,0,1270,4,0,2.0
2650,9,2330,2.5,0,2,320,4,0,1.0
2110,7,2110,2.0,0,0,0,3,0,2.0
2070,7,2070,2.5,0,0,0,4,0,2.0
1070,7,1070,1.5,0,0,0,3,0,1.0
3720,11,3720,2.5,0,0,0,3,0,2.0
1130,7,1130,1.0,0,0,0,3,0,1.0
3710,9,3710,2.75,0,0,0,5,0,2.0
2520,8,1680,1.75,0,0,840,4,0,1.0
2710,9,2710,2.75,0,0,0,4,0,2.0
1600,7,990,1.0,1,1,610,3,0,1.0
1520,7,840,1.75,0,0,680,2,0,1.0
4270,9,3060,3.25,0,0,1210,4,0,2.0
1300,6,1300,1.0,0,0,0,2,0,1.0
1820,7,1040,1.0,0,0,780,3,0,1.0
2510,8,1610,2.5,0,0,900,4,0,1.0
1790,6,1790,1.75,0,0,0,4,0,1.0
1660,6,1660,1.75,0,0,0,5,0,1.5
7390,12,5000,6.0,1,4,2390,6,1,2.0
4500,12,3340,3.5,1,0,1160,4,0,1.0
1990,7,1990,2.5,0,0,0,3,0,2.0
3200,9,3200,2.75,0,1,0,3,0,2.0
1940,7,1140,2.5,0,0,800,4,0,1.0
1760,7,880,1.75,0,0,880,4,0,1.0
1330,7,1330,1.5,0,0,0,3,0,1.0
2210,7,2210,2.0,0,0,0,6,0,2.0
920,7,920,1.0,0,0,0,2,0,1.0
1040,7,1040,1.0,0,0,0,2,0,1.0
2300,8,1580,2.25,0,2,720,3,0,1.0
2010,7,2010,2.0,0,0,0,4,0,2.0
3270,8,2180,2.25,0,0,1090,4,0,2.0
1210,6,1210,1.5,0,0,0,3,0,1.0
2588,8,2588,2.5,0,0,0,3,0,2.0
3052,8,3052,2.5,0,0,0,4,0,2.0
1230,7,1230,1.75,0,0,0,3,0,1.0
1300,7,1300,1.0,0,0,0,2,0,1.0
5510,13,4910,4.25,0,4,600,3,0,2.0
2120,7,1980,1.75,0,0,140,3,0,2.0
1540,7,1160,1.5,0,0,380,4,0,1.0
1981,8,1981,2.5,0,0,0,4,0,2.0
1200,7,1200,1.75,0,0,0,3,0,1.0
2530,8,1850,3.5,0,0,680,4,0,2.0
2280,8,2280,2.5,0,0,0,3,0,2.0
4690,11,3480,4.0,1,0,1210,4,0,2.0
2700,7,2700,2.75,0,0,0,4,0,2.0
2210,8,2210,2.25,0,0,0,4,0,2.0
2690,8,1870,2.25,0,2,820,2,0,1.0
1270,6,610,2.0,0,0,660,2,0,1.0
3310,9,3310,2.5,0,0,0,4,0,2.0
1760,7,1170,2.0,0,0,590,4,0,1.5
1330,7,1330,1.0,0,0,0,3,0,1.0
2240,7,1190,2.25,0,1,1050,3,0,1.0
830,6,830,1.0,0,0,0,2,0,1.0
1170,6,1170,1.0,0,0,0,3,0,1.0
2240,8,2240,2.25,0,0,0,4,0,2.0
1370,8,1370,2.0,0,0,0,2,0,1.0
2360,8,1630,2.5,1,2,730,4,0,1.0
4100,10,4100,3.25,0,2,0,5,0,2.0
3570,10,3570,3.25,0,2,0,4,0,2.0
2510,10,2510,2.5,0,0,0,2,0,2.0
4065,10,4065,3.5,1,0,0,4,0,2.0
1010,7,1010,1.0,0,0,0,2,0,1.0
1460,7,1460,1.75,0,0,0,2,0,1.0
1430,7,1430,1.75,0,0,0,3,0,1.0
740,5,740,1.0,0,0,0,2,0,1.0
1970,9,1970,2.25,0,0,0,3,0,2.0
1370,7,1370,1.5,0,0,0,3,0,1.0
2120,9,2120,2.5,0,0,0,4,0,2.0
1170,5,1170,1.0,0,0,0,2,0,1.5
1680,7,1080,2.75,0,0,600,4,0,1.0
3380,9,2160,3.5,0,1,1220,4,0,2.0
1950,8,1950,2.5,0,0,0,3,0,2.0
1970,7,1440,2.5,0,0,530,4,0,2.0
2860,8,2290,2.25,0,1,570,3,0,1.0
990,7,990,1.0,0,0,0,2,0,1.0
1890,8,1260,1.75,0,0,630,4,0,1.0
1730,8,1730,2.5,0,0,0,3,0,2.0
3400,9,1820,1.75,0,2,1580,3,0,1.0
2610,8,1610,2.5,1,0,1000,4,0,1.0
3190,8,2120,3.5,0,2,1070,4,0,2.0
2020,7,2020,2.5,0,0,0,3,0,2.0
1170,6,1170,1.0,0,0,0,3,0,1.0
1740,9,1740,2.5,0,0,0,3,0,2.0
680,6,680,1.0,0,4,0,1,0,1.0
1960,7,1750,2.25,0,0,210,3,0,2.0
1250,7,1250,1.75,0,0,0,3,0,1.0
2400,8,1400,2.25,0,0,1000,3,0,1.0
1880,8,1880,2.5,0,0,0,3,0,2.0
4380,10,3580,3.0,0,3,800,3,0,2.0
1940,8,1470,1.75,0,0,470,3,0,1.0
2200,8,2200,2.5,0,0,0,3,0,2.0
2170,8,1540,2.25,1,0,630,4,0,1.0
3020,9,3020,2.75,1,0,0,4,0,2.0
2610,8,2610,3.0,0,4,0,3,1,1.5
1010,7,1010,1.5,0,0,0,2,0,2.0
1750,7,1750,2.5,0,0,0,4,0,2.0
2010,8,2010,2.5,0,0,0,4,0,2.0
2330,8,1490,2.5,0,1,840,4,0,1.0
2060,7,1170,2.0,0,0,890,4,0,1.0
3380,10,3380,2.5,0,0,0,4,0,2.0
1800,8,1800,3.5,1,2,0,4,0,2.0
6110,11,6110,5.25,0,0,0,4,0,2.0
2760,8,1760,2.5,0,2,1000,3,0,1.0
1700,8,1700,2.25,0,0,0,3,0,3.0
2350,8,2350,2.5,0,0,0,4,0,2.0
2350,8,2350,2.5,0,0,0,4,0,2.0
3550,9,3550,2.5,0,0,0,4,0,2.0
1030,7,1030,1.0,0,0,0,3,0,1.5
3600,7,2400,5.25,0,0,1200,6,0,2.0
2760,7,1380,2.25,0,0,1380,5,0,1.0
2420,8,2420,2.25,0,0,0,3,0,1.0
3280,10,1680,2.5,0,0,1600,3,0,1.0
1340,8,1340,2.0,0,0,0,3,0,3.0
2880,8,1440,2.5,1,0,1440,5,0,1.0
1510,7,1240,1.75,0,0,270,3,0,1.0
1490,7,1490,2.0,0,0,0,3,0,1.0
1830,8,1520,2.5,0,0,310,3,0,1.0
1400,7,1400,2.5,0,0,0,3,0,2.0
2070,7,2070,2.25,0,0,0,4,0,2.0
1530,7,1210,2.5,0,0,320,3,0,1.0
1140,6,1140,2.0,0,0,0,2,0,1.0
1880,8,1520,3.0,0,0,360,3,0,2.0
960,6,960,1.0,0,0,0,2,0,1.0
2010,8,1310,2.5,1,0,700,4,0,1.0
3200,8,1600,2.75,0,2,1600,6,0,1.0
1840,7,1840,2.5,0,0,0,4,0,2.0
1010,7,1010,1.5,0,0,0,3,0,1.5
2460,8,1500,2.5,0,0,960,4,0,1.0
4640,8,2860,4.25,0,4,1780,5,1,2.0
1230,7,1230,1.0,0,0,0,3,0,1.0
940,5,940,1.0,0,0,0,2,0,1.0
1860,7,1490,1.5,0,0,370,3,0,1.0
1690,7,1360,3.5,0,0,330,3,0,2.0
2060,7,1030,1.75,0,0,1030,2,0,1.0
1730,7,1480,2.75,0,2,250,3,0,2.0
2430,8,1310,2.0,0,0,1120,4,0,1.0
2460,9,1490,2.75,0,0,970,5,0,1.0
1820,8,1820,2.5,0,0,0,4,0,2.0
1480,7,1480,1.75,0,0,0,3,0,1.0
2660,7,1450,2.5,0,0,1210,4,0,1.0
1410,7,1410,2.0,0,0,0,3,0,1.0
2470,9,2470,2.5,0,0,0,4,0,2.0
1360,7,1360,1.75,0,0,0,3,0,1.0
1490,7,1490,2.5,0,0,0,3,0,2.0
1680,7,1680,1.75,1,0,0,3,0,1.0
1670,7,1670,2.0,0,0,0,3,0,1.0
2070,8,1440,2.25,0,0,630,3,0,1.0
1610,7,1610,2.25,0,0,0,3,0,1.0
990,7,990,1.0,0,0,0,2,0,1.0
1320,6,1320,1.0,0,0,0,4,0,1.0
1810,7,1030,1.5,0,0,780,3,0,1.0
4310,10,3260,3.5,0,0,1050,6,0,2.0
3510,8,2750,3.5,0,0,760,4,0,2.0
1430,7,980,1.75,0,0,450,3,0,1.0
2610,10,2610,2.5,0,0,0,3,0,2.0
1740,7,1270,1.0,0,0,470,3,0,1.0
1370,8,1370,3.25,0,0,0,3,0,3.0
1390,8,1390,2.5,0,0,0,3,0,3.0
2070,8,2070,2.5,0,0,0,4,0,2.0
3570,9,3570,3.75,0,0,0,5,0,2.0
1080,7,1080,1.5,0,0,0,3,0,1.0
1550,7,1210,1.75,0,0,340,3,0,1.0
2530,7,2530,2.25,0,0,0,4,0,2.0
1260,6,840,1.75,0,0,420,3,0,1.0
1180,8,1180,1.0,0,0,0,3,0,1.5
4620,11,4620,2.5,0,0,0,4,0,2.0
1790,7,1060,2.75,0,0,730,5,0,1.5
2780,9,2780,2.25,0,0,0,5,0,2.0
1380,7,1380,1.5,1,0,0,3,0,1.0
1780,8,1530,2.5,0,0,250,3,0,2.0
8020,11,8020,6.25,1,0,0,5,0,2.0
1020,6,1020,1.0,0,0,0,2,0,1.0
2170,8,1270,2.25,0,2,900,4,0,1.0
2880,9,2880,2.75,0,0,0,5,0,2.0
1440,8,1440,2.0,0,0,0,3,0,1.0
1970,7,1970,2.5,0,0,0,5,0,2.0
4390,10,4390,3.25,1,0,0,5,0,2.0
1460,7,1460,1.75,0,0,0,3,0,1.0
1300,6,1300,1.0,1,0,0,3,0,1.0
1590,7,1590,2.0,0,0,0,4,0,3.0
920,6,920,1.0,0,0,0,3,0,1.0
1290,8,1290,1.75,0,0,0,2,0,2.0
1940,8,1190,2.5,0,0,750,4,0,1.0
2150,8,1870,1.75,1,0,280,3,0,2.0
3610,10,3610,3.0,0,0,0,4,0,2.0
1530,7,1530,1.0,0,0,0,6,0,1.5
1550,9,1220,3.25,0,0,330,3,0,2.0
1580,7,1580,2.5,0,0,0,4,0,2.0
2180,8,2060,2.0,0,0,120,4,0,1.5
1810,8,1810,2.5,0,0,0,3,0,3.0
1080,7,1080,1.0,0,0,0,2,0,1.0
1360,7,1360,1.5,0,0,0,3,0,1.5
1980,7,1280,1.75,0,1,700,2,0,2.0
1380,8,1380,2.5,0,0,0,3,0,3.0
1960,7,1080,1.75,0,0,880,3,0,1.0
1800,7,1800,2.25,0,0,0,3,0,2.0
2830,8,1840,3.0,0,3,990,3,0,2.0
1480,7,1000,1.5,0,0,480,3,0,1.0
5340,10,3740,3.75,0,3,1600,5,0,2.5
2010,8,1390,2.5,0,0,620,3,0,2.0
1030,7,880,1.0,0,0,150,3,0,1.0
1060,7,1060,1.0,0,0,0,3,0,1.0
2170,8,1370,3.0,0,0,800,4,0,1.0
2520,7,1640,1.75,1,0,880,4,0,1.0
1570,7,1120,2.0,0,0,450,4,0,1.0
1710,8,1710,2.0,1,0,0,4,0,1.5
1450,7,1450,1.0,0,0,0,3,0,1.5
800,7,800,1.0,0,2,0,2,0,1.0
730,6,730,1.0,0,0,0,2,0,1.0
2410,7,1940,2.5,0,0,470,2,0,1.0
2110,8,1600,2.25,0,2,510,4,0,1.0
2800,8,2800,2.5,0,0,0,4,0,2.0
1340,8,1340,2.25,0,0,0,3,0,3.0
2290,8,2290,2.5,0,0,0,4,0,2.0
2000,6,2000,1.75,0,0,0,3,0,1.0
1740,7,1740,1.75,0,0,0,3,0,1.0
1160,6,1160,1.0,0,0,0,2,0,1.0
1060,8,980,2.25,0,0,80,2,0,2.0
1730,7,1050,1.75,0,0,680,5,0,1.0
2030,8,2030,2.5,0,0,0,3,0,1.0
2060,8,1430,3.0,0,0,630,4,0,1.0
5990,11,5990,3.5,0,0,0,4,0,2.0
2510,8,2510,2.5,0,0,0,4,0,2.0
1630,8,1630,2.5,0,0,0,3,0,2.0
1380,7,1380,1.75,0,0,0,3,0,1.0
2120,7,1060,2.0,0,0,1060,4,0,1.0
1960,7,1750,2.25,0,0,210,3,0,2.0
1640,7,1640,2.0,0,0,0,3,0,1.0
1090,7,1090,2.0,0,0,0,2,0,2.0
1610,8,1610,2.5,0,0,0,3,0,2.0
1610,7,1610,2.0,0,0,0,4,0,1.0
5270,10,3440,3.5,0,0,1830,4,0,2.0
1090,7,1090,1.5,0,0,0,3,0,1.0
1060,6,1060,1.0,0,0,0,3,0,1.0
2580,8,1720,2.75,0,2,860,5,0,2.0
2440,8,2090,2.25,0,0,350,3,0,2.0
1200,7,1200,1.5,0,0,0,3,0,1.0
2730,9,1940,2.75,0,4,790,3,1,1.5
930,6,930,1.0,1,2,0,2,0,1.0
1650,8,1650,1.75,0,0,0,3,0,3.0
5270,11,3400,4.5,0,4,1870,4,1,2.0
2600,8,1410,2.0,0,0,1190,4,0,1.0
1000,6,1000,1.0,0,0,0,3,0,1.5
1420,7,1420,2.5,0,0,0,3,0,3.0
2060,9,2060,2.0,0,0,0,3,0,1.0
2150,8,1220,2.75,0,0,930,4,0,1.0
1660,7,1060,1.0,0,0,600,3,0,1.0
2300,8,2300,2.75,0,0,0,3,0,2.0
1200,6,1200,1.0,0,0,0,3,0,1.0
2800,8,2800,2.5,0,0,0,4,0,2.0
1950,7,1160,2.25,0,0,790,3,0,2.0
3720,10,1960,2.75,1,4,1760,4,0,1.0
2780,8,1390,2.5,0,0,1390,5,0,1.0
1010,7,1010,1.0,0,0,0,3,0,1.0
1750,7,1750,1.5,0,0,0,5,0,1.5
1810,7,1810,2.5,0,0,0,4,0,2.0
1960,7,1290,2.5,0,0,670,3,0,1.0
1760,7,1230,1.75,0,0,530,3,0,1.0
2200,7,1250,2.25,0,0,950,4,0,1.0
1150,6,1150,1.0,0,0,0,3,0,1.0
1400,6,1400,1.0,0,0,0,3,0,1.0
1470,8,1080,2.25,0,0,390,3,0,2.0
1430,7,900,1.75,0,0,530,3,0,1.0
1430,8,1430,1.75,0,0,0,3,0,1.0
2910,7,1600,2.75,0,0,1310,4,0,1.0
3480,10,2890,3.5,0,2,590,5,0,2.0
860,7,860,1.0,0,0,0,3,0,1.0
1930,9,1930,1.75,0,2,0,3,0,2.0
970,6,720,1.0,0,0,250,3,0,1.0
1850,7,1230,3.0,0,0,620,3,0,1.0
3560,11,3560,2.5,1,0,0,6,0,2.5
2500,7,1250,1.5,0,0,1250,4,0,1.0
770,4,770,0.75,0,0,0,3,0,1.0
1640,7,1640,1.75,1,0,0,3,0,1.5
1445,7,1300,2.25,0,0,145,3,0,2.0
1480,7,1480,1.75,1,0,0,3,0,1.0
1780,7,1080,1.5,0,0,700,4,0,1.0
5310,11,5310,4.75,0,0,0,4,0,2.0
1690,7,1690,1.5,1,0,0,3,0,1.0
2020,7,1330,2.5,0,0,690,3,0,1.0
1130,7,1130,1.0,0,0,0,3,0,1.0
3230,9,3230,2.5,1,0,0,4,0,2.0
1650,7,1650,2.0,0,0,0,3,0,2.0
1078,7,1078,1.5,0,0,0,2,0,2.0
2510,8,1680,1.75,1,0,830,4,0,1.0
2360,8,2360,2.5,1,0,0,3,0,2.0
1490,7,1490,1.0,0,0,0,3,0,1.5
3010,9,3010,2.75,1,0,0,4,0,2.0
1390,7,1390,1.0,0,0,0,3,0,1.0
2590,8,2590,2.5,0,0,0,3,0,2.0
2670,9,2670,2.25,0,0,0,3,0,2.0
1960,8,980,1.75,0,0,980,4,0,1.0
2870,8,1770,1.75,0,2,1100,2,0,2.0
1650,7,1650,2.25,0,0,0,3,0,2.0
1150,7,1150,1.0,0,0,0,3,0,1.0
1170,7,1170,1.5,0,0,0,3,0,1.0
1540,6,770,1.75,0,0,770,3,0,1.0
4140,9,3030,3.5,0,0,1110,5,0,2.0
1180,7,1180,1.5,0,0,0,3,0,1.0
1910,8,1910,2.5,0,0,0,3,0,2.0
2230,8,1810,2.25,0,2,420,4,0,1.5
4230,8,3230,4.0,1,4,1000,5,1,2.0
3760,9,2360,2.5,0,0,1400,6,0,1.0
3790,10,3790,2.75,0,0,0,4,0,2.0
2180,7,1200,2.5,0,0,980,5,0,1.0
3760,10,3060,3.0,0,3,700,3,0,2.5
1630,7,1630,1.75,0,0,0,3,0,1.0
2090,6,1060,2.0,0,0,1030,4,0,1.0
1630,7,1630,1.0,0,0,0,3,0,1.0
2160,7,1220,2.75,0,0,940,4,0,1.0
2840,7,1420,2.0,1,0,1420,4,0,1.0
3380,8,3380,4.25,0,0,0,5,0,2.0
1690,7,1190,1.75,0,0,500,4,0,1.0
2990,9,2000,3.5,0,4,990,4,0,2.0
2770,8,2100,3.5,0,0,670,4,0,2.0
1190,7,1190,1.5,0,0,0,2,0,3.0
2280,8,1500,2.5,0,0,780,4,0,1.0
2730,9,2730,2.5,0,0,0,4,0,2.0
3650,9,1830,2.5,0,4,1820,4,1,1.0
1300,6,1300,1.0,0,0,0,2,0,1.0
1720,8,1720,2.0,1,0,0,5,0,1.0
1150,7,1150,1.75,0,0,0,3,0,1.0
670,6,670,1.0,0,0,0,2,0,1.0
2020,8,1090,1.75,0,0,930,3,0,1.0
3860,9,1930,1.75,0,2,1930,3,0,1.0
1850,7,1100,1.75,0,0,750,4,0,1.0
1800,7,1280,2.25,0,0,520,3,0,1.0
2300,7,2300,1.75,0,0,0,5,0,2.0
810,7,810,1.0,0,0,0,2,0,1.0
2100,8,2100,2.5,0,0,0,3,0,1.0
1770,7,960,2.0,0,0,810,3,0,1.0
1510,8,1510,1.75,0,0,0,2,0,1.0
2320,8,1380,1.75,0,0,940,2,0,1.0
2130,8,2130,2.5,0,0,0,4,0,2.0
1330,7,1330,1.0,0,0,0,2,0,1.0
2120,8,1060,1.75,0,0,1060,4,0,1.0
3470,8,2520,3.5,0,3,950,4,0,2.0
2400,8,1420,2.25,1,0,980,3,0,1.0
2990,9,2990,2.75,0,0,0,4,0,2.0
2400,7,1440,2.25,0,0,960,3,0,1.5
1580,7,1040,1.0,0,0,540,3,0,1.0
900,6,900,1.5,0,0,0,3,0,1.5
3190,8,3190,3.75,0,0,0,6,0,2.0
1740,8,1740,2.5,0,0,0,3,0,2.0
1520,7,1000,1.75,1,0,520,4,0,1.0
1250,6,1250,1.75,0,0,0,3,0,1.0
3160,9,3160,2.75,0,0,0,3,0,2.0
1000,7,1000,1.0,0,2,0,2,0,1.0
1640,8,1640,2.5,1,0,0,3,0,3.0
1690,7,1690,1.0,0,0,0,3,0,1.0
1750,7,1330,1.75,0,0,420,3,0,1.0
2630,8,2630,2.5,0,0,0,4,0,2.0
2760,9,2760,2.5,0,0,0,3,0,2.0
1840,8,1840,1.75,0,0,0,3,0,1.0
2550,7,1860,2.25,0,0,690,2,0,2.0
1450,9,1110,2.5,0,0,340,2,0,2.0
1110,7,960,2.25,0,0,150,3,0,2.0
3070,8,2070,2.5,0,0,1000,4,0,2.0
2090,8,1420,2.5,0,0,670,5,0,1.0
2550,9,2550,2.25,1,0,0,3,0,2.0
1660,8,1260,3.5,0,0,400,3,0,2.0
3710,10,2760,3.0,0,2,950,4,0,2.0
1750,7,1750,1.0,0,0,0,5,0,1.5
1690,7,1690,2.5,0,0,0,3,0,2.0
1220,6,1220,1.0,0,0,0,3,0,1.0
1820,7,1820,1.5,1,0,0,3,0,1.0
1030,7,1030,1.0,0,0,0,2,0,1.0
2140,7,1070,1.75,0,1,1070,3,0,1.0
2630,8,2630,2.5,0,0,0,4,0,2.0
1210,8,1210,2.5,0,0,0,3,0,3.0
3216,9,3216,2.5,0,0,0,4,0,2.0
1480,7,1180,2.5,0,0,300,3,0,1.0
2740,9,2740,2.5,0,0,0,3,0,2.0
720,6,720,1.0,0,0,0,2,0,1.0
2020,8,2020,2.25,0,0,0,4,0,2.0
490,5,490,0.75,0,0,0,3,0,1.5
1320,7,1080,1.75,0,1,240,2,0,1.0
2100,7,2100,2.5,0,0,0,4,0,1.0
1790,8,1790,2.5,0,0,0,3,0,2.0
6510,11,3250,4.25,1,3,3260,5,0,2.0
4660,9,2600,4.0,0,2,2060,5,0,2.0
1400,7,1050,1.75,0,0,350,4,0,1.0
1608,8,1608,2.5,0,0,0,3,0,2.0
2460,8,2460,2.5,0,0,0,4,0,2.0
2850,8,1970,3.5,0,2,880,4,0,2.0
2100,7,1070,1.75,0,0,1030,5,0,1.0
4410,11,4410,3.75,0,3,0,4,0,3.0
1100,9,1100,1.25,1,0,0,1,0,3.0
2940,7,1520,2.25,0,0,1420,4,0,1.0
1600,7,1600,2.0,0,0,0,3,0,1.0
4000,9,2190,1.75,0,0,1810,3,0,1.0
1540,8,1540,2.5,0,0,0,4,0,2.0
6330,13,4900,4.0,1,2,1430,4,0,2.0
1540,8,1540,1.75,0,0,0,3,0,1.0
2550,9,2550,2.5,0,0,0,4,0,2.0
1000,7,1000,1.0,0,0,0,3,0,1.0
1740,8,1360,3.25,0,0,380,3,0,2.0
1320,8,1040,3.25,0,0,280,3,0,2.0
880,7,880,1.5,0,0,0,2,0,2.0
1560,7,1560,1.0,0,0,0,3,0,1.0
2240,7,1440,1.75,0,0,800,3,0,1.0
2530,8,2530,2.25,0,0,0,3,0,2.0
1700,7,1700,2.5,0,0,0,4,0,2.0
2240,8,1490,2.5,0,0,750,4,0,1.0
4210,9,3260,3.5,0,3,950,4,0,2.0
1870,7,1870,2.25,0,0,0,4,0,2.0
1610,7,1610,1.75,0,0,0,3,0,1.0
1360,7,780,2.0,0,0,580,2,0,1.0
1180,7,1180,1.0,0,0,0,3,0,1.0
2540,10,2540,3.75,0,0,0,4,0,2.0
1290,7,1290,2.0,0,0,0,3,0,1.0
3390,10,3390,2.0,0,0,0,4,0,2.0
2440,8,2440,2.5,0,0,0,3,0,2.0
2080,8,1590,2.25,0,0,490,3,0,1.0
2154,8,2154,2.5,0,0,0,4,0,2.0
1410,9,1410,2.25,0,0,0,3,0,3.0
2390,8,1580,2.25,0,0,810,3,0,2.0
2330,7,1270,2.0,0,0,1060,5,0,1.0
1840,8,1840,1.5,0,0,0,3,0,2.0
3040,8,3040,2.75,0,4,0,4,1,2.0
1790,7,1790,2.0,0,0,0,3,0,1.0
1510,7,1510,2.0,0,0,0,3,0,1.5
2340,8,2340,3.0,0,0,0,3,0,2.0
1860,8,1860,2.5,0,0,0,3,0,2.0
1900,7,1070,1.75,0,0,830,3,0,1.5
2950,9,1980,3.0,0,3,970,4,0,2.0
1780,7,900,2.0,0,0,880,4,0,1.0
1060,6,910,1.0,0,0,150,3,0,1.0
1420,7,1420,1.0,0,0,0,4,0,1.5
2740,7,1670,2.75,0,0,1070,5,0,1.5
1820,7,1420,2.5,0,0,400,3,0,1.0
1420,8,1420,1.5,0,0,0,4,0,1.5
1060,7,1060,1.0,0,0,0,3,0,1.0
2990,8,2990,2.5,0,0,0,4,0,2.0
1360,7,1360,1.5,0,0,0,3,0,1.0
2430,8,2430,2.5,0,0,0,4,0,2.0
2050,8,2050,2.25,0,0,0,4,0,2.0
1820,8,1820,2.0,1,0,0,3,0,2.0
1760,7,1100,2.0,0,0,660,3,0,1.0
1600,7,1600,2.5,0,0,0,3,0,2.0
1850,7,1540,2.0,0,0,310,4,0,1.0
2470,8,2470,2.25,0,0,0,4,0,2.0
2540,8,1320,1.75,0,3,1220,4,0,1.0
1270,7,1270,1.0,0,0,0,3,0,1.0
3362,8,3362,2.5,0,0,0,4,0,2.0
1920,8,1920,2.25,0,0,0,4,0,2.0
2750,8,1380,2.5,0,3,1370,4,0,1.0
2450,7,2450,2.25,0,0,0,3,0,1.0
3020,8,1510,2.5,0,0,1510,3,0,1.0
2660,9,1830,2.5,1,0,830,3,0,2.0
1020,6,1020,1.0,0,0,0,3,0,1.0
1960,7,980,1.75,0,0,980,3,0,1.0
1760,8,1460,1.75,0,0,300,3,0,1.0
1110,7,1110,1.0,0,0,0,3,0,1.5
1300,7,1300,1.5,0,0,0,3,0,1.0
1320,7,880,1.0,0,0,440,2,0,1.0
2000,9,1820,1.75,1,0,180,4,0,1.5
1690,7,1690,2.0,0,0,0,3,0,1.0
2290,8,2290,2.25,0,0,0,4,0,2.0
3750,10,3750,2.5,0,4,0,5,1,2.0
2480,8,1460,1.75,0,3,1020,4,0,1.0
4360,10,3530,3.75,1,4,830,5,0,2.0
1920,7,1920,1.75,0,0,0,3,0,1.0
1550,8,1550,2.5,1,0,0,2,0,2.0
1800,7,1800,2.0,1,0,0,3,0,1.0
2210,8,2210,1.5,0,0,0,3,0,1.5
1540,8,1540,1.75,0,0,0,3,0,1.0
2500,8,2500,2.0,0,0,0,3,0,1.0
1950,8,1950,2.5,0,0,0,4,0,2.0
2990,10,2990,2.5,0,0,0,3,0,2.0
1550,7,1250,1.0,0,0,300,3,0,1.0
2720,8,2720,2.5,0,0,0,3,0,2.0
3370,8,3370,2.5,0,0,0,4,0,2.0
2890,9,2370,3.5,0,0,520,4,0,2.0
2350,7,1020,2.25,0,0,1330,3,0,1.0
3420,9,3420,4.5,0,0,0,4,0,3.0
1100,6,1100,1.75,0,0,0,3,0,1.0
3070,8,1570,3.5,0,3,1500,3,0,1.0
1470,7,1220,1.0,0,0,250,3,0,1.0
1060,7,1060,1.75,0,0,0,3,0,2.0
1100,6,1100,1.0,0,4,0,3,0,1.5
3970,10,3260,4.5,0,2,710,3,0,2.0
1890,7,1230,1.75,0,0,660,3,0,1.0
2820,7,1880,3.0,0,0,940,9,0,2.0
1650,7,980,1.0,0,0,670,3,0,1.0
3490,8,3490,2.5,0,0,0,4,0,1.5
2970,9,2970,2.0,1,0,0,4,0,2.5
1930,7,1930,1.5,0,0,0,4,0,1.0
1590,7,1590,2.5,0,0,0,3,0,2.0
3850,9,3030,3.25,0,2,820,5,0,2.0
1000,6,1000,1.0,0,0,0,3,0,1.0
1640,8,1180,2.25,0,0,460,3,0,1.0
1660,7,1660,2.5,0,0,0,4,0,1.0
2860,10,2860,2.5,0,0,0,4,0,2.0
790,6,790,1.0,0,0,0,1,0,1.0
2240,6,2240,3.0,0,0,0,5,0,1.0
3290,8,2290,3.5,0,0,1000,4,0,1.5
1640,8,1640,2.0,0,0,0,3,0,1.0
2280,9,2280,2.5,0,3,0,3,0,2.0
660,4,660,0.75,0,0,0,2,0,1.0
2130,7,1440,3.0,0,0,690,4,0,1.0
1900,7,1500,1.5,0,0,400,2,0,1.0
1060,7,860,1.0,1,0,200,2,0,1.0
2640,7,1650,1.75,0,0,990,5,0,1.5
1300,7,1300,1.75,0,1,0,3,0,2.0
2500,9,2500,2.5,0,0,0,3,0,2.0
1350,9,1350,2.5,0,0,0,3,0,3.0
1210,6,1210,1.0,0,0,0,4,0,1.5
2080,8,1220,3.25,0,2,860,3,0,2.0
2020,8,1210,2.25,0,2,810,4,0,1.0
1190,7,1190,2.0,0,0,0,3,0,1.0
894,7,894,1.0,0,0,0,2,0,2.0
1810,7,1810,1.75,0,0,0,4,0,2.0
1380,7,1380,1.5,0,0,0,3,0,1.0
3620,10,3620,2.5,0,0,0,4,0,2.0
2050,7,1210,2.0,0,0,840,4,0,1.5
3170,8,3170,2.25,0,0,0,7,0,2.0
1350,7,1350,1.5,1,0,0,4,0,1.0
1040,7,1040,1.75,0,0,0,3,0,1.0
3690,10,3690,3.0,0,0,0,4,0,2.0
3290,9,2670,3.5,0,0,620,5,0,2.0
1830,7,1830,2.0,0,0,0,3,0,1.0
1180,7,1180,2.0,0,0,0,4,0,1.0
1260,7,840,1.75,0,0,420,2,0,1.0
1380,6,1380,1.0,0,0,0,4,0,1.5
1570,8,1570,2.5,0,0,0,3,0,3.0
1890,9,1430,2.0,0,0,460,3,0,2.0
910,6,910,1.0,0,0,0,2,0,1.0
2000,7,1150,1.75,0,0,850,4,0,1.0
1740,7,1740,2.5,0,0,0,4,0,2.0
1950,7,1950,1.75,0,0,0,3,0,1.0
3430,10,3430,2.5,0,2,0,4,0,1.5
1460,7,1460,1.5,0,0,0,3,0,1.0
1570,7,1570,1.75,0,0,0,3,0,2.0
1110,7,950,1.5,0,0,160,2,0,2.0
1460,6,780,1.0,0,2,680,4,0,1.0
1560,7,1560,1.75,0,0,0,3,0,1.0
1430,7,1130,1.5,0,0,300,3,0,1.0
1210,6,900,1.0,0,0,310,2,0,1.0
2250,8,2250,2.5,0,0,0,3,0,2.0
1940,8,1940,1.5,0,2,0,3,0,1.5
1360,7,1360,1.0,0,0,0,3,0,1.0
2560,8,1870,2.25,0,0,690,5,0,1.0
1890,8,1890,2.25,0,0,0,3,0,1.0
1670,8,1670,1.0,0,0,0,4,0,1.5
2420,7,2420,1.75,1,0,0,4,0,1.5
1250,7,1250,1.0,0,0,0,3,0,1.0
2440,9,2040,1.75,0,0,400,4,0,1.0
1140,6,1140,1.0,0,0,0,2,0,1.5
3730,10,2810,3.25,1,0,920,4,0,2.0
2940,10,2940,3.5,0,0,0,3,0,2.0
2430,7,2430,2.5,0,0,0,3,0,2.0
2340,8,1700,2.25,0,0,640,4,0,1.0
1440,8,1440,1.75,0,0,0,3,0,1.0
840,6,840,1.0,0,0,0,2,0,1.0
2510,8,2510,2.5,0,0,0,4,0,2.0
2070,7,2070,2.25,0,0,0,3,0,2.0
1010,6,1010,1.0,0,2,0,3,0,1.0
1800,7,950,1.0,1,0,850,4,0,1.0
1930,8,1260,2.0,0,0,670,3,0,1.0
1220,7,1220,1.0,0,0,0,3,0,1.0
2420,9,1500,2.0,0,1,920,3,0,1.0
1410,6,1410,2.5,0,0,0,3,0,1.0
2980,9,2980,3.0,0,0,0,3,0,2.0
2090,7,1550,2.5,0,4,540,3,1,2.0
2370,9,2370,2.5,1,0,0,3,0,2.0
2580,8,2580,2.5,0,0,0,4,0,2.0
1230,8,1010,2.0,0,0,220,3,0,2.0
1400,6,950,1.0,0,0,450,3,0,1.0
1490,7,1490,1.75,1,0,0,2,0,1.0
1310,7,1310,1.0,0,0,0,3,0,1.5
1670,7,1140,3.0,0,0,530,3,0,1.5
1620,8,1620,2.25,0,0,0,3,0,3.0
3020,10,2110,2.25,1,3,910,4,1,1.5
1990,8,1990,1.75,1,0,0,4,0,1.0
1680,8,1180,1.75,0,3,500,3,0,1.0
3140,8,2200,2.5,1,0,940,4,0,2.0
1570,8,1150,1.0,0,0,420,2,0,1.0
2720,9,2720,2.5,0,0,0,4,0,2.0
2180,7,1180,2.5,0,0,1000,4,0,1.0
1200,7,1200,1.0,0,0,0,3,0,1.5
2340,7,1540,2.5,0,0,800,3,0,1.5
1720,7,1450,2.25,0,0,270,3,0,1.5
1880,8,1440,1.5,0,2,440,4,0,1.0
2700,6,1950,3.5,0,2,750,5,0,1.5
1470,6,1470,1.0,0,0,0,2,0,1.0
1300,6,820,1.5,0,0,480,2,0,1.0
4800,11,3480,3.5,1,2,1320,5,0,2.0
2050,7,1330,1.75,0,0,720,4,0,1.0
2060,7,1210,2.75,0,0,850,4,0,1.0
1880,8,1880,2.5,0,0,0,3,0,2.0
2660,10,2660,2.5,1,0,0,4,0,2.0
4120,11,3970,3.5,0,1,150,4,0,2.0
3950,9,2460,3.5,0,0,1490,3,0,1.5
1630,8,1630,2.5,0,0,0,3,0,2.0
2180,9,1630,2.25,0,0,550,4,0,1.0
1300,7,1300,1.75,0,0,0,4,0,1.0
3100,9,3100,2.5,0,0,0,4,0,2.0
2270,8,2270,1.75,0,0,0,3,0,2.0
3030,9,1580,2.5,1,0,1450,4,0,2.0
1830,7,1330,2.25,0,0,500,3,0,1.0
1510,7,1510,1.75,0,0,0,3,0,1.0
2950,9,2950,2.5,0,0,0,4,0,2.0
2070,8,2070,1.75,0,0,0,3,0,1.5
2620,7,2620,2.5,0,3,0,3,0,2.0
1270,7,1100,1.0,0,0,170,2,0,1.0
1890,7,1890,1.0,0,0,0,2,0,1.5
2100,7,1690,2.5,0,0,410,3,0,2.0
1450,6,990,1.0,0,0,460,4,0,1.0
3078,9,3078,2.75,0,0,0,5,0,2.0
3176,9,2726,2.75,0,3,450,3,0,2.0
2020,7,1370,1.75,0,0,650,3,0,1.0
2600,9,2600,2.5,0,0,0,4,0,2.0
1480,8,1480,1.0,0,2,0,3,0,1.0
4080,11,4080,2.5,0,0,0,4,0,2.0
1720,7,1720,2.5,0,0,0,3,0,2.0
2500,8,1550,3.0,1,0,950,5,0,1.0
1160,7,1160,1.0,0,0,0,3,0,1.0
2630,9,2630,3.0,0,0,0,3,0,2.0
2200,8,1640,1.0,0,4,560,4,0,1.0
1720,8,1720,1.75,0,0,0,3,0,1.0
2010,8,2010,2.25,0,0,0,4,0,2.0
1270,7,1030,1.75,0,0,240,3,0,1.0
1730,7,1250,1.0,0,0,480,6,0,1.5
2000,8,2000,2.5,0,0,0,3,0,2.0
1880,8,1880,2.5,0,0,0,3,0,2.0
1340,7,1340,1.5,0,0,0,3,0,1.0
2360,9,2360,2.25,0,0,0,4,0,1.0
2250,9,2250,3.25,0,0,0,3,0,1.0
3030,8,2020,2.5,0,0,1010,4,0,2.0
1630,9,1630,2.0,0,0,0,3,0,1.0
1530,8,1530,2.5,0,0,0,3,0,3.0
2280,8,2280,2.0,0,0,0,4,0,2.0
2920,7,1860,3.0,0,0,1060,10,0,2.0
1110,6,1110,1.0,0,0,0,3,0,1.0
3570,9,3570,2.5,0,0,0,4,0,2.0
3440,9,3440,2.5,0,0,0,3,0,2.0
1270,7,1270,2.0,0,0,0,3,0,1.5
1520,7,1520,1.0,0,0,0,4,0,1.5
4240,8,3410,3.25,0,0,830,5,0,2.0
1610,7,1260,2.0,0,0,350,3,0,1.0
1170,8,1170,2.25,0,0,0,2,0,3.0
1030,7,1030,1.0,0,0,0,3,0,1.0
2390,7,2390,2.5,0,0,0,4,0,2.0
3130,7,3130,2.5,0,0,0,4,0,2.0
1510,7,1510,1.75,0,0,0,3,0,1.0
840,6,840,0.75,0,0,0,1,0,1.5
1850,7,1050,1.75,0,0,800,4,0,1.0
3680,10,3680,2.5,0,0,0,4,0,2.0
1030,6,1030,2.0,0,0,0,2,0,1.0
1130,6,1130,1.0,0,0,0,3,0,1.0
3030,8,1680,2.75,0,0,1350,4,0,1.0
2130,8,2130,2.25,1,0,0,4,0,2.0
1100,6,1100,1.0,0,0,0,3,0,1.0
1050,7,1050,2.0,0,0,0,3,0,1.0
2500,8,1700,2.75,1,0,800,4,0,1.0
940,8,940,1.0,0,0,0,2,0,1.0
1920,7,1320,1.0,0,0,600,3,0,1.0
1100,6,1100,1.0,0,0,0,4,0,1.5
1140,7,1140,1.0,0,0,0,3,0,1.0
3180,10,2610,2.5,1,4,570,2,0,2.0
3220,9,3220,2.5,0,0,0,4,0,2.0
3470,9,2360,2.25,0,1,1110,4,0,1.5
1040,7,1040,1.5,0,0,0,3,0,1.0
1910,7,1100,1.75,1,0,810,3,0,1.0
2891,9,2891,2.5,0,0,0,4,0,2.0
2170,8,2170,2.5,0,0,0,4,0,2.0
2050,8,2050,2.5,0,0,0,4,0,2.0
2050,8,2050,2.5,0,0,0,3,0,2.0
2320,7,1540,1.5,0,0,780,4,0,1.5
1720,7,860,1.0,0,0,860,3,0,1.0
3200,10,3200,2.5,0,0,0,3,0,1.0
2390,7,2140,2.75,0,0,250,4,0,2.0
3030,9,2080,3.0,0,0,950,3,0,1.5
2510,8,1630,2.75,1,0,880,4,0,1.0
1180,8,1180,2.0,0,2,0,3,0,2.0
3230,9,3230,2.75,0,0,0,5,0,2.0
2290,7,1510,1.5,1,0,780,4,0,1.0
2650,7,1400,2.5,0,0,1250,5,0,1.0
2090,7,1480,2.0,0,0,610,4,0,1.0
13540,12,9410,8.0,0,4,4130,7,0,3.0
4110,11,4110,3.25,1,2,0,4,0,2.0
1520,7,1020,1.5,0,0,500,4,0,1.0
1600,7,1050,1.75,0,0,550,3,0,1.0
3180,8,1400,1.0,0,0,1780,3,0,1.0
3680,9,2630,3.25,1,0,1050,5,0,2.0
1440,7,970,1.0,0,0,470,2,0,1.0
770,5,770,1.0,0,0,0,2,0,1.0
3330,9,1750,3.25,1,2,1580,4,0,1.0
1741,8,1741,2.5,0,0,0,3,0,2.0
2660,8,1590,2.75,0,0,1070,4,0,1.5
1710,7,1710,1.75,0,0,0,3,0,1.0
1120,6,720,1.0,0,1,400,2,0,1.0
1610,7,1010,1.75,0,0,600,2,0,1.0
2250,8,1480,2.75,0,0,770,4,0,1.0
1520,7,1520,2.5,0,0,0,3,0,2.0
1000,7,1000,1.0,0,0,0,3,0,1.0
1860,7,1860,1.5,0,0,0,4,0,1.0
1800,8,1800,2.0,1,0,0,3,0,1.0
2360,8,1640,2.25,0,0,720,4,0,1.0
1794,7,1794,2.5,0,0,0,3,0,2.0
2500,10,1910,2.5,1,0,590,3,0,2.0
2064,7,2064,2.0,0,0,0,3,0,2.0
1640,7,1640,2.25,0,0,0,3,0,2.0
2200,8,2200,2.25,0,0,0,4,0,2.0
2200,8,2200,2.75,0,0,0,4,0,2.0
2930,9,1670,1.75,0,3,1260,4,0,1.0
2900,8,2300,3.25,0,0,600,6,0,2.0
2140,8,2140,2.25,0,0,0,4,0,2.0
3160,7,1620,2.75,0,3,1540,4,0,1.0
2100,8,1580,2.5,0,0,520,4,0,3.0
1900,7,1900,2.25,0,0,0,4,0,1.0
580,5,580,1.0,0,0,0,2,0,1.0
2420,9,1820,3.5,0,0,600,3,0,2.0
1210,7,1210,1.5,0,0,0,3,0,1.0
1970,8,1970,2.5,0,0,0,4,0,2.0
1230,8,1080,2.5,0,0,150,3,0,2.0
2190,8,2190,2.5,0,0,0,3,0,2.0
1140,8,1010,2.25,0,0,130,2,0,2.0
3230,7,1750,3.25,0,0,1480,4,0,1.5
1980,9,1980,2.5,1,0,0,3,0,2.0
790,6,790,1.0,0,0,0,1,0,1.0
2600,8,1300,2.75,0,0,1300,4,0,1.0
3530,10,3530,2.25,0,0,0,3,0,2.5
2260,8,2260,2.5,0,0,0,3,0,2.0
1610,7,1110,2.0,0,0,500,3,0,1.0
3030,7,1540,2.75,0,0,1490,5,0,1.0
620,6,620,1.0,0,0,0,2,0,1.0
1210,9,920,2.5,0,0,290,3,0,2.0
1280,6,1280,1.5,0,0,0,3,0,2.0
2710,7,2060,1.75,0,0,650,3,0,1.0
2090,7,2090,1.75,0,0,0,3,0,1.0
2340,7,2340,2.5,0,0,0,5,0,2.0
2230,7,2230,2.5,0,0,0,3,0,2.0
1330,7,1330,1.75,0,0,0,3,0,1.0
1730,7,1730,1.5,0,0,0,4,0,2.0
710,6,710,1.0,0,0,0,2,0,1.0
1560,7,1560,2.5,0,0,0,3,0,2.0
2670,9,2670,3.25,0,2,0,3,0,2.0
1420,8,1420,2.25,0,0,0,3,0,3.0
4160,11,4160,3.75,0,0,0,4,0,2.0
2220,8,2220,2.25,0,0,0,3,0,2.0
1710,7,1400,3.5,0,0,310,3,0,2.0
3090,9,3090,2.5,0,0,0,3,0,2.0
1410,7,1410,2.0,0,0,0,3,0,1.0
1530,7,1530,2.0,0,0,0,3,0,1.0
1800,8,1350,1.75,0,0,450,3,0,1.0
1470,7,1220,1.0,0,0,250,3,0,1.0
4440,10,3240,3.5,1,2,1200,4,0,2.0
1740,8,1740,2.5,0,0,0,3,0,2.0
3230,9,2480,3.25,0,0,750,5,0,2.0
3100,10,3100,2.75,0,0,0,4,0,2.0
2490,8,1240,1.75,1,3,1250,4,0,1.0
2430,7,1330,3.0,0,0,1100,4,0,1.0
1770,8,1770,2.0,0,0,0,3,0,1.0
2578,9,2578,2.5,0,0,0,4,0,2.0
1580,6,790,2.0,0,0,790,3,0,1.0
2650,7,1590,1.75,0,0,1060,3,0,1.5
1740,7,1020,1.0,0,0,720,3,0,1.0
1770,7,1770,1.75,0,0,0,3,0,1.5
1860,8,1860,3.25,0,0,0,3,0,3.0
900,6,900,1.0,0,0,0,1,0,1.0
1070,7,1070,1.0,0,0,0,2,0,1.0
2100,9,2100,2.0,0,0,0,2,0,2.0
980,7,980,1.0,0,0,0,3,0,1.0
2270,8,1500,2.5,1,0,770,4,0,1.0
1120,7,1120,1.75,0,0,0,3,0,1.0
3510,10,3510,3.5,0,0,0,4,0,2.0
2100,8,1600,2.25,1,0,500,5,0,1.0
2480,8,2480,2.5,0,0,0,3,0,2.0
4280,11,2180,3.0,0,4,2100,4,0,1.0
1910,8,1910,1.75,0,0,0,4,0,1.0
730,4,730,1.0,0,0,0,1,0,1.0
1470,7,1030,1.75,0,0,440,3,0,1.0
1850,7,1500,2.5,0,0,350,3,0,1.0
3450,9,3450,3.25,0,0,0,4,0,2.0
1860,7,1860,1.5,0,0,0,3,0,1.0
1140,7,1140,1.0,1,0,0,2,0,1.0
1200,7,600,2.0,0,1,600,3,0,1.0
1870,8,1250,2.5,1,0,620,4,0,1.0
3230,10,3230,3.5,0,0,0,5,0,2.0
720,5,720,1.0,0,0,0,2,0,1.0
890,7,890,1.0,0,0,0,2,0,1.0
1300,7,900,1.75,0,0,400,3,0,1.0
800,8,800,1.5,0,0,0,2,0,2.0
1950,7,1950,2.5,0,0,0,4,0,2.0
2300,9,2300,2.5,0,0,0,3,0,2.0
1540,7,820,1.0,0,0,720,2,0,1.0
840,5,840,1.0,0,0,0,3,0,1.0
2020,7,1480,1.75,0,0,540,3,0,1.0
2520,8,1790,2.0,0,0,730,3,0,1.0
2753,9,2165,2.5,0,2,588,3,1,1.0
1870,7,1870,2.25,0,0,0,3,0,1.0
1984,8,1564,2.5,0,0,420,4,0,1.0
930,5,930,1.0,0,0,0,3,0,1.5
1530,7,1030,1.0,0,0,500,4,0,1.0
2170,8,2170,2.25,0,0,0,4,0,2.0
700,5,700,1.0,0,0,0,2,0,1.0
960,6,960,1.0,0,0,0,3,0,1.0
1980,8,1320,1.75,0,0,660,4,0,1.0
1340,6,1340,1.0,0,0,0,3,0,1.5
1510,7,1070,2.0,0,0,440,3,0,1.0
3740,10,2260,2.5,0,0,1480,4,0,1.0
770,6,770,0.75,0,0,0,1,0,1.0
900,7,900,1.0,0,0,0,2,0,1.0
1640,8,1640,2.5,0,0,0,3,0,2.0
1410,6,1210,1.0,0,0,200,3,0,1.5
740,6,740,1.0,0,0,0,2,0,1.0
2390,9,1760,2.5,0,0,630,4,0,2.0
620,6,620,1.0,0,0,0,1,0,1.0
2610,7,1710,2.75,0,0,900,3,0,2.0
1108,7,1108,2.0,0,0,0,3,0,3.0
1350,7,1060,1.0,0,0,290,2,0,1.0
1850,9,1560,2.5,0,0,290,3,0,2.5
1620,8,1200,2.25,0,0,420,4,0,1.0
1350,7,1350,2.5,0,0,0,3,0,2.0
1320,7,1320,1.75,0,0,0,2,0,1.0
1450,7,1450,2.0,0,0,0,3,0,1.0
1840,7,1240,1.75,0,0,600,3,0,1.0
1640,7,1110,1.75,0,0,530,3,0,1.0
770,6,770,1.0,0,0,0,2,0,1.0
1750,8,1750,1.75,0,1,0,3,0,1.0
3770,9,2890,3.75,0,0,880,4,0,2.5
2550,7,1560,2.25,0,0,990,4,0,1.0
1260,7,1260,1.75,0,0,0,3,0,1.0
2180,7,1340,1.5,0,0,840,5,0,1.5
1420,7,1420,2.0,0,0,0,3,0,1.5
1260,6,1260,1.75,0,0,0,4,0,1.0
2630,9,2630,2.25,0,0,0,3,0,2.0
940,7,940,1.0,0,0,0,3,0,1.0
1890,8,1890,2.25,0,0,0,4,0,1.0
960,6,960,1.0,0,0,0,2,0,1.0
2390,8,1440,2.5,0,2,950,3,0,1.0
1350,6,950,1.0,0,0,400,2,0,1.0
2650,8,2650,1.75,1,0,0,5,0,1.0
2670,9,2670,2.5,0,0,0,5,0,2.0
2820,9,2820,2.5,0,0,0,4,0,2.0
1990,10,1520,2.5,0,0,470,3,0,2.0
2660,8,2180,2.25,0,0,480,4,0,1.0
1280,6,1280,1.0,0,0,0,3,0,1.0
1820,7,1230,1.75,0,0,590,3,0,1.0
2570,7,2570,2.5,0,0,0,4,0,2.0
1740,7,1740,2.0,0,0,0,3,0,1.0
930,7,930,1.0,0,0,0,2,0,1.0
1510,8,1310,1.0,0,0,200,2,0,1.5
2720,8,1860,3.5,0,0,860,5,0,2.0
3990,11,3990,3.25,1,0,0,4,0,2.0
2080,7,1550,2.25,0,0,530,3,0,1.5
1700,8,1700,2.25,0,0,0,2,0,2.0
1850,7,1850,2.25,0,0,0,4,0,1.0
1175,8,740,2.5,0,0,435,2,0,2.0
2500,9,2500,1.75,0,0,0,3,0,1.0
2000,7,2000,2.0,0,0,0,3,0,2.0
2870,7,2330,3.0,0,0,540,6,0,2.0
2520,7,2520,2.5,0,0,0,3,0,1.5
1200,7,1200,1.0,0,0,0,3,0,1.0
1160,7,1160,1.0,0,0,0,3,0,1.0
2970,8,2970,2.5,0,0,0,4,0,2.0
1310,7,1170,1.5,0,0,140,3,0,1.0
1320,6,840,1.5,0,0,480,3,0,1.0
2630,8,2630,2.5,0,0,0,4,0,3.0
4600,9,3600,2.5,1,2,1000,5,0,1.5
1920,8,1920,1.75,0,0,0,4,0,2.0
1920,7,1920,2.5,0,0,0,3,0,2.0
1840,7,920,2.0,0,0,920,3,0,1.0
930,6,930,1.0,0,0,0,2,0,1.0
1280,7,1280,1.0,1,0,0,2,0,1.0
2598,9,2598,2.5,0,0,0,4,0,2.0
2500,7,1680,2.0,0,0,820,3,0,1.5
1040,7,1040,1.0,0,0,0,3,0,1.0
2300,9,2300,2.5,0,0,0,4,0,2.0
2580,9,2580,2.5,0,0,0,4,0,2.0
1640,9,1640,2.0,0,0,0,4,0,1.5
3940,9,3940,3.25,0,0,0,5,0,2.0
720,7,720,1.0,0,0,0,1,0,1.0
2800,10,2800,2.75,0,0,0,4,0,2.0
2110,7,1380,1.75,0,0,730,3,0,1.0
2950,10,2950,2.5,0,0,0,4,0,2.0
1590,7,1590,1.0,0,0,0,3,0,1.0
2710,7,2710,2.5,0,0,0,4,0,2.0
2060,8,2060,2.25,1,0,0,3,0,1.0
2240,7,1120,2.0,0,0,1120,4,0,1.0
6500,11,5180,5.25,1,0,1320,4,0,2.0
1710,7,1710,2.5,0,0,0,5,0,1.5
2710,10,2220,3.5,0,0,490,4,0,2.0
1650,7,1040,1.75,0,0,610,3,0,1.0
1560,8,1560,1.75,0,0,0,3,0,1.0
1120,7,1120,1.75,0,0,0,2,0,2.0
830,7,830,1.0,0,0,0,2,0,1.0
3570,9,3570,2.5,0,0,0,3,0,2.0
1530,8,1050,2.5,0,0,480,3,0,2.0
1460,7,1460,2.0,0,0,0,3,0,1.0
2100,7,1100,1.75,0,0,1000,4,0,1.0
1300,8,880,2.5,0,0,420,3,0,2.0
2570,9,2570,2.25,0,0,0,3,0,1.0
1170,7,1170,2.0,0,0,0,4,0,1.0
970,6,970,1.0,0,0,0,3,0,1.0
1390,6,1390,1.5,0,0,0,3,0,1.0
1180,7,1180,1.5,0,0,0,3,0,3.0
1010,7,1010,1.0,0,0,0,3,0,1.0
1680,5,840,2.0,0,0,840,5,0,1.0
2680,9,2680,2.25,0,0,0,3,0,1.0
1810,7,1810,2.0,0,0,0,3,0,1.5
2550,9,2550,2.5,0,0,0,4,0,2.0
2060,7,1260,1.0,0,0,800,2,0,1.0
3200,9,2670,3.5,0,0,530,4,0,2.0
1430,7,900,1.75,0,0,530,3,0,1.0
1510,7,910,2.0,0,0,600,3,0,1.0
1494,8,1494,3.5,0,0,0,3,0,3.0
1250,7,1030,2.5,0,0,220,2,0,2.0
3440,9,1760,2.5,0,2,1680,5,0,1.0
3160,9,3160,2.75,1,0,0,4,0,2.0
2940,9,1870,2.5,0,2,1070,4,0,2.0
3130,8,3130,2.75,0,0,0,4,0,2.0
1280,6,1280,1.0,0,0,0,4,0,1.0
2130,7,1330,2.5,0,0,800,5,0,1.0
1840,8,1840,1.75,0,0,0,3,0,1.0
2110,8,2110,1.75,1,0,0,3,0,1.0
2290,9,2290,2.5,0,0,0,3,0,3.0
1020,7,1020,1.0,0,0,0,3,0,1.0
920,6,920,1.0,0,0,0,2,0,1.0
970,6,970,1.0,0,0,0,3,0,1.0
2790,8,2790,2.25,0,3,0,3,0,1.0
1110,8,1110,2.25,0,0,0,2,0,3.0
1040,7,580,0.75,0,1,460,1,0,1.0
1370,7,1370,1.75,0,0,0,3,0,1.0
920,5,920,1.0,0,0,0,2,0,1.0
2100,7,2100,2.5,0,0,0,4,0,2.0
1930,9,1930,1.75,0,0,0,4,0,1.0
2530,8,2010,2.5,0,2,520,4,0,2.0
1480,7,1080,1.75,0,0,400,3,0,1.0
1070,7,1070,1.0,0,0,0,2,0,1.0
1420,8,1040,3.0,0,0,380,3,0,2.0
2080,8,2080,1.75,0,0,0,3,0,2.0
2510,7,1260,2.5,0,0,1250,5,0,1.0
1060,7,940,1.0,0,0,120,3,0,1.0
1280,7,1280,1.75,0,0,0,2,0,1.0
2710,9,2710,3.0,0,0,0,4,0,2.5
2450,8,2450,3.0,0,0,0,4,0,2.0
1180,7,1180,1.0,0,0,0,3,0,1.0
1960,8,1460,2.5,0,0,500,3,0,1.0
2270,6,1300,2.75,0,0,970,3,0,1.5
2170,7,1110,1.75,0,0,1060,3,0,1.0
2720,11,2720,2.25,0,0,0,3,0,2.0
1570,8,1570,2.5,0,0,0,3,0,2.0
1490,7,1490,2.5,0,0,0,0,0,2.0
2860,8,1640,2.25,0,0,1220,4,0,1.0
1580,7,1580,2.5,0,0,0,3,0,2.0
750,5,750,1.5,0,0,0,2,0,1.0
1950,7,1950,1.75,0,0,0,4,0,1.0
1890,7,1190,2.25,0,0,700,3,0,1.0
2990,11,2990,2.5,0,0,0,4,0,2.0
1820,7,1120,2.5,0,0,700,4,0,1.0
4230,10,3450,4.25,1,0,780,5,0,2.0
3440,10,3440,2.5,0,0,0,4,0,2.0
830,7,830,1.5,0,0,0,2,0,2.0
2380,6,1380,1.75,0,0,1000,3,0,1.0
1340,8,1340,2.5,0,0,0,2,0,3.0
1750,6,1070,2.0,0,1,680,4,0,1.0
1910,8,1530,2.5,0,0,380,3,0,2.5
620,5,620,1.0,0,0,0,1,0,1.0
2850,9,2850,2.25,0,0,0,4,0,2.0
2840,10,1920,3.5,0,0,920,4,0,2.0
3660,9,1830,2.0,0,3,1830,3,0,1.0
740,7,740,1.0,0,0,0,2,0,1.0
1720,7,1720,1.5,0,0,0,5,0,1.0
2530,9,2530,2.5,0,0,0,3,0,2.0
2280,8,2280,2.5,0,0,0,4,0,2.0
2590,9,2590,3.25,0,0,0,4,0,3.0
1700,7,1100,1.5,0,0,600,3,0,1.0
1410,7,960,1.0,0,0,450,5,0,1.0
1770,8,1770,2.0,0,0,0,3,0,1.0
1780,7,1230,2.25,1,0,550,3,0,1.0
1180,6,1180,2.0,0,0,0,2,0,2.0
3400,9,2290,3.25,0,0,1110,3,0,2.0
860,7,860,1.0,1,0,0,2,0,1.0
1760,7,1140,2.75,0,0,620,4,0,1.0
2180,8,1520,2.25,1,0,660,3,0,1.5
1430,7,1430,1.5,0,0,0,3,0,1.0
600,3,600,0.0,0,0,0,1,0,1.0
1740,6,580,1.75,0,0,1160,2,0,1.0
2900,7,2040,2.75,0,0,860,4,0,2.0
1910,7,1910,2.5,0,0,0,4,0,2.0
2840,7,1710,3.0,0,0,1130,5,0,1.0
2600,8,1490,2.25,0,2,1110,3,0,1.0
2400,7,1500,1.75,0,0,900,4,0,1.5
1650,7,1010,1.75,0,0,640,4,0,1.0
870,7,870,1.0,0,0,0,2,0,1.0
1270,8,1270,1.5,0,0,0,3,0,3.0
1230,7,1230,1.75,0,0,0,3,0,1.0
1330,5,1330,1.0,0,0,0,3,0,1.5
2490,8,1670,2.5,0,0,820,3,0,2.0
1400,7,1140,2.25,0,0,260,3,0,1.0
2120,8,1830,3.0,0,3,290,4,0,2.0
2850,10,1990,2.5,0,0,860,3,0,2.0
610,5,610,1.0,0,0,0,2,0,1.0
1910,7,1910,2.25,0,0,0,4,0,2.0
1280,8,1040,3.5,0,0,240,3,0,2.0
2020,8,2020,1.75,1,0,0,3,0,1.0
2940,8,1640,3.0,0,0,1300,4,0,1.0
1850,7,1850,1.75,0,0,0,3,0,1.0
1490,7,1490,1.5,0,0,0,4,0,2.0
1020,6,920,1.0,0,0,100,3,0,1.5
4010,11,4010,3.25,0,0,0,4,0,2.0
2450,7,1240,2.0,0,0,1210,5,0,1.0
2840,8,1470,2.5,0,0,1370,5,0,1.0
1650,7,1650,2.75,0,0,0,3,0,2.0
1610,7,1090,1.5,0,2,520,3,0,1.0
1530,8,1280,3.25,0,0,250,3,0,2.0
2000,8,1320,1.75,0,0,680,3,0,1.0
1950,8,1950,2.25,0,0,0,3,0,2.0
2590,9,2590,2.5,0,0,0,4,0,2.0
3610,8,3210,2.5,0,0,400,6,0,2.0
1120,6,1120,1.5,0,0,0,2,0,1.0
2840,8,2840,2.5,0,0,0,4,0,2.0
1770,8,1770,1.75,0,0,0,3,0,1.0
2180,7,2180,2.5,0,0,0,4,0,2.0
3900,10,3900,3.5,1,0,0,4,0,2.0
2060,8,2060,2.25,0,0,0,5,0,2.5
1280,8,1080,2.25,0,0,200,3,0,2.0
2230,9,2230,2.5,0,3,0,3,0,3.0
1770,7,1770,2.5,0,0,0,4,0,2.0
2020,8,1320,1.75,0,0,700,3,0,1.0
1820,6,910,1.75,0,0,910,2,0,1.0
920,6,920,1.0,0,0,0,2,0,1.0
1680,8,1680,1.75,0,0,0,3,0,1.0
2610,8,2610,2.5,0,0,0,4,0,2.0
1750,7,1750,1.0,1,0,0,4,0,1.5
1540,7,1200,1.0,0,0,340,3,0,1.5
2970,8,2970,2.5,0,0,0,4,0,2.0
1040,6,1040,1.0,0,0,0,3,0,2.0
2660,8,1330,1.75,0,0,1330,3,0,1.0
1220,7,1220,1.5,0,0,0,2,0,3.0
8010,12,5990,5.25,1,4,2020,5,1,2.0
860,6,860,1.5,0,0,0,3,0,1.0
1510,8,1510,1.75,0,0,0,2,0,1.0
1450,8,1450,1.75,0,0,0,3,0,1.0
3590,10,3590,3.0,0,0,0,4,0,2.0
2580,8,1660,2.5,0,0,920,4,0,1.0
3540,9,3540,2.75,0,0,0,4,0,2.0
1540,7,1540,1.0,0,0,0,4,0,1.5
2060,8,2060,2.5,0,0,0,3,0,2.0
2710,7,1460,2.0,0,0,1250,4,0,1.0
3170,9,3170,2.75,0,0,0,5,0,2.0
1930,7,1200,3.0,0,0,730,4,0,1.0
1710,7,1030,2.0,0,0,680,3,0,1.0
3720,8,1860,2.25,0,2,1860,4,0,1.0
1430,8,1430,3.0,0,0,0,3,0,3.0
1900,7,1900,2.5,0,0,0,3,0,2.0
1800,7,1800,2.5,0,0,0,3,0,2.0
1780,7,1250,2.5,0,0,530,3,0,1.0
870,7,870,1.0,0,0,0,2,0,1.0
4320,8,2160,2.5,0,0,2160,5,0,1.0
2480,9,2480,2.5,1,0,0,3,0,2.0
2430,8,2430,2.5,0,0,0,3,0,2.0
1730,8,1730,2.5,0,0,0,3,0,2.0
1710,8,1360,3.25,0,0,350,3,0,2.0
2890,9,2190,2.75,0,0,700,4,0,1.5
2120,7,1060,1.75,0,0,1060,4,0,1.0
1780,7,890,1.75,0,0,890,2,0,1.0
810,6,810,1.0,0,0,0,2,0,1.0
1900,8,1330,1.75,0,1,570,3,0,1.0
1770,7,1270,1.75,0,0,500,3,0,1.0
1770,8,1770,2.5,0,0,0,3,0,3.0
2450,8,1490,2.5,0,0,960,4,0,1.5
700,4,700,1.0,0,0,0,2,0,1.0
850,6,850,1.0,0,0,0,2,0,1.0
2650,9,2650,2.5,0,0,0,5,0,2.0
4030,9,4030,3.5,0,0,0,4,0,3.0
1780,8,1780,2.25,0,0,0,3,0,2.0
1530,7,1410,1.75,0,0,120,3,0,1.0
1550,7,1000,1.5,0,0,550,4,0,1.0
1200,6,1200,1.0,0,0,0,3,0,1.0
2060,7,1220,2.5,0,0,840,4,0,1.0
1630,7,1630,2.5,0,0,0,4,0,2.0
1120,7,1120,1.0,0,0,0,4,0,1.0
4560,12,2230,3.5,1,3,2330,4,0,1.0
1800,7,1800,1.5,0,0,0,3,0,1.0
3820,9,2040,2.5,0,0,1780,6,0,1.0
2200,7,2200,1.75,0,2,0,3,0,2.0
1530,9,1530,2.0,0,0,0,3,0,3.0
2550,7,1300,2.5,0,0,1250,4,0,1.0
1790,8,1240,2.5,0,2,550,4,0,1.0
1480,7,1240,1.5,0,0,240,2,0,2.0
1450,7,1450,2.5,0,0,0,3,0,2.0
1350,7,1350,1.75,0,0,0,3,0,1.0
4020,10,4020,4.5,1,0,0,4,0,2.0
2495,7,2495,2.5,0,0,0,4,0,2.0
3100,7,1820,2.5,0,0,1280,3,0,1.0
2800,8,1680,2.25,0,0,1120,4,0,1.0
1540,7,1180,2.25,0,0,360,3,0,1.0
1440,7,940,2.25,0,0,500,3,0,1.0
1470,8,1160,2.5,0,0,310,3,0,2.0
940,7,940,1.0,0,0,0,3,0,1.5
2090,7,2090,2.25,0,0,0,3,0,1.0
1220,6,1220,1.5,0,0,0,3,0,1.5
2210,8,2210,2.5,0,0,0,3,0,2.0
3320,10,2040,3.5,1,2,1280,4,0,1.0
1750,7,1750,1.75,0,0,0,3,0,1.0
2230,7,1180,2.5,0,0,1050,4,0,1.0
1560,8,1560,3.0,0,0,0,3,0,3.0
1900,8,1900,2.0,0,0,0,3,0,1.0
2807,8,2807,2.5,0,0,0,4,0,2.0
2570,8,1750,3.0,0,0,820,4,0,2.0
1930,8,1930,2.5,0,0,0,3,0,1.0
2490,7,2490,2.5,0,0,0,4,0,2.0
2590,8,1340,2.25,0,0,1250,4,0,1.0
1390,7,1390,1.75,1,0,0,3,0,1.0
2430,7,1570,2.5,0,0,860,3,0,1.0
1010,7,1010,1.75,0,0,0,3,0,1.0
2390,7,2390,2.75,0,0,0,4,0,2.0
2460,7,1700,3.0,0,0,760,4,0,1.0
1480,8,1480,1.75,0,2,0,3,0,1.0
1640,6,820,2.0,0,0,820,4,0,1.0
1920,8,1010,2.75,0,0,910,4,0,1.0
1610,7,950,1.75,0,0,660,2,0,1.0
1520,8,1520,1.0,0,0,0,3,0,1.5
3670,10,3670,2.5,0,0,0,4,0,2.0
2050,8,2050,1.75,1,0,0,3,0,1.0
1680,7,1290,1.75,0,0,390,3,0,1.0
1350,8,1270,2.5,0,0,80,3,0,3.0
1430,7,1430,1.0,0,0,0,2,0,1.0
2580,9,2580,2.5,0,0,0,3,0,2.0
2300,8,1550,2.25,0,0,750,3,0,1.0
1960,7,1050,2.0,0,0,910,4,0,1.0
1730,7,880,1.75,0,0,850,4,0,1.0
1980,7,1980,2.5,0,0,0,3,0,2.0
3370,7,3370,2.5,0,0,0,5,0,2.0
1670,8,1670,2.5,0,0,0,3,0,2.0
2750,10,2750,2.5,0,0,0,4,0,2.0
3510,10,3510,3.5,0,0,0,4,0,2.0
2120,8,2120,2.5,0,0,0,4,0,2.0
1310,7,1310,1.5,0,0,0,3,0,1.0
1590,7,1060,1.0,0,0,530,3,0,1.0
2310,8,1780,2.25,1,0,530,4,0,1.0
2480,8,2480,2.5,0,3,0,3,1,1.5
2330,8,2080,1.75,0,0,250,5,0,1.5
1430,7,1430,1.75,0,0,0,3,0,1.0
1522,8,1248,3.5,0,0,274,3,0,2.0
2310,9,2310,2.5,0,0,0,4,0,2.0
3320,9,3320,2.75,0,0,0,4,0,2.0
3460,7,3460,2.5,0,0,0,3,0,2.0
1030,5,1030,1.0,0,0,0,3,0,1.5
1340,7,1340,1.0,0,0,0,3,0,1.5
4110,10,2230,3.5,0,1,1880,3,0,1.0
2290,7,1390,1.75,0,0,900,4,0,1.0
1520,7,1520,1.5,1,0,0,3,0,1.0
2380,8,1680,2.75,0,0,700,4,0,1.0
2020,7,2020,2.25,0,0,0,3,0,2.0
2690,8,2690,3.0,0,0,0,4,0,1.0
1240,6,1240,1.0,0,0,0,2,0,1.5
1640,8,1640,1.75,0,2,0,3,0,1.0
1540,7,1540,1.0,0,0,0,3,0,1.5
1960,7,980,1.75,0,0,980,3,0,1.0
710,6,710,1.0,0,0,0,1,0,1.0
1129,7,1129,1.0,0,0,0,2,0,1.0
2475,7,2475,2.75,0,0,0,4,0,2.0
3320,9,3320,3.0,0,0,0,5,0,2.0
1690,7,1140,1.5,0,0,550,3,0,1.0
1840,7,1570,1.75,0,0,270,2,0,1.0
3280,9,3280,2.5,0,0,0,4,0,2.0
2040,7,1410,1.75,0,0,630,3,0,1.0
1720,8,1220,1.75,0,1,500,3,0,1.0
1430,6,980,1.0,0,0,450,4,0,1.0
2670,9,2670,2.5,1,0,0,3,0,2.0
1770,7,1770,2.5,0,0,0,3,0,2.0
3630,10,3630,2.5,0,0,0,4,0,2.0
1970,7,1970,2.5,0,0,0,4,0,2.0
2170,8,2170,2.5,0,0,0,3,0,2.0
3310,9,3310,2.25,0,0,0,4,0,2.0
1410,7,1180,2.5,0,0,230,3,0,2.0
1600,7,1600,1.5,0,0,0,3,0,1.0
1850,6,1740,1.0,0,0,110,3,0,2.0
1540,7,1360,3.5,0,0,180,3,0,2.0
720,6,720,1.0,0,0,0,2,0,1.0
2490,7,1690,2.0,0,0,800,4,0,1.0
2240,8,2240,2.5,1,2,0,3,0,2.0
2020,7,2020,2.5,0,0,0,4,0,2.0
2100,8,2100,2.0,0,0,0,4,0,2.0
2450,9,2450,2.75,0,0,0,3,0,2.0
2060,8,1440,2.5,0,0,620,4,0,1.0
1720,9,1240,2.25,0,0,480,3,0,2.0
5400,11,5400,3.75,0,0,0,3,0,2.0
3420,9,3420,2.5,0,0,0,4,0,2.0
3070,7,2360,2.75,0,1,710,3,0,2.0
2640,9,1840,3.25,0,0,800,3,0,2.0
1830,7,1230,2.0,0,0,600,2,0,1.0
1560,7,1030,2.75,0,0,530,3,0,1.0
1340,7,1340,2.5,0,0,0,3,0,1.0
2520,7,2520,2.75,0,4,0,6,1,2.0
1010,7,1010,1.0,0,0,0,2,0,1.0
1130,7,1130,1.0,0,0,0,3,0,1.0
3190,9,3190,2.5,0,0,0,3,0,2.0
1400,8,1400,1.5,0,0,0,3,0,3.0
1610,7,1610,2.0,0,0,0,4,0,1.0
2980,10,2640,3.0,0,0,340,4,0,2.0
2080,7,1300,1.5,0,0,780,3,0,1.0
2620,9,2620,2.5,0,0,0,4,0,2.0
1950,8,1370,1.75,0,0,580,4,0,1.0
1850,7,1850,2.25,0,0,0,3,0,2.0
2220,7,1110,2.0,0,0,1110,3,0,1.0
2900,8,1830,3.0,0,0,1070,5,0,1.0
5370,10,3850,3.25,1,0,1520,5,0,2.0
1210,7,1090,1.0,0,0,120,3,0,1.5
3950,8,3950,2.75,1,0,0,4,0,2.0
1360,7,1200,1.0,0,0,160,2,0,1.0
1480,8,1480,2.5,0,0,0,3,0,2.0
1050,7,1050,2.75,0,0,0,3,0,1.0
2330,9,1300,3.0,0,0,1030,3,0,1.0
2340,8,2340,1.75,1,0,0,3,0,1.0
3350,8,2510,3.25,0,0,840,5,0,2.0
1480,8,1480,1.75,0,0,0,3,0,1.5
2290,9,2290,2.5,1,0,0,3,0,2.0
1700,7,1450,1.75,0,2,250,3,0,1.5
2560,8,2220,2.75,0,2,340,5,0,1.5
2130,8,1580,1.75,0,0,550,3,0,1.0
3010,9,1260,2.5,1,3,1750,2,0,1.0
2190,9,2190,2.5,0,0,0,3,0,2.0
1610,7,910,1.75,0,0,700,3,0,1.0
2800,7,2800,3.5,0,0,0,5,0,2.0
4260,11,4260,3.0,1,2,0,4,0,2.0
1140,7,1140,1.5,0,0,0,3,0,2.0
4140,10,4140,4.5,0,0,0,5,0,2.0
3900,10,2520,3.0,1,4,1380,4,0,1.0
1550,7,1550,2.0,0,0,0,2,0,1.5
2520,8,2520,2.5,0,0,0,4,0,2.0
760,6,760,1.0,0,0,0,2,0,1.5
1626,8,1419,2.5,0,0,207,3,0,2.5
2480,8,1240,2.5,0,0,1240,4,0,1.0
1780,7,1780,2.5,0,0,0,3,0,2.0
1800,7,1800,2.25,0,0,0,4,0,2.0
2540,9,2540,2.5,0,0,0,4,0,2.0
2350,9,1650,3.0,0,0,700,4,0,1.0
1440,7,1200,2.0,0,0,240,4,0,1.0
5490,12,2910,3.5,1,4,2580,4,0,1.0
3160,10,3160,2.5,1,0,0,4,0,2.0
1580,7,1180,1.5,0,0,400,3,0,1.5
1480,7,870,1.75,0,0,610,3,0,1.0
2190,8,1380,1.75,0,2,810,5,0,1.0
1800,7,1350,2.5,0,0,450,3,0,1.0
1900,7,1300,1.5,0,0,600,3,0,1.5
4090,10,2090,3.0,1,2,2000,5,0,1.0
1040,7,1040,1.0,0,2,0,3,0,1.5
1610,8,1610,2.5,0,0,0,3,0,3.0
2860,8,1430,2.25,0,0,1430,4,0,1.0
1300,6,1300,1.0,0,0,0,3,0,1.0
2230,7,1450,2.5,0,0,780,4,0,1.0
2100,8,2100,2.25,0,1,0,3,0,2.0
2190,9,1540,3.25,0,0,650,4,0,2.0
2150,8,1550,2.5,0,0,600,3,0,1.0
1460,7,1460,1.0,0,0,0,4,0,1.5
1620,8,1320,1.0,0,4,300,2,0,1.0
2350,7,1450,2.0,0,0,900,4,0,1.5
1070,7,900,2.5,0,0,170,3,0,2.0
2110,7,1670,3.0,0,0,440,5,0,2.0
2700,8,1560,1.75,0,2,1140,3,0,1.0
2420,8,1420,2.75,0,1,1000,4,0,1.0
1740,8,1320,2.5,0,0,420,3,0,2.0
1690,7,1690,1.5,1,0,0,3,0,1.5
2310,7,1890,1.5,1,0,420,4,0,1.0
710,6,710,1.0,0,2,0,2,0,1.0
1690,8,1370,3.5,0,0,320,3,0,2.0
3050,8,3050,2.75,0,0,0,5,0,2.0
2220,7,1640,2.0,0,0,580,3,0,1.0
1720,7,1720,2.5,0,0,0,3,0,1.0
830,6,830,1.0,0,0,0,2,0,1.0
840,6,840,1.0,0,0,0,3,0,1.0
2160,7,1080,2.5,0,0,1080,4,0,1.0
1200,7,1200,1.0,0,0,0,3,0,1.0
1500,7,1500,2.5,0,0,0,3,0,2.0
2380,8,2380,2.5,0,0,0,3,0,2.0
2700,9,2070,3.25,0,2,630,5,0,2.0
2620,7,2620,2.0,0,3,0,3,0,1.0
2980,9,2980,2.5,0,0,0,4,0,2.0
2110,8,1270,2.5,0,0,840,4,0,1.0
1610,7,1610,1.75,0,0,0,3,0,1.0
1250,8,1250,2.5,0,0,0,3,0,3.0
3120,11,3120,2.5,0,4,0,5,0,2.0
2670,8,1610,2.25,1,0,1060,4,0,1.0
1600,7,1150,1.0,0,0,450,3,0,1.0
750,6,750,1.0,0,0,0,2,0,1.0
1120,7,1120,1.0,0,0,0,3,0,1.0
1010,7,1010,1.0,0,0,0,3,0,1.0
1190,8,1190,2.25,0,0,0,3,0,3.0
3080,8,2310,3.5,0,0,770,5,0,2.0
1560,7,790,2.0,0,0,770,3,0,1.0
3370,9,3370,2.5,0,0,0,4,0,2.0
1340,7,1340,1.0,0,0,0,4,0,1.5
980,7,780,1.0,0,0,200,2,0,1.0
2260,8,1700,2.5,0,0,560,3,0,2.0
3370,9,3370,2.75,0,0,0,5,0,2.0
900,7,900,1.0,0,0,0,2,0,1.0
3890,9,2870,3.5,0,1,1020,5,0,2.0
1400,8,1400,1.5,0,0,0,3,0,3.0
1150,7,1150,1.0,0,0,0,3,0,1.0
2990,8,2990,2.75,0,0,0,5,0,2.0
1400,7,1400,2.0,0,0,0,4,0,1.0
1530,7,1240,2.25,0,0,290,3,0,1.0
2120,8,1450,2.5,1,0,670,4,0,1.0
1000,7,1000,1.0,0,0,0,3,0,1.0
2680,7,1870,3.0,0,0,810,5,0,2.0
2390,8,1620,2.75,0,2,770,4,0,1.0
1460,8,1460,3.5,0,0,0,4,0,3.0
2460,8,1560,2.5,0,0,900,4,0,1.0
2950,8,2950,3.5,0,0,0,5,0,3.0
1760,8,1760,1.75,0,0,0,4,0,1.5
2220,7,1110,1.75,0,0,1110,3,0,1.0
1780,7,1030,1.5,0,4,750,3,0,1.0
2240,7,1120,1.0,0,0,1120,4,0,1.0
1260,7,1260,2.25,0,0,0,3,0,2.0
3530,9,1840,2.25,1,3,1690,3,1,1.0
1440,7,1440,2.0,0,0,0,3,0,1.0
1080,7,1080,2.0,0,0,0,3,0,1.0
2030,9,2030,2.5,0,0,0,3,0,2.0
2290,7,1330,1.5,0,0,960,4,0,1.0
1650,8,1650,2.0,0,0,0,3,0,2.0
1270,6,1270,1.0,0,0,0,2,0,1.0
2050,8,2050,1.75,0,0,0,3,0,2.0
2510,10,2510,2.5,0,2,0,3,0,2.0
1200,7,1200,1.5,0,0,0,3,0,1.0
1640,8,1640,2.25,0,0,0,2,0,2.0
1890,8,1640,3.5,0,0,250,3,0,2.0
1960,8,1960,2.5,0,0,0,3,0,2.0
3490,8,2590,2.5,0,0,900,3,0,2.0
3120,9,2370,3.25,0,0,750,4,0,2.0
2280,7,2280,2.0,0,0,0,5,0,2.0
1150,7,1150,1.5,0,1,0,2,0,1.0
2090,8,1490,2.25,0,0,600,4,0,1.0
2570,8,2570,1.75,0,2,0,3,0,1.0
2350,7,1180,1.75,0,0,1170,3,0,1.0
1420,6,1420,1.0,0,0,0,3,0,1.0
1500,8,1500,2.5,0,0,0,3,0,2.0
2420,7,2420,2.5,0,0,0,2,0,2.0
1620,8,1540,2.25,0,0,80,3,0,3.0
2650,9,2650,2.75,0,0,0,3,0,1.0
1310,7,1310,1.5,0,0,0,4,0,1.5
1350,6,1350,1.0,0,0,0,3,0,1.0
2080,7,1040,1.75,0,0,1040,3,0,1.0
1160,7,1160,1.5,0,0,0,2,0,1.0
1570,8,1570,2.25,0,0,0,3,0,2.0
1570,5,1570,1.0,0,0,0,3,0,1.5
840,5,840,1.0,0,0,0,3,0,1.0
1810,7,1070,2.5,0,0,740,3,0,1.0
1980,7,1980,1.75,0,0,0,3,0,1.0
1270,8,1270,1.75,0,0,0,2,0,2.0
1840,7,1210,1.75,0,0,630,4,0,1.0
1190,6,1190,2.0,0,0,0,3,0,1.5
970,7,970,1.0,0,0,0,2,0,1.0
2206,6,866,2.25,0,2,1340,3,0,1.0
1460,7,1460,1.75,0,0,0,3,0,2.0
2110,7,1480,1.75,0,0,630,3,0,1.0
2300,8,2300,2.5,0,0,0,4,0,2.0
1820,7,1820,2.5,0,0,0,4,0,2.0
1880,7,1810,2.75,0,0,70,3,0,2.0
3690,11,3690,2.5,0,0,0,4,0,2.0
3890,9,3150,3.25,0,0,740,4,0,1.5
1770,8,1300,1.75,0,0,470,3,0,1.0
1680,7,1100,1.75,0,0,580,4,0,1.0
1840,7,1840,1.5,0,0,0,4,0,1.5
2440,7,1880,2.25,0,0,560,4,0,1.0
3180,9,3180,2.25,0,0,0,4,0,2.0
2180,8,2000,1.75,0,2,180,4,0,1.0
1550,7,1550,2.0,0,0,0,2,0,1.5
1890,8,1890,2.5,0,0,0,3,0,2.0
3040,9,3040,2.5,0,0,0,3,0,2.0
2320,8,2320,2.5,0,0,0,3,0,2.0
2690,7,2690,2.5,0,0,0,5,0,2.0
1580,6,790,1.5,0,0,790,4,0,1.0
3160,9,1780,2.5,1,0,1380,5,0,1.0
1310,7,1310,1.0,0,0,0,3,0,1.0
1810,7,1500,1.5,0,0,310,4,0,1.0
2040,8,1680,1.0,0,3,360,3,0,1.0
3910,10,3910,3.25,1,0,0,4,0,2.0
2170,7,1280,2.5,0,0,890,3,0,1.5
3000,7,2110,2.5,0,0,890,3,0,1.5
1680,7,1140,1.0,0,0,540,2,0,1.0
780,4,780,0.75,0,0,0,2,0,1.0
1640,7,1640,2.0,0,0,0,3,0,1.0
2820,8,2820,2.5,0,0,0,4,0,2.0
1120,7,950,1.0,0,0,170,2,0,1.0
1500,8,1500,1.0,0,0,0,3,0,1.0
1780,6,1080,1.5,0,0,700,4,0,2.0
840,7,840,1.0,0,0,0,2,0,1.0
2470,8,2470,2.5,0,0,0,3,0,2.0
1400,8,1400,2.0,0,0,0,2,0,1.0
3450,8,3450,3.25,0,0,0,4,0,2.0
1730,8,1730,1.75,0,0,0,3,0,1.0
2820,7,2320,3.25,0,0,500,5,0,1.5
830,6,830,1.0,0,3,0,2,1,1.0
3130,9,2210,3.25,0,0,920,3,0,1.0
1530,7,1210,1.0,0,0,320,3,0,1.0
800,5,800,1.0,0,0,0,2,0,1.0
1100,7,1100,1.0,0,0,0,3,0,2.0
2000,7,1110,1.75,0,0,890,3,0,1.0
1961,7,1961,2.5,0,0,0,4,0,2.0
1750,7,1750,1.75,0,0,0,3,0,1.0
3040,8,3040,2.5,0,0,0,4,0,2.0
1370,6,1370,1.0,0,0,0,3,0,1.0
1790,7,1340,2.25,0,0,450,3,0,1.0
3510,10,3510,2.5,1,0,0,4,0,2.0
1990,7,1090,1.75,0,0,900,3,0,1.0
1710,7,1410,1.0,0,0,300,4,0,1.5
1310,7,850,2.5,0,0,460,3,0,2.0
2010,8,2010,2.5,0,0,0,4,0,2.0
2120,7,1420,1.5,0,0,700,3,0,1.0
1510,7,1030,2.5,0,0,480,3,0,1.0
2030,8,2030,2.5,0,0,0,4,0,2.0
2400,8,2400,2.5,0,0,0,4,0,2.0
2000,7,1170,1.5,0,0,830,4,0,1.0
3350,9,3350,2.75,0,0,0,4,0,2.0
3340,10,3340,2.5,0,0,0,4,0,2.0
1910,8,1910,2.0,0,0,0,3,0,1.5
1280,7,1280,1.5,1,0,0,3,0,1.0
1560,7,1560,1.5,1,0,0,3,0,1.0
3760,11,3760,2.5,0,0,0,4,0,2.0
1650,7,1260,2.25,0,0,390,3,0,1.0
4020,9,3120,3.25,1,0,900,5,0,2.0
2220,7,1110,2.5,0,0,1110,5,0,1.0
1790,6,940,1.75,0,0,850,3,0,1.0
1920,7,960,1.75,0,0,960,3,0,1.0
1260,8,1260,2.25,0,0,0,2,0,3.0
2880,10,2880,2.5,1,0,0,4,0,2.0
2080,7,1200,2.5,0,0,880,4,0,1.0
1710,8,1710,2.25,0,0,0,3,0,2.0
3070,9,1720,2.5,0,3,1350,3,0,1.0
1480,8,1180,3.25,0,0,300,3,0,2.0
3240,9,3240,3.25,0,0,0,3,0,2.0
3230,8,3230,2.5,0,0,0,4,0,2.0
2110,7,1510,2.75,0,0,600,4,0,1.0
1070,7,1070,1.0,0,0,0,2,0,1.0
960,6,960,1.0,0,0,0,3,0,1.0
2600,8,2600,2.5,0,0,0,4,0,2.0
1500,6,1500,1.75,0,0,0,3,0,1.0
1220,7,1220,1.5,0,0,0,4,0,1.5
1780,8,1280,2.25,0,0,500,3,0,1.0
2980,9,2980,2.5,0,0,0,4,0,2.0
1790,7,1270,2.25,0,0,520,5,0,1.0
3130,10,3130,2.5,0,0,0,4,0,2.0
1240,7,1240,2.0,1,0,0,2,0,1.0
800,7,800,1.0,0,0,0,2,0,2.0
2620,9,2620,2.5,0,0,0,4,0,2.0
1930,7,1430,2.25,0,0,500,4,0,1.0
1760,8,1760,2.5,0,0,0,3,0,3.5
2993,7,2233,1.5,0,0,760,4,0,2.0
1710,7,1710,1.75,0,0,0,3,0,1.0
670,6,670,1.0,0,0,0,2,0,1.0
1930,8,1930,1.75,1,0,0,3,0,1.0
2850,8,2120,4.0,0,0,730,4,0,2.0
3070,8,3070,3.0,0,0,0,5,0,2.0
1690,7,1690,2.5,0,0,0,3,0,2.0
1720,8,1140,2.0,0,0,580,3,0,1.0
3990,9,2870,3.25,0,2,1120,3,0,2.0
1700,7,1250,1.5,0,0,450,3,0,1.0
1660,7,1660,2.5,0,0,0,3,0,2.0
2740,8,1980,2.5,0,0,760,4,0,1.0
2230,8,1320,2.25,0,0,910,5,0,1.0
3840,10,3840,4.25,0,0,0,3,0,2.0
2630,7,1610,3.0,0,0,1020,6,0,1.0
2420,7,2420,2.0,0,0,0,4,0,1.5
2110,7,1110,1.0,1,0,1000,3,0,1.0
1600,7,1280,2.25,0,0,320,3,0,1.0
2430,8,2430,2.25,0,0,0,4,0,2.0
1520,8,1520,2.0,0,0,0,3,0,1.0
1480,7,1480,1.75,0,0,0,3,0,2.0
960,6,960,1.0,0,0,0,3,0,1.0
790,6,790,1.0,0,0,0,2,0,1.0
1120,7,1120,1.5,0,0,0,3,0,1.0
1660,7,830,1.75,0,0,830,3,0,1.0
1020,7,1020,1.0,0,0,0,2,0,1.0
1800,9,1800,2.25,0,0,0,2,0,2.0
1900,7,1300,2.75,0,2,600,4,0,1.0
1890,9,1890,2.75,0,0,0,3,0,2.0
1020,7,1020,1.0,0,0,0,2,0,1.0
1340,7,1340,1.5,0,0,0,3,0,1.0
1320,7,1320,1.0,0,0,0,3,0,1.5
2600,8,1560,2.75,0,0,1040,4,0,1.0
1520,7,1520,2.25,0,0,0,3,0,2.0
1260,8,1260,2.5,0,0,0,3,0,2.0
1130,6,1130,1.0,0,0,0,3,0,1.5
2350,7,1510,1.75,0,0,840,3,0,1.0
2280,7,1220,2.0,0,0,1060,4,0,1.0
1340,5,1340,1.0,0,0,0,3,0,1.0
2030,7,2030,2.0,0,0,0,4,0,2.0
2180,8,1370,2.25,1,0,810,4,0,1.0
2130,9,2130,3.75,0,4,0,4,1,1.5
740,6,740,0.75,0,0,0,1,0,1.0
4940,9,3450,2.5,0,4,1490,4,0,1.0
900,6,900,1.0,0,0,0,3,0,1.0
1330,6,1330,1.0,0,0,0,3,0,1.0
2080,8,2080,4.0,0,4,0,3,0,3.0
2570,9,2570,2.5,0,0,0,4,0,2.0
2100,7,1400,2.5,0,0,700,5,0,1.0
3160,8,2180,3.5,0,4,980,4,0,2.0
3620,10,2220,2.5,0,4,1400,4,0,1.0
2080,7,1280,1.75,0,0,800,3,0,1.0
1400,7,1400,1.0,0,0,0,3,0,1.0
1290,7,1290,1.0,0,0,0,3,0,1.0
3060,9,1810,2.25,0,2,1250,3,0,1.5
2730,8,2730,2.75,0,0,0,5,0,2.0
1970,9,1970,2.5,0,4,0,3,0,1.0
2780,9,1670,2.25,0,3,1110,3,0,1.0
2390,7,1560,1.75,0,0,830,3,0,1.0
2340,7,1170,2.25,0,0,1170,5,0,1.0
940,7,880,2.0,0,0,60,3,0,1.0
1160,6,580,2.0,0,0,580,3,0,1.0
3340,10,3340,2.5,1,0,0,4,0,2.0
2350,7,1390,2.25,0,0,960,3,0,1.0
2170,7,1100,1.75,0,0,1070,5,0,1.0
2320,7,1510,3.0,0,0,810,5,0,1.0
2420,8,1880,1.75,0,0,540,4,0,1.0
2040,7,2040,2.5,0,0,0,4,0,2.0
1150,6,1150,1.0,0,0,0,3,0,1.0
1800,7,1800,2.0,0,0,0,4,0,1.0
6550,11,5400,5.5,0,0,1150,4,0,1.0
2180,8,1280,2.0,0,0,900,4,0,1.0
1800,7,1160,1.0,0,0,640,3,0,1.5
1950,7,1120,2.5,0,0,830,4,0,1.0
1250,7,1250,1.0,0,0,0,3,0,1.0
1820,7,1080,1.75,0,0,740,4,0,1.0
3330,9,1830,3.0,0,0,1500,4,0,1.0
1390,7,1390,2.5,0,0,0,3,0,2.0
900,6,900,1.0,0,0,0,2,0,1.0
2170,8,2170,2.5,0,0,0,2,0,1.0
1950,7,1950,2.5,0,0,0,3,0,2.0
1560,7,1400,2.75,0,0,160,3,0,1.0
1660,7,1120,2.0,0,0,540,2,0,1.0
1510,8,1510,2.0,0,0,0,2,0,1.0
1430,7,930,1.75,0,0,500,3,0,1.0
2370,7,1460,1.75,0,0,910,4,0,1.0
2410,8,2410,2.25,1,0,0,4,0,1.0
1080,5,1080,0.75,0,0,0,3,0,1.0
4110,9,3130,2.75,0,1,980,4,0,2.0
2605,9,2090,2.5,1,2,515,3,0,2.0
2310,8,2310,2.25,0,0,0,3,0,2.0
1030,7,765,1.75,0,0,265,2,0,2.0
1280,7,1280,1.5,0,0,0,4,0,1.0
1440,7,1140,1.5,0,0,300,3,0,1.0
1340,7,1340,1.75,0,0,0,3,0,2.0
3300,8,3300,4.5,0,0,0,6,0,2.0
5440,9,2720,2.75,0,0,2720,4,0,1.0
1650,7,1100,1.75,0,0,550,4,0,1.0
1230,7,1230,1.0,0,0,0,3,0,1.0
3570,10,2860,4.0,1,0,710,4,0,2.0
2370,8,1570,2.5,0,3,800,3,0,1.0
1340,7,1340,2.0,0,0,0,3,0,1.0
760,6,760,1.0,0,0,0,2,0,1.0
1500,7,1500,1.75,0,0,0,4,0,1.5
1741,8,1446,2.5,0,0,295,2,0,2.0
2860,7,1730,3.0,0,0,1130,4,0,1.0
1820,7,1820,1.75,0,0,0,4,0,1.0
2005,7,1605,2.0,0,0,400,3,0,1.0
2470,9,2470,2.5,0,0,0,3,0,2.0
2200,7,1250,1.75,0,0,950,3,0,1.0
1150,5,590,1.75,0,0,560,3,0,1.0
1360,8,1360,2.0,0,0,0,2,0,1.0
1260,7,1260,2.25,0,0,0,3,0,2.0
1520,7,1520,2.0,0,0,0,2,0,1.0
1830,8,1540,2.5,0,0,290,4,0,1.0
2340,8,1500,2.75,0,0,840,3,0,1.0
1910,7,1000,2.75,0,0,910,4,0,1.0
1465,7,1050,2.75,1,0,415,2,0,2.0
1860,8,1860,2.25,0,0,0,4,0,2.0
2030,8,2030,2.5,0,0,0,4,0,2.0
2200,9,2200,2.5,0,2,0,3,0,2.0
1880,7,970,2.0,0,0,910,4,0,1.0
2480,9,2480,2.5,0,0,0,3,0,2.0
1660,7,1660,2.25,0,0,0,2,0,2.0
1090,7,1090,1.0,0,0,0,3,0,1.5
2690,8,1370,2.75,0,0,1320,4,0,1.0
1100,7,1100,1.0,0,0,0,3,0,1.0
2100,9,2100,2.5,0,0,0,3,0,2.0
2480,10,2130,1.5,0,3,350,3,0,2.0
2300,7,2300,3.0,0,0,0,4,0,2.0
1970,8,1310,2.25,0,0,660,4,0,1.0
1970,8,1570,2.5,0,0,400,5,0,1.0
1280,8,1280,1.5,0,0,0,3,0,1.5
3800,7,2490,3.25,0,0,1310,5,0,1.0
3040,9,3040,2.5,0,0,0,3,0,2.0
1100,7,900,1.0,0,0,200,3,0,1.0
1410,7,1410,1.0,0,0,0,4,0,1.5
1280,7,1280,1.75,0,0,0,3,0,1.5
1050,7,910,1.0,0,0,140,3,0,1.0
2031,9,2031,3.0,0,0,0,3,0,2.0
2310,8,2310,2.0,0,0,0,4,0,1.5
1440,7,1440,2.25,0,0,0,3,0,2.0
2150,7,1460,1.75,0,2,690,4,0,1.0
2290,8,1420,3.0,0,0,870,3,0,1.0
1280,6,640,1.0,0,0,640,2,0,1.0
2510,8,1610,2.5,0,0,900,4,0,1.0
1660,7,1660,1.5,1,0,0,3,0,1.0
5220,11,5220,4.5,0,0,0,5,0,2.0
2540,9,2540,2.5,0,1,0,3,0,2.0
1170,7,1170,1.0,0,0,0,3,0,1.0
3730,9,2760,3.25,0,0,970,4,0,2.0
1190,5,1190,1.0,0,0,0,2,0,1.0
1640,8,1180,2.25,0,0,460,3,0,1.0
1900,9,1900,2.5,1,0,0,3,0,2.0
3410,9,3410,2.75,0,0,0,4,0,2.0
1700,5,850,2.0,0,0,850,2,0,1.0
1510,8,1170,1.0,0,0,340,3,0,1.0
1970,8,1680,3.5,0,0,290,3,0,2.0
1220,7,1220,1.5,0,0,0,3,0,1.0
2030,8,1890,2.0,0,2,140,3,0,1.0
2130,7,1100,2.75,0,0,1030,5,0,1.0
2770,8,2370,2.75,0,0,400,3,0,1.5
1570,7,1570,2.0,0,0,0,3,0,1.0
1670,7,900,2.0,0,0,770,6,0,1.0
1170,7,1170,1.75,0,0,0,3,0,1.0
820,6,820,1.0,0,0,0,2,0,1.0
4450,9,3460,3.75,0,0,990,5,0,2.0
2310,8,1670,2.75,0,0,640,4,0,1.0
2950,7,2950,2.5,0,0,0,4,0,2.0
1820,9,1820,2.75,0,0,0,3,0,1.0
2110,8,2110,2.5,0,0,0,4,0,2.0
930,6,930,1.0,0,0,0,1,0,1.0
1740,8,1320,2.5,0,0,420,3,0,2.0
2340,8,1290,1.75,0,0,1050,4,0,1.0
3270,10,3270,2.5,0,0,0,4,0,2.0
1840,7,1290,2.5,0,0,550,3,0,1.0
1390,8,1390,2.5,0,0,0,3,0,2.0
6400,10,3810,3.75,0,2,2590,3,0,1.0
1370,7,1370,1.5,0,0,0,2,0,1.0
1870,7,1120,2.0,0,0,750,5,0,1.0
1100,8,1100,1.5,0,0,0,1,0,1.5
2740,9,2740,2.5,0,4,0,3,0,2.0
2090,8,1330,1.75,0,0,760,3,0,1.0
1640,8,1640,2.25,1,0,0,3,0,1.0
3060,9,3060,2.5,0,2,0,3,0,2.0
1760,8,1760,2.5,0,0,0,3,0,2.0
1440,7,1440,1.0,1,0,0,3,0,1.0
3050,9,2330,2.75,1,4,720,3,0,1.0
2750,9,2750,3.0,0,0,0,4,0,2.0
1290,8,1290,2.25,0,0,0,2,0,3.0
1090,7,840,1.0,0,0,250,2,0,1.0
2370,8,2370,2.5,0,0,0,3,0,2.0
2720,8,2720,3.0,0,0,0,4,0,2.0
1680,8,1680,1.75,0,0,0,2,0,1.0
3620,10,2920,3.5,1,0,700,3,0,2.0
1470,7,1470,1.0,0,0,0,3,0,1.0
2210,8,1640,1.75,0,0,570,4,0,1.0
2420,8,1370,2.25,0,0,1050,3,0,1.0
3770,9,3070,2.75,0,2,700,4,0,2.0
2670,9,2670,2.5,0,0,0,3,0,2.0
2540,8,1290,2.5,0,1,1250,3,0,1.0
3560,8,1650,2.5,0,2,1910,3,0,1.0
910,7,910,1.0,0,0,0,2,0,1.0
1650,7,1650,1.75,0,0,0,3,0,1.0
1780,8,1780,2.25,0,0,0,4,0,2.0
2100,7,1300,1.75,0,0,800,4,0,1.0
1410,7,1410,1.0,0,0,0,4,0,1.5
2150,8,1240,2.75,0,0,910,4,0,1.0
1600,7,1600,1.5,0,0,0,4,0,1.0
1730,7,880,1.75,0,0,850,4,0,1.0
3300,9,2410,3.5,1,0,890,5,0,2.0
1230,6,1230,1.0,0,0,0,2,0,1.0
1560,7,1560,1.75,0,0,0,4,0,1.0
2200,8,2200,2.5,0,0,0,3,0,2.0
3500,9,3500,2.5,0,0,0,4,0,2.0
1970,8,1420,1.75,0,0,550,3,0,1.0
1870,7,1390,2.25,0,0,480,3,0,1.0
1360,7,1360,2.0,0,0,0,3,0,1.0
1930,8,1930,2.25,0,0,0,4,0,1.0
2170,8,1450,3.0,0,0,720,5,0,1.5
1720,7,860,2.0,0,0,860,4,0,1.0
4860,9,4860,3.25,0,0,0,4,0,2.5
1700,7,1700,2.5,0,0,0,3,0,2.0
1940,8,1770,2.75,0,3,170,3,0,2.0
2000,6,1200,2.0,0,0,800,5,0,1.5
2029,9,2029,2.5,0,0,0,3,0,2.0
3400,10,3400,2.5,0,0,0,3,0,2.0
1150,7,1150,1.0,0,0,0,2,0,1.0
1270,5,1270,1.0,0,0,0,2,0,1.0
1880,6,1880,1.75,0,0,0,5,0,2.0
1430,8,1410,2.5,0,0,20,2,0,3.0
1930,7,1020,2.0,0,0,910,5,0,1.0
5190,11,5190,4.0,1,1,0,5,0,2.0
2340,7,2340,2.5,0,0,0,4,0,2.0
3390,10,3390,3.5,0,0,0,4,0,2.0
1110,7,980,2.0,0,0,130,2,0,3.0
2510,8,2050,2.75,0,0,460,4,0,1.0
2880,10,2880,2.5,0,0,0,3,0,2.0
1160,8,1160,1.0,0,0,0,2,0,1.0
1440,6,720,1.75,0,0,720,4,0,1.0
2530,7,1530,2.75,0,0,1000,5,0,1.0
2360,8,2360,2.75,0,0,0,4,0,1.0
750,5,750,1.0,0,0,0,2,0,1.0
1530,8,1480,2.25,0,0,50,2,0,3.0
2150,8,2150,2.5,1,0,0,3,0,2.0
4120,8,2070,2.5,1,4,2050,4,1,1.0
2540,10,2540,2.5,0,0,0,4,0,1.0
1790,7,1040,1.75,0,0,750,3,0,1.0
2540,8,1820,2.5,0,0,720,3,0,1.0
2880,7,2880,2.5,0,0,0,4,0,2.0
3550,9,3550,1.75,1,0,0,4,0,2.0
1800,7,1800,2.5,0,0,0,3,0,2.0
1320,7,1320,1.5,0,0,0,3,0,2.0
2350,8,2350,2.5,0,0,0,4,0,2.0
1330,7,960,1.75,0,0,370,2,0,1.0
2670,9,2670,2.25,0,0,0,3,0,2.0
890,6,760,1.0,0,0,130,2,0,1.0
3906,9,3906,3.5,0,2,0,4,0,2.0
990,7,990,1.0,0,0,0,2,0,1.0
1430,7,1030,2.75,0,0,400,4,0,1.0
990,7,990,1.0,0,0,0,3,0,1.0
1740,7,1740,2.5,0,0,0,5,0,1.0
3040,9,3040,2.5,1,0,0,4,0,2.0
2080,6,1040,2.0,0,0,1040,5,0,1.0
3050,8,1920,1.5,1,0,1130,5,0,1.5
1070,7,1070,1.75,0,0,0,3,0,1.0
1160,7,1160,1.75,0,0,0,3,0,1.0
1940,7,1940,2.25,0,0,0,4,0,2.0
1700,8,1700,1.75,0,0,0,2,0,1.0
2430,8,2430,2.5,0,0,0,3,0,2.0
1260,7,1260,1.75,0,0,0,3,0,1.0
2120,9,1720,2.25,0,0,400,3,0,1.0
1570,8,1170,2.25,0,0,400,3,0,1.0
1710,6,1710,2.0,0,0,0,3,0,1.5
2200,8,1100,2.75,0,0,1100,4,0,1.0
2550,9,2550,2.0,0,0,0,3,0,2.0
840,6,840,1.0,1,0,0,2,0,1.0
4645,10,3855,4.25,1,0,790,4,0,2.0
6430,12,6430,3.0,1,0,0,4,0,2.0
1040,6,1040,1.0,0,0,0,3,0,1.0
2440,7,2440,3.0,0,0,0,4,0,2.0
3990,8,1990,2.5,1,0,2000,5,0,1.0
1950,8,1950,2.5,0,0,0,3,0,2.0
1600,8,1600,3.25,0,0,0,3,0,3.0
1670,8,1670,1.75,1,0,0,3,0,1.0
1680,7,1680,1.5,0,0,0,2,0,1.5
1380,7,1380,1.5,0,0,0,3,0,2.0
2580,8,2580,2.5,0,0,0,3,0,1.5
1970,8,1970,2.5,0,0,0,3,0,2.0
2010,9,2010,2.5,0,0,0,3,0,2.0
2540,8,1320,1.0,0,0,1220,2,0,1.0
3130,10,3130,2.75,0,0,0,4,0,2.0
1110,7,1110,1.0,0,0,0,3,0,1.0
2580,9,1620,2.25,0,0,960,4,0,1.0
1800,8,1420,1.5,0,0,380,3,0,1.0
2840,9,2840,2.75,0,0,0,4,0,3.0
1990,7,1990,2.5,0,0,0,3,0,2.0
2584,8,2584,3.5,0,0,0,4,0,2.0
3300,9,3300,2.75,0,0,0,4,0,2.0
1470,8,1470,0.0,0,2,0,0,0,3.0
2360,7,2060,1.75,0,0,300,5,0,1.5
2790,8,2790,2.75,0,0,0,4,0,2.0
1130,6,1130,1.0,0,0,0,4,0,1.5
2400,8,2400,2.5,0,0,0,4,0,2.0
1530,8,1530,3.25,0,0,0,3,0,3.0
3220,9,3220,2.5,1,0,0,4,0,2.0
1930,8,1480,1.75,1,0,450,3,0,1.0
1410,7,1410,2.0,0,0,0,3,0,1.5
2170,9,2170,2.5,0,0,0,3,0,2.0
2620,8,1830,2.5,1,0,790,3,0,2.0
1660,7,1660,1.75,0,0,0,3,0,1.0
2840,11,2840,2.5,0,3,0,3,0,2.0
1450,7,1450,2.5,0,0,0,3,0,2.0
2580,8,2580,3.0,0,0,0,4,0,2.0
1520,7,1520,2.0,0,0,0,3,0,2.0
1000,6,1000,1.0,0,2,0,3,0,1.0
3361,10,3361,2.5,0,0,0,5,0,2.0
2130,8,1840,2.5,0,0,290,3,0,2.0
2190,8,1240,2.25,0,1,950,3,0,1.0
980,6,980,1.0,0,0,0,3,0,2.0
850,7,850,1.0,0,0,0,2,0,1.0
2230,7,1700,1.0,0,3,530,5,0,1.5
780,6,780,1.0,0,0,0,2,0,1.0
2000,7,1000,1.75,0,2,1000,5,0,1.0
2790,8,1640,2.0,1,0,1150,4,0,1.0
1830,5,1830,1.5,0,0,0,3,0,1.5
1390,7,1030,1.75,0,0,360,4,0,1.0
1440,7,1440,1.0,0,0,0,3,0,1.5
2710,9,2710,2.5,0,0,0,4,0,2.0
3230,10,3230,2.5,0,0,0,4,0,2.0
1710,7,1140,1.0,0,0,570,3,0,1.0
2620,8,1620,2.5,0,4,1000,4,0,1.0
2900,9,1750,2.75,0,2,1150,4,0,1.0
3250,8,2420,3.0,0,0,830,4,0,2.5
2080,7,1280,2.25,0,0,800,4,0,1.0
2160,9,2160,2.5,0,0,0,3,0,2.0
1150,6,780,1.0,0,0,370,2,0,1.0
2700,9,2700,2.25,0,0,0,5,0,2.0
1190,7,970,1.5,0,0,220,3,0,1.0
1360,6,860,1.5,0,0,500,3,0,1.0
2270,8,1740,2.25,0,0,530,3,0,1.0
2216,9,2216,2.75,0,0,0,3,0,1.0
1680,7,860,1.0,0,0,820,2,0,1.0
2000,8,2000,2.5,0,0,0,4,0,2.0
1680,7,1680,1.75,0,0,0,4,0,1.5
1810,7,1810,2.0,0,0,0,3,0,1.0
3110,10,1590,3.0,1,4,1520,3,0,1.0
2000,6,2000,1.5,0,0,0,5,0,1.5
2090,7,2090,2.0,1,0,0,3,0,1.5
1880,8,1880,1.0,1,0,0,3,0,1.5
1480,6,1480,1.0,0,0,0,3,0,2.5
2630,8,1670,3.0,0,0,960,5,0,2.0
1900,7,1700,2.5,0,0,200,3,0,2.5
2099,7,2099,2.5,0,0,0,3,0,2.0
2120,8,2120,2.25,0,0,0,3,0,1.0
1370,8,1370,2.25,0,0,0,3,0,3.0
2360,9,2360,2.0,1,0,0,2,0,1.5
1950,8,1950,2.75,0,0,0,2,0,3.0
2180,8,1480,1.75,0,0,700,3,0,1.0
3172,8,3172,2.5,0,0,0,4,0,2.0
4980,11,4980,3.75,0,3,0,4,0,2.0
2270,8,2270,2.5,0,0,0,4,0,2.0
1790,6,1790,1.0,0,0,0,3,0,1.0
3530,10,3530,3.75,1,0,0,5,0,2.0
2056,7,1048,1.75,0,0,1008,2,0,1.0
1370,7,900,1.5,0,0,470,4,0,1.0
2000,7,2000,2.75,0,0,0,5,0,2.0
1420,7,1420,1.0,0,0,0,2,0,1.0
5570,9,3860,3.25,0,0,1710,5,0,2.0
1910,8,1910,2.0,0,0,0,4,0,1.5
1060,7,1060,1.0,0,0,0,2,0,1.0
2280,7,2280,1.0,0,0,0,2,0,2.0
2990,9,2990,2.75,1,0,0,5,0,2.0
1200,6,1060,1.0,0,0,140,4,0,1.0
1890,7,1890,2.25,0,0,0,4,0,2.0
1810,7,1810,2.5,0,0,0,3,0,2.0
1250,6,1250,1.0,0,0,0,3,0,1.0
2500,7,1250,1.75,0,0,1250,4,0,1.0
2260,8,1520,2.5,0,0,740,5,0,1.0
2150,8,2150,2.5,0,0,0,2,0,1.0
2430,8,2430,3.0,0,0,0,4,0,2.0
4570,11,4570,3.75,0,0,0,5,0,2.0
2430,8,1430,1.75,0,0,1000,4,0,1.0
1400,6,700,1.0,0,0,700,4,0,1.0
950,6,950,1.0,0,0,0,2,0,1.0
1200,6,1200,1.75,0,0,0,3,0,1.0
1240,6,960,1.0,0,0,280,3,0,1.5
2500,8,1430,3.0,0,0,1070,5,0,1.0
2600,8,2020,1.75,0,0,580,4,0,1.0
1170,9,1170,2.5,0,0,0,2,0,2.0
1030,8,1030,1.5,0,0,0,1,0,1.0
620,6,620,1.0,0,0,0,1,0,1.0
2990,9,2990,2.5,0,0,0,5,0,2.0
1930,7,1490,2.75,0,0,440,3,0,1.5
1210,7,1210,1.0,0,0,0,4,0,1.0
1870,7,1870,1.75,1,0,0,3,0,1.0
1420,7,1130,2.25,0,0,290,3,0,1.0
2850,8,2340,2.0,0,3,510,3,0,1.0
1400,7,1140,2.25,0,0,260,3,0,1.0
2410,7,1460,2.25,0,0,950,4,0,1.5
1620,7,1620,1.0,1,0,0,3,0,1.5
1460,7,1460,1.75,0,0,0,3,0,1.0
2260,7,2260,2.5,0,0,0,3,0,2.0
3840,9,2110,2.75,1,2,1730,4,0,1.0
1270,7,1080,2.5,0,0,190,3,0,2.0
3620,9,3620,3.25,0,2,0,5,0,2.0
2310,7,1650,1.75,0,0,660,4,0,1.0
2600,9,2600,2.25,0,0,0,3,0,2.0
1330,7,1330,1.5,0,2,0,4,0,1.5
1600,8,1600,2.5,0,0,0,3,0,2.0
2570,8,1910,1.75,0,0,660,4,0,1.0
1940,7,1090,1.75,1,0,850,4,0,1.0
2140,7,1470,2.25,0,0,670,1,0,1.0
3030,9,3030,2.5,0,0,0,3,0,2.0
860,6,860,1.0,0,0,0,3,0,1.0
2700,8,1660,1.5,0,4,1040,2,0,1.5
1340,7,1340,1.0,0,0,0,3,0,1.0
1630,8,1630,2.25,0,0,0,3,0,3.0
2160,9,2160,2.5,0,0,0,3,0,2.0
2160,8,2160,2.25,0,0,0,3,0,2.0
1910,8,1910,1.75,0,0,0,2,0,2.0
1220,6,1220,1.0,0,0,0,2,0,1.5
1040,7,1040,1.0,0,0,0,3,0,1.0
1770,7,1090,1.75,0,0,680,3,0,1.0
1670,7,1170,2.25,0,0,500,3,0,1.0
2360,9,2360,2.25,1,0,0,4,0,2.0
1220,6,1220,1.5,0,0,0,4,0,1.0
1580,8,1080,2.5,0,2,500,3,0,2.0
1340,8,1340,1.0,0,2,0,2,0,1.0
2810,9,2810,2.75,0,0,0,4,0,2.0
2930,8,2930,2.5,0,0,0,4,0,2.0
2380,8,2380,2.5,0,0,0,4,0,2.0
1050,6,930,1.0,0,0,120,3,0,1.0
3750,8,2440,2.25,0,0,1310,4,0,2.0
4080,12,3210,3.5,1,2,870,4,0,2.0
1550,7,1030,1.75,0,0,520,5,0,1.0
1110,7,1110,1.0,0,0,0,3,0,1.5
2640,8,2640,2.5,0,0,0,4,0,2.0
3900,9,2650,3.5,0,0,1250,5,0,2.0
2740,10,1980,2.25,0,2,760,4,0,1.0
2180,8,2180,2.5,0,0,0,4,0,1.0
1660,7,1100,2.25,0,0,560,3,0,1.5
3370,10,2000,3.25,1,2,1370,5,0,1.0
1430,7,1430,1.0,0,0,0,3,0,1.5
1140,6,1140,1.5,0,0,0,3,0,1.5
1370,8,1370,2.25,0,0,0,3,0,3.0
2200,7,1410,2.75,0,0,790,4,0,1.0
1560,7,1060,1.5,0,0,500,3,0,1.0
950,7,950,1.0,0,0,0,2,0,1.0
2450,7,2450,3.0,0,0,0,5,0,2.0
2210,10,1500,3.0,0,0,710,2,0,2.0
1270,7,960,1.0,0,0,310,2,0,1.0
1340,7,1340,1.0,0,0,0,4,0,1.0
2770,8,2770,2.5,0,0,0,4,0,2.0
2460,9,2460,2.5,0,0,0,4,0,2.0
1340,7,1340,2.0,0,0,0,2,0,1.0
1480,7,1480,1.75,0,0,0,3,0,1.0
1570,8,1310,3.25,0,0,260,2,0,2.0
3200,9,3200,2.5,0,0,0,4,0,2.0
1740,8,1740,1.75,0,0,0,3,0,1.5
1870,7,1870,2.5,0,0,0,3,0,2.0
1930,8,1930,2.5,0,0,0,4,0,2.0
1320,8,1100,1.5,0,0,220,2,0,2.0
1570,7,1570,1.0,0,0,0,3,0,1.0
2510,8,1630,2.0,0,0,880,4,0,1.0
1500,7,870,2.0,0,0,630,3,0,1.0
1130,8,1130,2.25,0,0,0,2,0,2.0
1050,7,840,1.0,0,0,210,3,0,1.0
1520,8,1520,1.0,0,3,0,3,0,1.5
3700,9,3700,3.0,0,0,0,3,0,2.0
2210,7,1030,1.5,0,0,1180,3,0,1.0
1770,7,1770,1.75,0,0,0,5,0,1.0
2290,7,1290,1.75,0,3,1000,4,0,1.0
2244,7,2244,2.5,0,0,0,3,0,2.0
1370,6,1370,1.0,0,0,0,4,0,2.0
3010,8,3010,2.5,0,0,0,4,0,2.0
1950,7,1130,1.5,0,0,820,5,0,1.0
4340,8,2170,2.5,0,0,2170,5,0,1.0
2270,8,2270,2.5,0,0,0,5,0,2.0
1870,7,1870,2.5,0,0,0,3,0,2.0
1320,7,880,2.75,0,0,440,3,0,1.0
2050,7,2050,2.5,0,0,0,4,0,2.0
1650,8,1290,2.25,0,0,360,3,0,1.0
1410,7,1410,2.0,0,0,0,3,0,1.0
2840,8,2060,3.0,0,0,780,4,0,1.5
2120,8,1420,3.0,0,0,700,4,0,1.5
2400,7,1320,2.75,0,0,1080,4,0,1.0
1270,7,1270,1.5,0,0,0,3,0,1.0
2680,8,1580,2.25,0,0,1100,3,0,2.0
1410,8,1410,1.0,0,0,0,2,0,1.5
1800,8,1800,2.5,0,0,0,4,0,2.0
440,5,440,0.75,0,3,0,2,1,1.0
2280,8,2280,2.5,0,0,0,4,0,2.0
1320,7,1320,1.75,0,0,0,3,0,1.5
1020,6,1020,1.0,0,0,0,2,0,1.5
2100,7,1400,1.0,0,0,700,2,0,1.0
1260,7,1260,1.5,0,0,0,2,0,2.0
1510,7,1510,1.0,0,0,0,2,0,1.0
890,6,890,1.0,0,0,0,2,0,1.0
1552,7,1552,2.25,0,0,0,3,0,2.0
5410,10,5050,4.75,1,0,360,5,0,2.0
3110,8,3110,3.0,0,0,0,4,0,2.0
2960,8,1480,2.5,0,3,1480,4,0,1.0
950,6,790,1.75,0,0,160,3,0,1.0
3070,11,1970,2.5,0,2,1100,4,0,2.0
2260,7,1130,1.75,1,1,1130,4,0,1.0
2900,9,2900,2.5,1,0,0,5,0,2.0
1420,7,1020,2.5,0,0,400,3,0,1.0
1010,6,1010,1.0,0,2,0,2,0,1.0
1780,7,1210,1.75,0,0,570,3,0,1.0
1200,7,1200,1.0,0,0,0,3,0,1.0
2090,7,1670,2.5,0,0,420,3,0,2.0
2700,8,2700,2.5,1,0,0,4,0,2.0
1610,8,1610,2.0,0,0,0,3,0,1.5
1280,7,1280,1.0,0,0,0,2,0,1.0
2080,7,1740,2.0,0,0,340,5,0,1.0
3360,9,3360,2.75,0,0,0,5,0,2.0
860,6,860,1.0,0,0,0,3,0,1.0
880,7,880,1.0,0,0,0,2,0,2.0
2640,8,2640,2.75,0,0,0,4,0,1.5
2710,8,2710,2.5,0,0,0,4,0,2.0
1860,7,930,2.0,0,0,930,3,0,1.0
1380,7,1380,1.0,0,0,0,2,0,1.0
3190,10,3190,2.5,0,0,0,4,0,2.0
1710,8,1260,2.0,0,0,450,3,0,1.0
830,7,830,1.0,0,0,0,3,0,1.0
2740,10,2740,2.5,1,2,0,3,0,2.0
3730,7,2150,1.75,0,0,1580,4,0,1.0
1180,6,1180,1.0,0,0,0,3,0,1.0
1370,7,1370,1.0,0,0,0,2,0,1.0
820,8,760,1.0,0,0,60,1,0,1.0
2790,8,1880,3.0,0,0,910,4,0,2.0
2750,9,2750,2.5,0,0,0,4,0,2.0
2310,8,2310,2.5,0,0,0,3,0,2.0
3180,11,3180,2.5,1,0,0,4,0,2.0
2570,8,1580,3.0,0,0,990,5,0,1.0
1270,7,1270,1.75,0,0,0,3,0,1.0
3740,8,1980,2.75,0,0,1760,5,0,1.0
980,8,980,1.0,0,0,0,2,0,2.0
1250,7,1250,1.0,0,0,0,3,0,1.0
3990,8,3090,3.75,0,0,900,5,0,2.0
1900,8,1900,1.75,1,0,0,3,0,1.0
1760,7,1090,1.0,0,0,670,4,0,1.0
1190,7,1190,1.0,1,0,0,2,0,1.0
2650,8,1520,2.5,0,0,1130,4,0,1.5
1240,7,1040,2.0,0,0,200,4,0,1.0
1470,7,810,1.5,0,0,660,4,0,1.0
1790,7,1790,2.5,0,0,0,4,0,2.0
2450,8,2450,2.5,0,0,0,3,0,2.0
2180,8,1680,2.0,0,2,500,3,0,1.5
4070,8,3390,2.5,0,0,680,4,0,3.0
830,7,830,1.0,0,0,0,1,0,1.0
1350,8,1120,2.5,0,0,230,3,0,2.0
1720,8,1150,1.75,0,0,570,5,0,1.0
1810,7,1230,2.5,0,0,580,4,0,1.0
1750,7,1410,2.25,0,0,340,3,0,1.0
2510,7,2510,2.5,0,0,0,4,0,2.0
1200,7,1200,1.75,0,0,0,3,0,1.5
3830,8,2900,2.5,0,0,930,4,0,2.0
2800,10,1910,3.25,0,0,890,5,0,1.5
880,6,880,1.0,0,0,0,2,0,1.0
4290,9,2480,3.0,1,3,1810,5,0,1.0
1660,8,1660,1.75,0,0,0,3,0,1.0
3760,9,2820,3.5,0,3,940,5,0,2.0
2490,8,2290,2.75,0,0,200,3,0,2.0
1000,7,1000,1.0,0,3,0,1,1,1.0
1010,8,1010,2.0,0,0,0,3,0,1.0
1910,8,1910,1.75,0,0,0,3,0,1.5
2360,8,1690,2.5,0,0,670,3,0,1.0
1800,8,1000,1.75,0,0,800,3,0,1.0
1200,8,1200,1.5,0,0,0,3,0,2.0
2320,7,1510,2.0,0,0,810,3,0,1.0
1390,7,1390,1.5,1,0,0,3,0,1.0
5180,11,2610,3.25,1,0,2570,5,0,1.0
1830,7,1060,1.75,0,0,770,5,0,1.0
1780,8,1180,1.5,0,0,600,4,0,1.0
1630,8,1320,2.5,0,0,310,3,0,1.0
4850,10,3850,4.25,0,4,1000,4,1,2.0
3300,8,2820,2.25,1,3,480,4,0,1.5
3030,8,1760,3.0,0,0,1270,3,0,2.0
1240,6,1240,1.0,0,0,0,3,0,1.5
2820,9,1800,2.25,0,2,1020,4,0,1.5
1310,7,1310,1.0,0,0,0,3,0,1.0
1840,8,1340,1.5,0,2,500,2,0,1.0
1470,7,1170,1.0,0,0,300,2,0,1.0
2910,8,2130,2.75,1,0,780,4,0,1.0
3660,9,3260,2.5,0,2,400,3,0,2.0
1728,9,1728,1.75,0,3,0,2,0,1.0
3670,9,3670,2.5,0,0,0,4,0,2.0
2480,7,2480,2.5,0,0,0,4,0,2.0
1530,8,1140,3.25,0,0,390,3,0,2.0
2180,7,1310,2.75,0,0,870,3,0,1.0
1280,8,1280,2.25,0,0,0,3,0,3.0
1350,7,1350,2.0,0,0,0,3,0,1.0
2740,7,2740,2.25,0,0,0,4,0,2.0
3180,10,2610,2.5,1,4,570,2,0,2.0
1460,7,1210,1.0,0,0,250,2,0,1.0
1040,8,1040,2.25,0,0,0,2,0,2.0
3580,9,3580,3.5,0,0,0,3,0,1.5
1210,7,1210,1.0,0,0,0,3,0,1.5
960,4,960,1.0,0,0,0,2,0,1.0
1000,7,1000,1.0,0,0,0,2,0,1.0
4700,10,4700,2.5,0,0,0,4,0,2.0
820,7,820,1.5,0,0,0,2,0,2.0
1020,6,1020,1.0,0,0,0,2,0,1.0
980,7,980,1.0,0,0,0,3,0,1.0
1440,5,1440,2.0,0,0,0,4,0,1.0
1660,7,960,1.75,0,0,700,4,0,1.0
1470,7,970,1.0,0,0,500,2,0,1.0
2190,7,1540,2.5,1,0,650,3,0,1.0
1820,8,1190,1.5,0,0,630,4,0,1.0
2580,9,2580,2.5,1,2,0,4,0,2.0
3670,10,3670,2.5,0,0,0,4,0,2.0
3370,9,2650,3.5,0,1,720,5,0,2.0
2160,6,1300,1.0,0,0,860,2,0,1.0
2220,7,1560,2.75,1,0,660,4,0,1.0
3030,10,3030,2.5,0,0,0,3,0,1.5
840,7,840,1.0,0,0,0,2,0,1.0
1740,7,1170,2.25,0,0,570,4,0,1.0
2510,9,1810,2.25,0,0,700,4,0,1.0
1490,8,1100,1.75,0,0,390,4,0,1.0
2970,9,2970,3.0,0,0,0,5,0,2.0
850,4,850,1.0,0,0,0,2,0,1.5
1310,7,1310,2.0,0,0,0,3,0,1.0
3180,9,3180,2.5,0,0,0,4,0,2.0
2530,7,1390,2.75,1,0,1140,8,0,2.0
1520,8,1040,2.5,0,0,480,3,0,2.0
2330,9,2330,2.5,1,0,0,3,0,2.0
2170,8,1380,2.75,0,0,790,3,0,1.0
970,7,970,1.0,0,0,0,2,0,1.0
1470,8,1470,2.5,0,3,0,2,0,3.0
1280,7,1280,1.0,1,0,0,3,0,1.0
2210,7,1450,2.5,0,0,760,3,0,1.0
1870,7,1870,2.0,0,3,0,4,0,1.0
1660,7,1270,1.0,0,0,390,3,0,1.0
1390,6,1390,1.0,0,0,0,2,0,1.0
2060,8,2060,2.5,0,0,0,3,0,2.0
1250,7,1250,1.0,0,0,0,3,0,1.0
1030,7,1030,1.0,0,0,0,2,0,1.0
1640,7,1240,2.25,0,0,400,3,0,1.0
2900,8,2900,2.5,0,0,0,4,0,2.0
1450,7,1450,1.0,0,0,0,3,0,1.0
1740,7,1740,1.75,0,0,0,3,0,1.0
590,7,590,1.0,0,0,0,1,0,1.0
1590,7,1130,1.75,0,0,460,3,0,1.0
1350,6,1350,1.5,0,0,0,3,0,1.0
2040,7,1020,1.75,0,0,1020,4,0,1.0
1590,8,1590,1.75,1,0,0,3,0,1.0
2240,7,1120,1.0,0,0,1120,2,0,1.0
2510,9,2510,2.5,0,0,0,3,0,2.0
1000,7,1000,1.5,0,0,0,3,0,1.0
2640,7,2140,3.0,1,0,500,5,0,2.0
2200,7,2200,2.75,0,0,0,4,0,1.5
3080,9,3080,3.5,0,0,0,4,0,2.0
1670,8,1670,1.75,1,0,0,3,0,2.0
2370,8,1570,2.5,0,0,800,4,0,1.0
3740,9,3740,2.0,0,0,0,4,0,2.0
2420,8,2420,2.25,0,0,0,4,0,2.0
4220,10,2110,3.5,1,0,2110,5,0,1.0
893,8,893,1.5,0,0,0,2,0,2.0
4380,11,4380,3.5,0,0,0,4,0,1.5
2680,7,2350,2.0,0,2,330,4,0,2.0
2120,7,1170,1.5,0,0,950,4,0,1.0
2040,8,2040,2.5,0,0,0,4,0,2.0
3350,8,2670,3.5,0,2,680,3,0,2.0
2760,7,1630,2.75,0,0,1130,4,0,1.0
3070,10,2670,2.5,1,0,400,4,0,2.0
3150,8,3150,2.5,0,0,0,4,0,2.0
1630,7,1630,2.5,0,0,0,4,0,2.0
3960,10,2850,3.5,0,0,1110,4,0,2.0
1070,6,1070,1.0,0,0,0,3,0,1.0
2050,8,2050,2.5,0,0,0,4,0,2.0
2610,8,1260,2.75,0,0,1350,4,0,1.0
1730,6,1730,1.0,0,0,0,2,0,2.0
2660,8,2660,2.5,0,0,0,4,0,2.0
1010,7,1010,1.0,0,0,0,3,0,1.0
2930,9,1520,2.75,1,0,1410,5,0,1.0
1320,7,1320,1.75,0,0,0,3,0,1.5
1340,8,1340,2.0,0,0,0,3,0,3.0
1120,6,1120,1.0,0,0,0,3,0,1.0
1880,8,1880,2.25,0,0,0,3,0,1.5
1350,7,1350,1.75,0,0,0,3,0,1.0
1552,7,1552,2.25,0,0,0,3,0,2.0
2160,8,1730,1.75,0,0,430,3,0,1.0
990,7,990,1.0,0,0,0,3,0,1.0
2500,7,1300,2.5,0,0,1200,5,0,1.0
1240,7,1150,2.25,0,0,90,2,0,2.0
3020,9,3020,2.75,1,0,0,5,0,2.0
1140,7,1140,1.0,0,0,0,3,0,1.0
1280,9,1040,2.0,0,0,240,3,0,2.0
2990,9,2990,2.75,0,0,0,3,0,2.0
4560,11,2760,3.25,1,4,1800,3,0,1.0
3100,9,3100,2.5,0,0,0,4,0,2.0
1630,7,1100,2.25,0,0,530,4,0,1.0
2650,9,2650,2.5,0,0,0,3,0,2.0
1410,6,1410,1.0,0,0,0,3,0,2.0
2750,7,2250,2.0,0,0,500,4,0,1.5
1550,8,1390,2.5,0,0,160,3,0,3.0
1860,7,1860,1.75,0,0,0,3,0,1.0
2180,8,1090,1.5,0,3,1090,3,0,1.0
1800,8,1800,1.5,0,0,0,4,0,1.5
2050,8,2050,2.5,0,0,0,4,0,2.0
1160,8,1020,1.5,0,0,140,2,0,2.0
3360,9,3360,3.25,0,0,0,5,0,2.0
3730,10,3730,3.25,1,4,0,5,0,1.0
3070,10,2180,3.25,1,0,890,4,0,2.0
2170,8,2170,3.0,0,0,0,4,0,2.0
1300,7,1300,1.0,0,0,0,3,0,1.0
3320,7,3320,2.5,0,0,0,4,0,2.0
1620,7,900,1.75,0,0,720,2,0,1.0
2850,8,2850,2.5,0,0,0,4,0,2.0
1980,7,1980,2.5,1,0,0,3,0,1.0
1450,8,1160,3.5,0,0,290,3,0,2.0
1750,7,1150,1.75,0,0,600,3,0,1.0
2100,8,2100,2.5,0,0,0,4,0,2.0
2070,8,1220,2.0,0,0,850,3,0,1.0
2000,7,2000,2.5,0,0,0,3,0,2.0
910,7,910,1.0,0,0,0,3,0,1.0
2120,7,2120,2.0,0,0,0,5,0,1.5
3750,9,3750,2.75,0,0,0,5,0,2.0
1690,7,1060,1.75,0,0,630,3,0,1.0
1920,8,1920,2.5,0,0,0,4,0,2.0
2910,9,2910,2.25,1,0,0,4,0,2.0
2430,8,2430,2.5,0,0,0,4,0,1.0
2700,9,2700,2.75,0,0,0,4,0,1.0
2100,8,2100,2.5,1,0,0,3,0,1.0
1450,7,1050,1.75,0,0,400,3,0,1.0
1330,8,1080,2.25,0,0,250,3,0,2.0
3080,8,3080,2.5,0,0,0,4,0,2.5
1830,8,1750,2.25,1,2,80,4,0,2.0
2400,8,1760,2.75,0,2,640,4,0,1.0
1860,7,1040,3.0,0,0,820,3,0,1.0
2010,8,2010,2.5,0,0,0,3,0,2.0
960,6,810,1.0,0,0,150,2,0,1.0
2820,9,2820,2.5,0,0,0,4,0,2.0
1240,6,1240,1.0,0,0,0,3,0,1.0
1430,7,1430,1.5,0,0,0,2,0,1.0
1050,6,1050,1.75,0,0,0,2,0,1.5
1010,6,1010,1.0,0,0,0,3,0,1.0
2060,7,1070,1.75,0,0,990,4,0,1.0
1750,7,1750,1.5,0,0,0,3,0,1.0
1460,8,1460,3.25,0,0,0,3,0,3.0
910,7,910,1.0,0,0,0,2,0,1.0
1280,7,640,1.0,0,0,640,3,0,1.0
2550,9,2550,2.5,1,0,0,3,0,2.0
2040,8,2040,2.5,0,0,0,4,0,2.0
1900,8,1900,2.5,0,0,0,4,0,2.0
1480,8,1480,2.5,0,0,0,3,0,2.0
1840,8,1310,1.75,0,0,530,3,0,1.0
1250,7,1250,1.0,0,0,0,3,0,1.0
1540,7,1540,2.0,0,0,0,4,0,1.5
3450,9,2180,2.5,1,0,1270,4,0,1.5
5760,12,4390,2.5,0,4,1370,4,0,2.0
2510,8,1810,2.25,0,0,700,3,0,1.0
1760,7,1330,2.25,0,0,430,3,0,2.0
1540,7,1540,2.0,0,0,0,3,0,1.0
2860,10,2860,2.25,1,0,0,4,0,2.0
1390,7,840,1.75,0,3,550,3,0,1.0
1210,8,1210,1.75,0,0,0,2,0,2.0
2860,7,2860,5.25,0,0,0,6,0,2.0
1430,7,1130,1.75,0,0,300,4,0,1.0
2330,8,2330,2.25,0,0,0,4,0,2.0
2560,8,1450,2.75,1,2,1110,4,0,1.0
3110,9,3110,2.5,0,0,0,4,0,2.0
1670,7,1670,1.5,0,0,0,3,0,1.5
3760,11,2830,3.5,0,4,930,3,1,2.0
710,6,710,1.0,0,0,0,2,0,1.0
1840,7,920,1.75,0,0,920,3,0,1.0
1720,7,1040,1.75,0,0,680,4,0,1.5
1850,7,1850,1.75,0,0,0,4,0,1.0
2050,7,2050,2.0,1,0,0,3,0,1.0
1580,7,1580,1.75,0,0,0,3,0,1.0
1130,7,940,1.5,0,0,190,3,0,1.0
2320,8,2320,2.5,0,0,0,3,0,3.0
1420,8,1160,2.75,0,0,260,3,0,2.0
1100,7,1100,1.5,1,0,0,4,0,1.0
1540,7,1540,1.0,0,0,0,3,0,1.0
1000,8,1000,1.5,0,0,0,2,0,3.0
2980,10,2980,2.5,0,0,0,4,0,2.0
5130,11,5130,4.5,1,0,0,5,0,2.0
5860,10,4150,4.25,1,3,1710,6,0,2.0
2070,8,1250,2.5,1,0,820,4,0,1.0
3140,10,2240,3.25,0,3,900,3,0,2.0
1470,7,1020,1.0,0,0,450,2,0,1.0
2510,9,1830,1.75,0,2,680,4,0,1.0
1700,6,1700,1.0,0,0,0,3,0,1.0
2520,7,1260,2.75,0,0,1260,4,0,1.0
1240,7,1240,1.0,0,0,0,3,0,1.5
2710,8,2710,2.25,0,0,0,4,0,2.0
2630,8,1430,1.75,0,2,1200,4,0,1.0
1150,6,1150,1.0,0,4,0,2,1,1.0
3527,7,3527,2.75,0,0,0,4,0,2.0
1940,8,1340,2.5,0,0,600,3,0,1.0
2470,8,1250,2.75,0,0,1220,5,0,1.0
1500,8,1500,1.75,1,0,0,3,0,1.0
3880,7,3880,3.75,0,0,0,5,0,2.0
1380,5,1380,1.0,0,2,0,2,0,1.5
710,6,710,1.0,0,0,0,1,0,1.0
2320,8,1160,2.25,0,0,1160,4,0,1.0
2930,9,2030,1.75,0,0,900,3,0,1.0
2270,8,2270,2.0,0,0,0,4,0,2.0
1620,7,1620,2.5,0,0,0,3,0,2.0
1130,6,1130,2.0,0,0,0,3,0,1.0
2240,7,1630,2.0,1,0,610,3,0,1.0
2990,10,2990,3.25,0,0,0,3,0,2.0
2520,9,2520,2.5,0,0,0,3,0,3.0
1260,7,1260,1.75,0,0,0,3,0,1.5
1850,7,950,2.0,0,0,900,3,0,1.0
1360,7,1360,1.0,0,0,0,4,0,1.0
1610,7,1610,2.5,0,0,0,3,0,2.0
820,6,820,1.0,0,0,0,2,0,1.0
1490,7,1090,2.5,0,0,400,3,0,1.0
1450,7,840,2.5,0,0,610,3,0,1.0
3030,7,2030,2.5,0,0,1000,4,0,2.0
1090,7,1090,1.5,0,0,0,3,0,1.0
1730,6,1730,2.0,0,0,0,5,0,1.0
1880,8,1390,2.25,0,0,490,3,0,1.0
1120,7,1120,1.75,0,0,0,4,0,1.0
1900,6,950,1.75,0,0,950,3,0,1.0
2080,7,1330,2.0,0,0,750,4,0,1.0
1360,8,1360,1.75,0,0,0,3,0,1.0
2660,8,2660,2.5,0,0,0,3,0,2.0
950,7,950,1.0,0,0,0,2,0,1.0
1950,7,1950,2.5,0,0,0,3,0,2.0
1930,7,1380,2.5,0,0,550,4,0,1.0
1050,6,1050,1.0,0,0,0,2,0,1.5
2350,7,2350,2.5,0,0,0,3,0,2.0
2150,8,1400,2.5,1,3,750,4,0,1.0
2481,8,2481,2.75,0,0,0,5,0,2.0
1340,6,1340,1.75,0,0,0,2,0,1.0
3720,9,1930,3.0,0,0,1790,4,0,1.0
2100,9,2100,2.0,0,0,0,3,0,1.0
1580,7,1580,2.5,0,0,0,4,0,1.0
1120,7,1120,1.0,1,0,0,3,0,1.0
1710,7,1060,1.75,0,0,650,3,0,1.0
4830,11,4830,3.25,1,4,0,4,1,2.0
2000,7,2000,2.5,0,0,0,4,0,2.0
1560,8,1560,2.5,0,0,0,3,0,2.0
1890,8,1890,2.5,0,0,0,3,0,2.0
8000,12,6720,5.0,1,4,1280,5,0,2.0
2410,8,2060,1.75,0,3,350,4,0,2.0
2910,10,2910,2.5,0,0,0,3,0,2.0
2690,9,2690,2.75,0,0,0,3,0,1.0
1770,8,1190,2.25,0,0,580,4,0,1.0
2060,8,2060,2.5,0,0,0,3,0,2.0
5790,10,4430,3.25,1,3,1360,5,0,2.0
870,7,870,1.0,0,2,0,2,0,1.0
1530,8,1530,2.5,0,0,0,3,0,2.0
1860,8,1860,2.5,0,0,0,3,0,2.0
3310,9,1660,2.25,1,4,1650,4,0,1.0
890,6,890,1.0,0,0,0,2,0,1.0
1910,8,1910,2.5,0,0,0,4,0,2.0
1230,7,1230,1.0,0,0,0,3,0,1.0
2678,9,2678,2.5,0,0,0,3,0,2.0
1900,7,950,1.75,0,0,950,3,0,1.0
1410,7,810,1.75,0,0,600,3,0,1.0
1100,6,1100,1.0,0,0,0,2,0,1.0
1640,7,1220,2.25,0,0,420,3,0,1.0
2630,8,2630,2.5,0,0,0,2,0,2.0
1990,7,1990,2.25,0,0,0,3,0,2.0
1200,7,1200,1.0,0,0,0,3,0,1.0
4410,11,3430,3.5,0,4,980,3,1,2.0
7100,13,5240,5.0,0,0,1860,6,0,2.5
1760,7,1760,1.75,0,4,0,3,1,2.0
3390,10,3390,2.5,0,2,0,4,0,2.0
3310,9,3310,3.5,0,0,0,4,0,2.0
3410,8,2190,1.0,0,0,1220,4,0,2.0
2245,8,2245,2.5,0,0,0,4,0,2.0
1600,7,1600,1.75,0,0,0,3,0,2.0
1570,8,1570,1.5,0,3,0,3,0,1.0
2500,8,2500,2.75,0,0,0,4,0,2.0
3320,9,3320,2.5,0,0,0,5,0,2.0
1580,8,1180,1.75,0,0,400,3,0,1.0
2230,7,1390,1.75,0,0,840,6,0,1.0
3220,8,3220,2.25,0,0,0,5,0,2.0
1920,7,1920,2.5,0,0,0,4,0,2.0
1900,7,1900,2.5,0,0,0,4,0,2.0
3560,10,2590,3.5,0,3,970,4,0,2.0
2560,8,2560,3.0,0,0,0,2,0,1.0
1540,7,960,2.0,0,0,580,2,0,1.0
1530,8,1530,1.75,0,0,0,3,0,2.0
6050,11,6050,5.0,0,3,0,6,0,2.0
3070,9,2070,2.5,1,3,1000,4,0,1.0
4040,11,4040,3.75,0,0,0,4,0,2.0
1150,7,1150,2.5,0,0,0,3,0,2.0
1615,8,1615,2.0,0,0,0,2,0,1.5
720,5,720,1.0,0,0,0,2,0,1.0
2620,7,1570,2.5,1,2,1050,4,0,1.0
2310,8,2310,2.5,0,0,0,4,0,2.0
3880,10,2570,2.5,1,0,1310,4,0,2.0
2960,8,1550,2.25,0,2,1410,5,0,1.0
2290,8,1550,2.25,0,2,740,4,0,1.0
2810,7,1740,2.5,0,0,1070,4,0,1.0
2520,8,1720,2.75,0,0,800,4,0,2.0
1650,8,1230,1.75,1,0,420,3,0,1.0
3140,10,3140,3.25,1,0,0,6,0,2.0
3600,8,1800,4.0,0,2,1800,5,0,1.0
2420,9,1870,3.25,0,0,550,4,0,1.5
1750,7,1750,2.5,1,0,0,3,0,2.0
2040,7,2040,2.0,0,0,0,5,0,2.0
1670,7,1310,2.5,0,0,360,3,0,1.0
2260,9,2260,2.25,1,0,0,4,0,1.0
3090,8,1750,2.5,0,0,1340,5,0,1.0
1500,7,1500,1.0,0,0,0,3,0,1.5
1680,8,1680,2.25,0,0,0,4,0,2.0
2350,7,2350,2.5,0,0,0,4,0,2.5
2850,8,1680,2.5,0,1,1170,3,0,1.0
2000,7,1080,1.75,0,0,920,3,0,1.0
2790,10,2790,2.5,1,0,0,4,0,2.0
1760,7,1760,2.25,0,0,0,3,0,2.0
2540,8,1520,2.75,0,0,1020,5,0,1.0
3260,8,3260,2.5,0,0,0,4,0,2.0
1170,8,1170,1.5,0,0,0,2,0,3.0
1430,7,1430,1.0,0,0,0,3,0,1.5
1250,7,1250,1.75,0,0,0,3,0,1.0
3160,9,1820,2.5,1,2,1340,3,0,1.0
860,6,860,1.0,0,0,0,3,0,1.0
2710,9,2710,2.5,0,0,0,4,0,2.0
1100,9,1100,2.25,0,0,0,2,0,2.0
1450,7,1450,1.5,0,0,0,2,0,1.0
2260,10,2260,2.5,0,0,0,3,0,1.5
2650,9,2650,2.5,0,0,0,4,0,2.0
1190,7,1190,2.0,0,0,0,3,0,1.0
1880,8,1880,2.0,1,0,0,2,0,1.5
1570,7,800,2.5,0,0,770,4,0,1.0
1590,7,1190,1.75,0,0,400,3,0,1.0
3361,9,3361,2.5,0,0,0,4,0,2.0
2200,8,2200,2.5,0,0,0,3,0,2.0
2020,7,1700,1.0,0,3,320,2,0,1.0
2210,9,2210,2.25,0,0,0,4,0,2.0
2510,8,2510,2.25,0,0,0,3,0,2.0
2370,8,1660,2.25,1,0,710,4,0,1.0
3490,10,3490,2.75,0,0,0,5,0,2.0
1940,7,970,2.0,0,2,970,3,0,1.0
2340,8,1590,2.5,0,2,750,4,0,1.0
1820,7,1280,2.25,0,0,540,3,0,1.0
2440,10,1640,2.75,0,0,800,3,0,1.0
2300,8,2300,2.5,0,0,0,4,0,2.0
2620,9,2620,2.5,0,0,0,4,0,2.0
1180,8,1180,1.5,0,0,0,2,0,2.0
1690,6,890,1.75,0,0,800,4,0,1.0
1560,7,1560,1.5,0,0,0,4,0,1.0
1010,7,1010,1.0,0,0,0,3,0,1.0
2420,9,1620,2.5,0,3,800,3,0,1.0
2130,7,1350,2.0,0,0,780,4,0,1.0
1260,6,1260,1.0,0,0,0,3,0,1.0
2750,9,2750,2.5,0,0,0,4,0,2.0
1880,6,1360,1.0,0,0,520,5,0,1.5
1060,7,1060,2.0,0,0,0,3,0,1.0
1670,7,1670,2.25,0,0,0,3,0,2.0
2456,8,2456,2.5,0,0,0,3,0,2.0
630,5,630,1.0,0,0,0,2,0,1.0
1440,6,720,2.0,0,0,720,3,0,1.0
2610,8,1760,2.75,1,0,850,4,0,1.0
2529,7,2529,2.5,0,0,0,3,0,2.0
1650,7,910,1.75,0,0,740,4,0,1.0
1640,7,1040,2.0,0,0,600,3,0,1.0
1800,7,1800,2.25,0,0,0,3,0,2.0
3340,9,2420,2.5,0,0,920,3,0,2.0
2350,8,1990,2.0,0,0,360,3,0,1.5
1080,7,1080,2.0,0,0,0,3,0,1.0
940,7,940,1.0,0,0,0,2,0,1.0
1300,7,1300,1.75,0,0,0,3,0,1.0
1590,7,1590,2.5,0,0,0,3,0,3.0
1100,7,1100,1.5,0,0,0,3,0,1.0
1240,7,1240,1.0,0,1,0,2,0,1.0
1360,7,1360,1.5,0,0,0,3,0,2.0
2270,9,2270,2.75,1,0,0,4,0,2.0
1040,6,1040,0.75,0,0,0,3,0,1.0
1630,8,1630,3.25,0,0,0,3,0,3.0
1270,7,1270,1.0,0,0,0,3,0,1.0
3080,9,1700,1.75,0,0,1380,4,0,1.0
1320,6,1020,2.0,0,0,300,3,0,1.0
1610,7,1610,2.5,0,0,0,3,0,2.0
790,6,790,1.0,0,0,0,2,0,1.0
920,6,920,1.0,0,0,0,2,0,1.0
2420,8,1620,2.25,0,2,800,4,0,1.0
1920,7,1260,1.75,1,0,660,5,0,1.0
1750,8,1320,2.25,0,0,430,4,0,1.0
4070,10,4070,4.0,1,0,0,5,0,2.0
2540,8,1820,3.5,0,0,720,4,0,2.0
2890,8,1630,2.5,0,0,1260,6,0,1.0
1510,8,1510,1.75,0,0,0,3,0,1.0
2600,8,2600,2.5,0,0,0,4,0,2.0
2070,8,2070,2.5,0,0,0,3,0,2.0
990,6,990,1.0,0,0,0,2,0,1.0
1070,7,1070,1.75,0,0,0,3,0,1.0
2180,9,2180,2.25,0,0,0,3,0,2.0
2990,7,2990,2.5,0,0,0,4,0,2.0
1030,6,880,1.0,0,0,150,3,0,1.0
1680,7,870,1.75,0,0,810,3,0,1.0
2470,9,2470,2.5,0,0,0,4,0,2.0
1320,7,1320,1.0,0,0,0,3,0,1.0
4490,10,3930,5.0,1,0,560,5,0,2.0
2550,8,1390,2.75,0,0,1160,5,0,1.0
1240,8,1240,1.5,0,0,0,3,0,1.5
1540,7,1540,1.5,0,0,0,3,0,1.0
1570,7,1570,2.25,0,3,0,3,0,1.0
3600,9,2720,3.5,1,0,880,4,0,2.0
2370,8,1600,2.5,1,0,770,4,0,1.0
2270,7,1820,2.5,0,0,450,2,0,3.0
3390,9,3390,2.75,0,0,0,4,0,2.0
1830,7,1830,1.0,0,0,0,3,0,1.0
2450,7,1550,2.75,0,0,900,4,0,1.5
1210,7,910,1.75,0,0,300,2,0,1.0
1610,7,1010,2.0,0,0,600,3,0,1.0
4700,11,3500,3.5,1,3,1200,4,0,2.0
1180,7,1180,1.0,0,0,0,2,0,1.0
1570,7,1570,2.0,0,0,0,4,0,2.0
1300,7,1300,1.0,0,0,0,3,0,1.0
4930,9,3930,2.5,0,0,1000,3,0,2.0
1830,7,1830,1.5,0,0,0,3,0,1.0
1510,8,1510,1.5,0,0,0,3,0,1.0
1490,7,1010,1.75,0,0,480,3,0,1.0
3320,8,1810,2.25,1,0,1510,4,0,1.0
3830,9,3050,4.5,0,0,780,6,0,3.0
2150,7,1650,1.75,0,0,500,3,0,1.0
1400,7,1400,1.0,0,0,0,3,0,1.0
1560,7,1560,1.5,0,0,0,3,0,1.0
1680,9,1120,2.5,0,0,560,3,0,2.0
1640,7,1540,1.5,0,0,100,2,0,1.5
2190,7,2190,2.5,0,0,0,4,0,2.0
1500,8,1500,2.5,0,0,0,2,0,2.0
2190,8,1550,2.5,0,0,640,3,0,1.0
1980,6,1070,2.0,1,0,910,3,0,1.5
2030,8,2030,2.5,0,0,0,3,0,2.0
1657,7,1657,1.0,0,0,0,2,0,2.0
6810,13,6110,3.75,0,0,700,5,0,2.5
2180,7,2180,3.0,0,0,0,4,0,2.0
4130,11,4130,3.25,0,0,0,4,0,2.0
1170,6,1170,1.0,0,0,0,2,0,1.0
2110,8,2110,2.5,0,0,0,3,0,2.0
1410,7,1410,1.75,0,0,0,3,0,1.0
2100,8,2100,3.0,0,0,0,4,0,2.0
2750,9,2750,2.5,0,0,0,3,0,2.0
2880,8,1920,2.25,0,0,960,4,0,1.0
2710,7,2710,2.5,0,0,0,3,0,2.0
1140,7,1140,1.0,0,0,0,3,0,1.0
3410,9,3410,2.75,0,0,0,4,0,2.0
1400,7,1400,1.75,1,0,0,3,0,1.0
2090,7,2090,2.5,0,0,0,3,0,2.0
3400,8,2300,2.5,0,0,1100,3,0,2.0
1500,7,1500,1.5,0,0,0,3,0,1.0
2240,8,2240,2.5,0,0,0,3,0,2.0
940,6,940,1.0,0,0,0,3,0,1.0
2870,9,2870,2.5,1,0,0,5,0,2.0
2370,8,1550,2.25,0,0,820,4,0,1.0
2160,8,2160,1.75,0,0,0,4,0,2.0
2390,8,2390,2.5,0,0,0,4,0,2.0
2190,8,2190,2.25,0,0,0,3,0,3.0
2200,9,1600,1.0,0,0,600,3,0,1.0
1160,7,1160,1.0,0,0,0,2,0,1.0
1630,7,1630,1.0,0,0,0,2,0,1.0
1290,7,1290,1.0,1,0,0,2,0,1.0
1810,7,1360,1.0,0,0,450,3,0,1.0
2110,9,2110,2.5,0,0,0,3,0,2.0
3400,10,3400,3.0,0,0,0,4,0,2.0
710,6,710,1.0,0,0,0,2,0,1.0
2840,8,2840,2.5,0,0,0,4,0,2.0
1510,7,1510,2.0,0,0,0,2,0,1.5
2630,7,1330,1.75,0,0,1300,3,0,1.0
2010,7,1410,1.75,0,0,600,4,0,1.0
960,7,960,1.0,0,0,0,2,0,1.0
2070,7,2070,2.0,1,0,0,4,0,1.0
2710,7,2710,1.0,0,3,0,3,0,2.0
2430,8,1670,2.5,0,0,760,4,0,1.0
2220,7,1490,1.5,1,0,730,4,0,1.0
1230,8,1080,2.25,0,0,150,3,0,2.0
2800,8,1420,2.5,0,0,1380,4,0,1.0
1720,7,1440,2.25,0,0,280,3,0,1.0
2210,8,1210,2.0,0,1,1000,4,0,1.0
1660,7,980,1.5,0,0,680,3,0,1.0
2440,7,2440,2.5,0,0,0,4,0,2.0
1940,8,1940,2.5,0,0,0,4,0,2.0
860,6,860,1.0,0,0,0,3,0,1.0
1810,7,1810,1.75,0,0,0,3,0,1.0
4380,11,4380,3.5,0,0,0,5,0,2.0
1610,7,1610,1.0,0,0,0,4,0,1.0
390,6,390,1.0,0,0,0,1,0,1.0
2320,7,1260,3.0,1,0,1060,4,0,1.0
1520,7,1030,1.0,0,0,490,3,0,1.0
3150,9,3150,2.5,0,0,0,3,0,2.0
1030,6,930,1.75,0,0,100,3,0,1.0
2440,8,2440,2.25,0,0,0,4,0,2.0
2820,9,2050,2.5,0,0,770,4,0,2.0
1440,7,1040,2.75,0,0,400,3,0,1.0
1560,7,1560,1.0,0,0,0,3,0,1.0
1040,7,1040,1.0,0,0,0,3,0,1.0
2910,9,2510,2.25,0,0,400,3,0,1.5
2670,9,1780,2.0,0,0,890,4,0,1.5
910,7,910,1.0,0,0,0,2,0,1.0
1790,7,1190,3.0,0,0,600,3,0,1.0
2490,9,2490,2.5,0,0,0,4,0,2.0
1040,8,1040,2.25,0,0,0,2,0,2.0
1910,7,1000,2.0,0,0,910,3,0,1.0
1300,6,1300,1.75,0,0,0,3,0,1.5
2170,8,2170,2.5,0,0,0,3,0,2.0
1220,8,1110,1.5,0,0,110,2,0,2.5
2692,9,2692,2.5,0,0,0,4,0,2.0
2370,7,2370,2.75,0,0,0,3,0,2.0
3020,9,3020,2.5,0,4,0,4,0,2.0
1570,8,1290,3.25,0,0,280,3,0,2.0
1930,7,1030,1.5,0,0,900,6,0,1.0
2370,8,1950,2.5,0,0,420,3,0,2.0
2510,8,2510,2.25,0,0,0,4,0,2.0
1340,9,1340,1.5,0,1,0,3,0,1.5
2010,8,2010,2.5,1,0,0,3,0,2.0
2270,8,2270,2.5,0,0,0,3,0,2.0
1770,8,1770,2.0,0,0,0,3,0,3.0
1480,7,1480,1.75,0,0,0,4,0,1.0
1520,8,1400,2.25,0,0,120,3,0,2.0
4380,11,4380,4.0,0,0,0,3,0,2.0
1490,7,1490,2.25,0,0,0,3,0,2.0
1600,7,1110,1.0,0,0,490,3,0,1.5
910,6,910,1.0,0,0,0,2,0,1.0
1580,7,1580,1.75,0,0,0,3,0,1.0
1650,7,1130,2.0,0,0,520,4,0,1.0
1750,7,1050,1.5,0,0,700,3,0,1.0
1800,7,900,1.5,0,4,900,2,0,1.0
920,7,920,1.0,0,0,0,3,0,1.0
2577,8,2577,2.5,0,0,0,3,0,2.0
3180,8,1590,2.5,1,0,1590,6,0,1.0
1090,7,1090,1.0,0,0,0,3,0,1.0
2210,8,1510,2.25,1,0,700,3,0,1.0
2240,8,2240,2.5,0,0,0,4,0,2.0
1550,8,1550,2.25,0,0,0,3,0,3.0
3620,9,3620,3.0,0,2,0,4,0,2.0
1860,8,930,2.0,0,0,930,3,0,1.0
900,6,790,1.0,0,0,110,3,0,1.0
1260,6,1260,1.0,0,0,0,3,0,1.0
1290,7,1290,1.0,1,0,0,3,0,1.0
1120,7,1120,1.0,0,0,0,3,0,1.0
1450,7,1450,1.75,0,0,0,4,0,1.0
2298,7,2298,1.0,0,0,0,3,0,1.0
1120,8,1120,1.5,0,0,0,2,0,3.0
3100,9,2090,3.25,0,2,1010,4,0,2.0
1560,7,1290,2.25,0,0,270,3,0,1.0
1950,9,1500,2.5,0,0,450,2,0,2.0
2201,8,2201,2.5,0,0,0,4,0,2.0
1730,8,1730,2.5,0,0,0,3,0,2.0
2710,7,1890,3.0,0,0,820,5,0,2.0
2780,9,2780,2.5,1,0,0,4,0,2.0
1640,7,1640,1.75,0,0,0,3,0,1.5
830,6,830,1.0,0,0,0,2,0,1.0
2192,8,2192,2.25,0,0,0,4,0,2.0
1280,7,1280,2.5,0,0,0,2,0,2.0
1700,7,1200,1.75,0,0,500,3,0,1.0
1360,6,1360,1.75,0,0,0,2,0,1.0
2310,10,2020,2.75,0,0,290,3,0,2.0
840,6,840,1.0,0,0,0,2,0,1.0
2810,9,2810,2.5,0,0,0,5,0,2.5
3181,8,3181,2.5,0,0,0,4,0,2.0
1090,6,1090,1.0,0,0,0,3,0,1.0
4590,11,3450,3.75,1,0,1140,5,0,2.0
3650,7,3650,2.0,0,0,0,3,0,2.0
2110,9,2110,2.5,0,0,0,3,0,2.0
988,7,988,1.5,0,0,0,2,0,3.0
2400,7,1890,1.0,0,0,510,3,0,1.0
1530,7,1400,1.0,0,0,130,4,0,1.5
2520,9,2520,2.5,0,0,0,4,0,2.0
1020,7,1020,1.0,0,0,0,2,0,1.0
830,6,830,1.0,0,0,0,2,0,1.0
2140,6,1320,1.0,0,0,820,4,0,1.5
1560,7,1560,1.75,0,0,0,3,0,1.0
1550,7,1550,2.0,0,0,0,3,0,1.5
1980,8,1520,1.5,0,0,460,3,0,1.0
1300,7,1300,1.75,0,0,0,3,0,1.0
2900,9,2900,2.5,0,0,0,4,0,2.0
2740,9,1930,1.5,0,0,810,4,0,2.0
1010,7,1010,1.5,0,0,0,2,0,2.0
1340,7,890,2.0,0,0,450,3,0,1.0
1230,7,1230,1.5,0,0,0,2,0,2.0
2660,9,2660,2.75,0,0,0,4,0,2.0
1300,6,650,1.75,0,0,650,2,0,1.0
2520,7,1600,2.0,0,0,920,4,0,1.0
3690,9,1890,1.75,0,0,1800,5,0,1.0
2450,8,2450,2.75,0,2,0,4,0,2.0
1440,7,1440,2.25,0,0,0,3,0,1.0
1440,7,1150,1.0,0,0,290,2,0,1.0
2660,8,1820,3.0,1,0,840,4,0,1.5
1430,8,990,2.0,0,0,440,3,0,1.0
2090,7,2090,2.25,0,0,0,4,0,2.0
1444,7,1444,1.75,0,0,0,3,0,1.5
3520,10,3520,2.5,0,0,0,4,0,2.0
1840,7,1270,2.25,0,0,570,3,0,1.0
1700,7,1700,2.25,0,0,0,5,0,1.5
1260,6,1260,1.0,0,0,0,2,0,2.0
910,8,820,1.5,0,0,90,2,0,2.0
900,6,900,1.0,0,0,0,2,0,1.0
810,7,810,1.0,0,0,0,1,0,1.0
3880,7,3880,3.0,0,0,0,5,0,2.0
4320,7,2880,2.25,0,0,1440,5,0,2.0
1420,7,1420,1.5,0,0,0,4,0,1.5
2440,8,1560,2.5,1,0,880,4,0,1.0
2440,8,1440,2.0,0,0,1000,3,0,1.0
2070,8,2070,2.25,0,0,0,4,0,2.0
1260,7,870,1.5,0,0,390,3,0,1.0
950,7,950,1.0,1,0,0,3,0,1.0
1060,7,1060,1.0,0,0,0,2,0,1.5
1720,7,1220,2.25,0,0,500,3,0,1.0
1950,7,1950,2.0,0,0,0,4,0,1.0
3500,9,2590,3.5,0,2,910,4,0,2.0
1370,7,1370,1.5,0,0,0,3,0,2.0
1820,7,1820,1.5,0,0,0,3,0,1.0
3360,9,3360,2.25,0,0,0,4,0,2.0
2840,10,2840,3.5,0,0,0,3,0,3.0
720,6,720,1.0,0,0,0,1,0,1.0
1300,7,1300,1.5,1,0,0,3,0,1.0
4060,9,2790,2.5,0,0,1270,4,0,2.0
1140,6,1140,1.5,1,0,0,2,0,1.0
1370,8,1080,2.75,0,0,290,2,0,2.0
1920,7,1920,1.75,0,0,0,4,0,1.0
1460,7,1460,1.5,0,0,0,3,0,1.0
2010,8,2010,2.0,0,0,0,3,0,1.0
1350,7,1350,1.5,0,0,0,3,0,1.0
2240,8,2240,2.5,0,0,0,4,0,2.0
1820,8,1570,2.5,0,0,250,3,0,2.0
1380,7,1380,1.0,0,0,0,3,0,1.0
1580,7,1390,1.5,0,0,190,4,0,1.5
2730,8,2130,2.25,0,0,600,5,0,1.5
2700,7,2110,1.75,0,0,590,3,0,1.0
1520,7,1520,2.5,0,0,0,3,0,2.0
2510,9,2510,3.25,0,0,0,4,0,2.0
2700,9,2700,2.75,0,0,0,2,0,1.0
1010,6,1010,1.0,0,0,0,2,0,2.0
3320,9,1900,2.25,0,2,1420,5,0,1.0
2440,7,1390,1.75,0,0,1050,4,0,1.0
2530,8,2530,2.25,0,0,0,3,0,2.0
2250,8,2250,2.5,0,0,0,3,0,2.0
2540,7,1480,2.0,0,0,1060,5,0,1.0
1770,7,1770,2.5,0,0,0,3,0,2.0
1250,7,1030,1.0,0,0,220,3,0,1.0
860,7,860,1.0,0,0,0,3,0,1.5
1420,7,1420,2.25,0,0,0,3,0,2.0
2140,8,1220,1.75,1,0,920,3,0,1.0
1430,7,1140,1.75,0,2,290,3,0,1.0
1260,7,1040,1.0,0,0,220,2,0,1.0
1340,7,1340,2.5,0,0,0,3,0,2.0
1120,6,1120,1.5,0,0,0,4,0,1.0
1870,7,1060,2.0,0,0,810,3,0,1.5
2740,9,2740,2.5,1,0,0,4,0,2.0
2090,8,1070,1.75,0,0,1020,4,0,1.0
3160,10,1740,2.75,0,0,1420,5,0,2.0
1200,6,1200,1.0,0,0,0,3,0,1.0
3210,8,1610,2.75,0,0,1600,4,0,1.0
2990,9,2990,2.5,0,0,0,4,0,2.0
2820,7,2380,2.5,0,0,440,5,0,2.0
1710,7,1240,1.75,0,0,470,3,0,1.0
1500,6,750,1.75,0,2,750,3,0,1.0
1160,7,1160,1.0,0,0,0,3,0,1.0
1820,7,1520,2.0,0,2,300,3,0,2.0
2550,9,2550,2.5,0,0,0,3,0,2.0
2257,8,1363,3.0,0,0,894,5,0,1.0
3390,7,1970,2.75,0,0,1420,4,0,1.0
3230,9,2350,3.25,0,1,880,5,0,2.0
1970,8,1970,2.5,0,0,0,4,0,2.0
2070,8,2070,2.5,0,0,0,3,0,2.0
2090,7,1360,2.5,0,0,730,3,0,1.0
1050,7,1050,2.5,0,0,0,2,0,2.0
1540,7,770,1.0,0,0,770,4,0,1.0
1600,7,930,2.0,0,0,670,3,0,1.0
1540,7,1540,2.0,0,0,0,3,0,1.0
1980,8,1210,1.75,0,0,770,4,0,1.5
1770,8,1330,2.25,0,0,440,3,0,1.0
1360,7,1360,2.25,0,0,0,3,0,1.5
930,7,930,1.0,0,0,0,2,0,1.0
2800,7,2800,3.75,0,0,0,5,0,1.0
1850,8,1850,2.5,1,0,0,3,0,2.0
2170,9,2170,3.5,0,0,0,4,0,2.0
3770,10,3770,2.5,0,0,0,4,0,2.0
1470,8,1470,2.5,1,0,0,2,0,2.0
1980,8,1980,2.5,0,0,0,3,0,2.0
1950,7,1250,2.75,0,0,700,3,0,1.0
1990,8,1990,2.25,0,0,0,3,0,2.0
1850,7,1140,1.75,0,0,710,4,0,1.0
2180,7,1410,2.5,0,0,770,4,0,2.0
3400,9,3400,2.75,1,0,0,4,0,2.0
2160,7,1260,1.75,0,0,900,3,0,1.5
1380,6,1380,1.0,0,0,0,3,0,1.5
1830,8,1830,2.5,0,0,0,3,0,2.0
2790,8,2790,2.75,0,0,0,4,0,2.0
2250,8,2250,2.5,0,0,0,4,0,2.0
3720,7,3720,3.0,0,0,0,4,0,3.0
3730,10,2440,3.5,0,2,1290,4,0,2.0
1390,5,1390,1.0,0,0,0,3,0,1.0
2020,8,1010,2.0,0,0,1010,4,0,1.0
3192,8,3192,2.5,0,0,0,3,0,2.0
1610,7,1610,1.75,1,0,0,3,0,1.0
3240,10,3240,2.5,0,0,0,3,0,2.0
2530,6,2530,3.0,1,0,0,6,0,1.0
3510,10,3510,3.5,0,0,0,4,0,2.0
1360,6,960,2.0,0,0,400,4,0,1.0
2140,8,1440,2.25,0,0,700,3,0,1.0
1930,8,1540,2.25,0,0,390,4,0,1.5
850,6,850,1.0,0,0,0,2,0,1.0
2510,7,1460,3.0,0,0,1050,6,0,1.0
3240,9,1860,2.5,0,0,1380,4,0,1.0
3370,10,3370,3.25,1,0,0,5,0,2.0
3400,8,2320,4.0,0,0,1080,5,0,2.0
1480,7,1480,2.5,0,0,0,3,0,1.0
1320,7,1320,1.0,0,0,0,3,0,2.0
1620,7,1090,1.75,0,0,530,3,0,1.0
2230,7,2230,2.5,0,0,0,4,0,2.0
1770,8,1370,1.75,0,0,400,4,0,1.0
2630,9,2630,2.5,0,0,0,3,0,2.0
1860,8,1860,2.25,1,0,0,2,0,2.0
2830,9,2830,2.75,0,0,0,4,0,2.0
1230,8,1230,1.5,0,0,0,2,0,3.0
1000,7,1000,1.0,0,2,0,2,0,1.0
1500,7,1500,1.75,0,0,0,3,0,1.0
4070,10,4070,2.25,1,0,0,4,0,2.0
1463,7,1463,2.0,0,0,0,3,0,3.0
1440,6,1440,2.0,0,0,0,3,0,2.0
1088,6,1088,1.0,0,0,0,2,0,1.0
2730,7,2730,2.5,0,0,0,4,0,2.0
1840,8,1340,2.75,0,2,500,3,0,1.0
1480,8,1480,2.5,0,0,0,3,0,3.0
870,6,870,1.0,0,0,0,2,0,1.0
1020,6,1020,1.0,0,0,0,2,0,1.0
1400,8,1400,2.25,0,2,0,3,0,3.0
1410,7,1410,2.0,0,0,0,3,0,1.0
1460,8,1460,3.25,0,0,0,3,0,3.0
4510,8,3270,2.75,0,2,1240,4,0,2.5
2330,8,1560,2.75,0,0,770,4,0,1.0
1980,7,1160,3.0,0,0,820,4,0,1.0
1190,8,1190,2.5,0,0,0,3,0,3.0
3190,10,3190,3.5,0,0,0,3,0,2.0
2040,7,1020,1.75,0,0,1020,5,0,1.0
2250,7,1550,2.5,0,0,700,4,0,1.0
1960,8,1220,2.25,0,0,740,4,0,1.0
1940,7,1940,1.75,0,0,0,5,0,1.5
940,7,940,1.0,0,0,0,3,0,1.0
2090,7,2090,2.5,0,0,0,4,0,2.0
1580,7,1180,1.75,0,0,400,3,0,1.0
2610,8,2610,2.5,0,0,0,3,0,2.0
2260,8,2260,2.25,0,0,0,4,0,2.0
3480,11,3480,2.5,0,0,0,4,0,2.0
2790,9,2790,2.5,1,0,0,4,0,2.0
1810,7,1030,1.75,0,0,780,3,0,1.0
1600,7,1600,1.0,0,0,0,3,0,1.5
1660,7,1040,1.75,0,0,620,3,0,1.0
1950,6,1160,2.0,0,0,790,4,0,1.0
1030,6,1030,1.0,0,0,0,2,0,1.0
1770,7,1770,2.25,0,0,0,3,0,2.0
2000,7,2000,1.0,0,0,0,4,0,2.0
2320,7,2320,2.5,0,0,0,4,0,2.0
1240,7,1240,1.0,0,0,0,3,0,1.5
2350,7,1320,1.25,0,0,1030,3,0,1.0
2510,9,2510,2.5,0,0,0,3,0,2.0
1910,6,910,2.0,0,0,1000,4,0,1.0
2840,10,2840,3.5,0,4,0,4,0,1.0
2610,9,2610,2.5,0,0,0,4,0,2.0
1930,8,1930,2.0,0,0,0,3,0,1.0
2130,8,1170,1.75,0,2,960,3,0,1.0
2400,8,2400,3.25,0,0,0,4,0,2.0
1950,8,1950,1.5,0,0,0,3,0,3.0
700,6,700,1.0,0,0,0,2,0,1.0
1880,7,1330,1.75,0,0,550,3,0,1.0
2730,9,1740,2.75,0,2,990,4,0,1.0
1740,7,1740,1.0,0,0,0,3,0,1.0
1240,6,860,1.5,0,0,380,2,0,1.0
1240,6,1240,1.0,0,0,0,3,0,1.0
3170,9,3170,2.75,0,0,0,5,0,2.0
3840,8,2460,3.0,0,3,1380,6,0,1.5
3180,9,3180,2.5,0,3,0,4,0,2.0
1790,7,1380,2.25,0,0,410,3,0,1.5
860,6,860,1.0,0,0,0,2,0,1.0
1340,8,1340,1.5,0,0,0,3,0,1.0
4330,11,3230,3.5,1,0,1100,4,0,2.0
1690,7,1690,2.5,0,0,0,3,0,2.0
1550,6,1330,1.5,0,0,220,3,0,1.0
1550,7,1550,2.5,0,0,0,3,0,2.0
1280,8,1200,1.5,0,0,80,2,0,2.0
960,7,960,1.0,0,0,0,3,0,1.0
940,7,940,1.0,0,0,0,3,0,1.5
1800,8,1800,1.5,0,0,0,3,0,2.0
1660,7,830,1.75,0,0,830,2,0,1.0
2410,7,2410,2.5,0,0,0,3,0,2.0
1490,7,1490,2.0,0,0,0,3,0,1.0
1430,8,1430,2.25,0,0,0,3,0,2.0
1610,8,1220,3.25,0,0,390,3,0,2.0
1200,6,1200,1.0,0,0,0,2,0,1.0
1790,7,1790,1.5,0,0,0,4,0,1.5
2140,8,1070,2.0,0,0,1070,3,0,1.0
800,7,800,1.5,0,0,0,2,0,2.0
1580,8,1580,2.5,0,0,0,3,0,2.0
1140,6,1140,1.0,0,0,0,2,0,1.5
1170,8,1170,2.5,0,0,0,2,0,2.0
4460,11,4460,4.0,0,0,0,4,0,2.0
4340,11,4340,3.5,0,0,0,4,0,2.0
1570,7,1200,2.25,0,0,370,3,0,1.0
1360,7,1360,1.75,0,0,0,3,0,1.0
3530,9,2660,3.25,0,0,870,3,0,2.0
1440,7,960,1.75,0,0,480,3,0,1.0
1390,7,1390,1.0,0,0,0,3,0,1.0
2400,8,1230,2.5,0,0,1170,4,0,1.0
3490,10,2280,2.25,0,0,1210,4,0,2.0
1810,7,1210,2.5,0,0,600,3,0,1.0
1530,6,1530,1.5,0,0,0,4,0,1.0
980,8,980,2.5,0,0,0,2,0,3.0
1660,7,1130,1.75,0,0,530,3,0,1.0
960,7,960,1.0,0,0,0,3,0,1.0
1470,7,1470,2.25,0,0,0,3,0,2.0
1620,7,1620,1.5,0,0,0,3,0,1.0
1040,6,1040,1.0,0,0,0,3,0,1.0
1830,7,1250,2.75,0,0,580,4,0,1.0
1300,7,1060,2.5,0,0,240,3,0,2.0
950,6,950,1.0,0,0,0,2,0,1.0
1790,7,1480,3.0,0,0,310,3,0,2.0
1160,7,1160,1.75,0,1,0,2,0,2.0
3410,10,3410,2.75,0,0,0,4,0,1.5
1960,8,1960,2.25,0,0,0,4,0,2.0
2610,8,1910,2.75,0,0,700,4,0,3.0
1030,6,1030,1.0,0,0,0,2,0,1.0
2750,8,1800,2.75,0,0,950,4,0,1.0
2250,8,1280,2.5,0,0,970,5,0,1.0
4270,10,4270,3.5,1,2,0,4,0,2.0
2490,9,2490,2.5,0,0,0,3,0,2.0
2410,8,2410,2.5,0,0,0,4,0,2.0
2970,9,2970,3.0,0,0,0,5,0,2.0
2950,8,2950,2.5,0,0,0,3,0,2.0
1260,6,1260,1.75,0,0,0,3,0,1.0
2140,8,2140,2.5,0,0,0,4,0,2.0
2030,9,1610,2.25,0,0,420,4,0,2.0
1960,7,980,2.75,0,0,980,4,0,1.0
2290,7,1550,2.75,0,0,740,4,0,1.5
1950,9,1950,2.5,0,0,0,3,0,2.0
1630,7,1630,2.5,0,0,0,3,0,2.0
2350,7,2350,2.75,0,0,0,4,0,2.0
1630,7,1270,1.0,0,0,360,2,0,1.0
1180,7,1040,1.75,0,0,140,3,0,1.0
1830,7,1830,2.5,0,0,0,3,0,2.0
2970,9,1770,2.5,0,0,1200,3,0,1.0
2500,9,2500,2.75,1,0,0,3,0,2.0
4200,9,3140,3.5,0,0,1060,5,0,2.0
2270,7,1520,2.25,0,0,750,4,0,1.5
1540,7,1140,2.75,0,0,400,5,0,1.0
1520,7,1520,1.75,0,0,0,3,0,1.0
1940,7,980,2.0,0,0,960,4,0,1.0
2090,8,1360,2.5,0,0,730,3,0,1.0
2710,8,2710,3.5,0,0,0,4,0,2.0
1480,7,1480,1.0,0,0,0,4,0,1.5
1410,7,1410,2.0,0,0,0,3,0,1.0
1450,7,1450,2.0,0,0,0,3,0,2.0
1730,7,1010,1.5,0,0,720,5,0,1.0
2030,7,2030,2.75,0,0,0,4,0,1.0
2720,9,2720,2.5,0,0,0,4,0,2.0
1940,7,1360,2.25,0,0,580,4,0,1.0
1413,8,1413,2.5,0,0,0,3,0,2.0
2700,8,1600,2.5,0,0,1100,4,0,1.0
1440,6,1440,1.75,0,0,0,3,0,1.5
1140,7,940,1.5,0,0,200,2,0,2.0
1570,7,1570,1.0,0,0,0,3,0,1.0
2170,9,2170,2.5,0,0,0,3,0,2.0
2780,7,2780,2.25,0,0,0,4,0,2.0
2020,7,1010,1.5,0,0,1010,4,0,1.0
1770,7,1350,2.25,0,0,420,3,0,1.0
1170,8,1170,1.0,0,0,0,3,0,1.0
2800,8,2800,2.5,0,0,0,4,0,2.0
700,6,700,0.75,0,0,0,2,0,1.0
1800,8,1800,2.5,0,0,0,3,0,2.0
2560,9,2560,2.5,0,0,0,4,0,2.0
1230,7,880,1.0,0,0,350,2,0,1.5
3490,10,3490,3.25,0,0,0,4,0,2.0
3730,10,3730,2.75,0,0,0,4,0,2.0
2030,8,2030,2.5,0,0,0,4,0,2.0
790,7,790,1.0,0,0,0,2,0,1.0
1790,8,1790,2.5,0,0,0,3,0,2.0
2480,8,2480,2.5,0,0,0,4,0,2.0
3250,9,3250,3.25,0,0,0,4,0,2.0
5020,12,5020,4.25,0,0,0,4,0,2.0
1560,8,1560,2.5,0,0,0,3,0,2.0
2340,7,2340,2.5,0,0,0,4,0,2.0
1320,7,1040,2.25,0,0,280,3,0,2.0
630,6,630,1.0,0,0,0,2,0,1.0
3280,7,2080,1.75,0,0,1200,4,0,1.0
3380,9,2700,3.5,0,0,680,3,0,2.0
2090,8,2090,2.5,0,0,0,4,0,2.0
2300,7,1600,3.0,0,0,700,6,0,2.0
1980,6,1580,1.0,0,0,400,3,0,1.5
2370,8,2370,2.5,0,0,0,3,0,2.0
1800,8,1800,2.5,0,0,0,4,0,2.0
3020,9,3020,3.25,0,0,0,4,0,1.0
3690,10,3690,3.5,0,0,0,3,0,2.0
880,7,880,1.0,0,0,0,2,0,1.0
1760,7,1230,1.75,0,0,530,3,0,1.0
3080,9,2010,3.5,0,0,1070,4,0,2.0
2070,8,1390,2.25,1,0,680,4,0,1.0
1870,8,1720,1.0,0,0,150,3,0,1.0
3580,10,2210,2.75,0,3,1370,3,0,2.0
1010,7,1010,1.0,0,0,0,3,0,1.0
3320,8,2190,2.75,0,0,1130,5,0,2.0
2130,7,1380,2.25,0,0,750,4,0,1.0
3450,10,2430,3.25,0,3,1020,4,0,2.0
1550,7,1050,1.75,0,0,500,3,0,1.0
2710,9,2080,2.5,0,4,630,3,0,1.0
4690,10,3450,4.5,1,0,1240,5,0,2.0
3170,10,1990,2.25,0,2,1180,2,0,2.0
2360,8,1760,3.0,0,0,600,4,0,1.0
1490,6,1490,1.0,0,0,0,3,0,1.0
2120,6,1770,2.0,1,0,350,4,0,1.0
2160,8,1460,2.5,0,0,700,4,0,1.0
1630,8,1630,1.0,0,3,0,3,0,1.0
1040,6,1040,1.75,0,0,0,3,0,1.0
1110,7,1110,2.0,0,0,0,3,0,1.0
1550,7,1550,2.0,1,0,0,3,0,1.0
1180,6,1180,2.0,0,0,0,2,0,2.0
870,6,870,1.0,0,0,0,2,0,1.0
1250,6,1250,1.0,0,0,0,3,0,1.0
2390,8,2220,2.5,0,0,170,3,0,2.0
1790,8,1330,1.75,0,0,460,3,0,1.0
1410,6,980,1.0,0,0,430,3,0,1.0
2830,9,2830,2.5,0,0,0,4,0,2.0
1490,7,1490,2.25,0,0,0,3,0,2.0
2620,8,2620,2.5,0,0,0,3,0,2.0
1860,7,1020,2.25,0,0,840,3,0,1.5
2170,8,2170,2.75,0,0,0,4,0,2.0
1730,8,1730,2.5,0,0,0,3,0,2.0
4120,10,4120,3.75,0,0,0,4,0,2.0
1987,7,1987,2.5,0,0,0,4,0,2.0
1430,7,1430,2.5,0,0,0,3,0,2.0
2340,7,1620,1.75,0,0,720,3,0,1.5
1800,7,1300,1.75,0,0,500,3,0,1.0
790,5,790,1.0,0,0,0,2,0,1.0
4430,10,4430,4.0,1,0,0,5,0,2.0
1370,8,1370,3.0,0,0,0,3,0,3.0
1810,8,1810,2.25,1,0,0,3,0,2.0
5700,10,2850,2.75,1,4,2850,6,0,1.0
870,6,870,1.0,0,0,0,3,0,1.0
2550,7,2550,2.5,0,0,0,5,0,2.0
2420,7,2420,2.5,0,0,0,4,0,2.0
1720,7,1720,2.0,0,0,0,4,0,1.0
1715,7,1715,2.25,0,0,0,3,0,2.0
2450,8,2450,2.5,0,0,0,3,0,2.0
1080,8,1080,1.0,0,0,0,2,0,1.0
1280,8,1280,3.0,0,0,0,3,0,3.0
3330,9,3330,2.25,0,0,0,4,0,2.0
2390,8,2390,2.5,0,0,0,4,0,2.0
1360,7,1360,1.5,0,0,0,2,0,2.0
1720,8,1720,1.5,0,0,0,3,0,2.0
2810,8,2810,2.5,0,0,0,4,0,2.0
2850,7,1730,2.0,0,1,1120,4,0,1.5
1060,7,1060,1.5,0,0,0,3,0,1.0
3786,9,1934,3.25,0,4,1852,3,1,1.0
1400,7,1400,1.75,0,0,0,3,0,1.0
4060,10,2890,1.75,0,3,1170,4,0,2.0
1100,6,1100,1.0,0,0,0,2,0,1.5
3250,8,3250,2.0,0,0,0,3,0,2.0
2060,8,1320,2.5,1,0,740,4,0,1.0
1300,7,1300,1.0,0,0,0,3,0,1.0
3540,10,3540,2.5,1,0,0,4,0,2.0
3180,9,2060,3.5,0,1,1120,4,0,2.0
2590,8,2590,2.75,0,0,0,5,0,2.0
1910,8,1910,2.5,0,0,0,3,0,2.0
3190,8,2210,2.5,0,0,980,4,0,1.0
2250,8,1450,1.75,0,0,800,4,0,1.0
2050,7,1240,1.75,0,0,810,3,0,1.0
950,7,950,1.0,0,0,0,3,0,1.0
2601,9,2601,2.5,0,0,0,4,0,2.0
2230,7,2230,2.5,0,0,0,3,0,2.0
1100,7,1100,1.0,0,0,0,3,0,1.0
1080,7,1080,1.0,0,2,0,2,0,1.0
2000,8,2000,2.5,0,0,0,3,0,2.0
2620,9,2620,2.75,0,0,0,4,0,2.0
5120,11,4490,4.0,0,2,630,3,0,3.0
470,4,470,0.75,0,0,0,1,0,1.0
3880,10,3880,2.5,0,0,0,4,0,2.0
930,5,930,1.0,0,0,0,2,0,1.0
2380,7,1410,2.25,0,0,970,4,0,1.0
2720,7,1360,2.5,0,0,1360,5,0,1.0
2610,8,1700,2.25,0,0,910,4,0,1.0
3250,9,3250,2.5,0,0,0,4,0,2.0
2040,7,2040,2.0,0,0,0,3,0,2.0
1550,7,1080,1.5,0,0,470,3,0,1.0
1420,6,1420,1.0,0,0,0,3,0,1.5
1900,7,1900,2.5,1,0,0,4,0,1.0
1160,6,1160,1.0,0,0,0,3,0,1.0
2430,9,2430,2.5,0,0,0,3,0,2.0
2080,8,1460,2.25,0,0,620,4,0,1.0
1240,8,1070,1.75,0,0,170,3,0,1.0
2844,8,2844,2.75,0,0,0,5,0,2.0
1890,7,1890,1.0,0,0,0,3,0,1.0
1340,7,1340,1.0,0,0,0,3,0,1.0
1610,7,1610,1.75,0,0,0,3,0,1.0
1560,7,1560,1.75,0,0,0,3,0,2.0
750,6,750,1.0,0,0,0,2,0,1.0
940,7,940,1.0,0,0,0,2,0,1.0
1680,8,1680,2.0,0,0,0,3,0,1.0
1140,8,940,1.75,0,0,200,2,0,2.0
1630,7,1630,1.5,0,0,0,3,0,1.0
2460,9,2460,2.75,0,0,0,4,0,2.0
2020,6,1760,1.0,0,0,260,3,0,1.0
1900,7,1410,2.75,0,0,490,3,0,1.0
4410,12,3880,3.25,0,2,530,5,0,2.0
1800,7,1800,2.5,0,0,0,3,0,2.0
1628,7,1628,1.75,0,0,0,3,0,1.0
1900,7,1900,2.0,0,0,0,4,0,1.0
1790,7,1790,2.5,0,0,0,4,0,2.0
2070,8,2070,2.5,0,0,0,4,0,2.0
1520,7,1520,3.0,0,0,0,3,0,3.0
1610,7,1210,1.75,0,2,400,3,0,1.0
1770,7,1770,2.25,0,0,0,4,0,2.0
1870,7,1580,1.0,0,0,290,5,0,1.0
620,6,620,1.0,0,0,0,1,0,1.0
4030,10,3630,3.25,0,0,400,3,0,2.0
1230,7,1230,1.0,1,0,0,3,0,1.0
2670,8,2670,2.75,0,0,0,5,0,2.0
2020,7,1380,2.25,0,0,640,4,0,1.0
2030,7,1400,2.5,0,0,630,4,0,1.0
2000,8,2000,1.75,0,0,0,3,0,1.5
2270,8,1570,2.5,0,0,700,5,0,1.0
1900,7,1300,1.75,0,0,600,3,0,1.0
2020,8,2020,2.5,0,3,0,3,0,3.0
1850,7,1090,3.0,0,0,760,3,0,1.0
1250,8,1250,2.25,0,0,0,3,0,3.0
2460,8,2460,2.5,1,0,0,4,0,2.0
1720,7,1020,1.75,0,0,700,3,0,1.0
2430,8,1270,2.5,0,1,1160,3,0,1.0
720,6,720,1.0,0,4,0,1,1,1.0
1590,7,1590,1.75,0,0,0,3,0,1.0
1430,6,1080,1.0,0,0,350,3,0,1.0
1830,7,1430,1.0,0,0,400,3,0,1.5
1580,8,1580,1.0,0,2,0,2,0,2.0
1780,8,1480,2.25,0,0,300,4,0,1.0
1500,7,1060,2.75,0,0,440,4,0,1.0
2550,7,1850,2.25,0,0,700,3,0,1.0
1790,7,1790,2.5,0,0,0,4,0,2.0
3380,10,2800,3.5,0,0,580,3,0,3.0
2100,8,1340,1.75,1,0,760,4,0,1.0
3140,9,3140,2.5,0,0,0,4,0,2.0
680,5,680,0.75,0,0,0,1,0,1.0
2790,10,1970,3.5,0,2,820,5,0,2.0
1960,8,1330,1.5,0,0,630,3,0,2.0
1550,7,1550,1.75,0,0,0,3,0,1.0
1120,6,1120,1.0,0,0,0,3,0,1.0
2105,8,2105,2.5,0,0,0,4,0,2.0
2550,9,2550,2.5,0,0,0,4,0,2.0
1110,7,1110,2.0,0,0,0,3,0,1.0
1470,7,1130,1.5,0,0,340,3,0,1.0
1150,7,1150,1.0,0,0,0,3,0,1.5
1930,8,1930,2.5,0,0,0,4,0,2.0
3120,9,2590,2.5,0,4,530,4,1,2.0
2130,7,1680,2.0,0,0,450,3,0,1.5
1470,7,1470,1.0,0,0,0,3,0,1.0
1780,7,1780,2.5,0,0,0,4,0,2.0
1400,8,1400,1.0,0,0,0,3,0,1.0
1220,7,1220,2.25,0,0,0,3,0,2.0
1310,6,1310,2.0,0,0,0,2,0,2.0
1380,7,1380,1.0,0,0,0,3,0,1.0
1410,7,1410,2.0,0,0,0,3,0,1.0
2440,9,2440,2.5,0,0,0,4,0,2.0
840,6,700,1.75,0,0,140,2,0,1.0
2260,7,1280,2.5,0,0,980,3,0,1.5
1630,7,1120,2.5,0,0,510,3,0,1.0
2080,7,1040,2.0,0,0,1040,4,0,1.0
1380,7,880,1.75,0,0,500,3,0,1.0
1830,7,1230,1.75,0,0,600,3,0,1.0
1460,7,1460,2.0,0,0,0,3,0,2.0
2790,9,2790,2.5,0,0,0,4,0,2.0
2732,8,1870,2.5,0,2,862,5,0,1.0
2620,9,2620,2.5,0,0,0,4,0,2.0
1850,7,1850,2.25,0,0,0,3,0,2.0
1750,7,1750,1.5,1,0,0,3,0,1.0
1613,7,1613,2.5,0,0,0,4,0,2.0
1800,7,900,1.75,0,0,900,3,0,1.0
1260,6,1260,2.0,0,0,0,3,0,1.0
1750,7,1750,2.5,0,0,0,3,0,2.0
3020,9,1980,2.5,1,2,1040,5,0,1.0
1250,6,970,1.0,0,0,280,3,0,1.5
2130,8,2130,1.75,0,0,0,4,0,1.5
1780,7,1780,1.75,0,0,0,3,0,1.0
940,6,940,1.0,0,0,0,2,0,1.0
720,6,720,1.0,0,1,0,2,0,1.0
1790,8,1410,1.75,0,0,380,4,0,1.0
1780,7,1230,2.5,0,0,550,3,0,1.0
1210,5,1210,1.0,0,0,0,2,0,1.0
2430,8,1580,1.75,0,0,850,4,0,1.0
1880,8,1410,1.75,0,0,470,3,0,1.0
1720,7,1720,2.5,0,0,0,5,0,1.5
920,6,820,1.75,0,0,100,3,0,1.0
1260,7,1260,1.0,0,0,0,5,0,1.5
1090,6,980,1.0,0,0,110,1,0,1.0
1780,7,1080,1.5,0,0,700,2,0,1.0
1960,7,1960,1.75,0,0,0,3,0,1.0
2750,7,2750,2.5,0,0,0,4,0,2.0
1330,8,1330,1.75,1,0,0,3,0,1.0
2680,7,2680,2.25,0,0,0,4,0,2.0
2060,7,2060,2.5,0,0,0,4,0,2.0
2100,7,1400,2.5,0,2,700,4,0,2.0
710,6,610,1.0,0,0,100,1,0,1.0
2280,8,2280,2.5,0,0,0,3,0,2.0
930,6,930,1.0,0,0,0,3,0,1.0
1360,7,1060,1.0,0,0,300,3,0,1.0
3500,9,3500,3.25,0,0,0,4,0,2.0
1430,7,1430,1.75,1,0,0,3,0,1.0
1560,7,1560,2.0,0,0,0,3,0,1.0
2280,7,1680,2.25,0,0,600,3,0,1.0
2550,9,2550,2.5,0,0,0,3,0,2.0
1170,5,1170,1.0,0,0,0,3,0,2.0
1730,7,1330,1.5,0,0,400,3,0,1.0
2040,8,1270,2.25,0,0,770,4,0,1.0
840,6,840,1.0,0,0,0,3,0,1.0
2820,8,2170,2.75,0,0,650,4,0,1.5
1580,8,1580,2.5,0,0,0,3,0,2.0
2230,7,1390,1.5,0,0,840,3,0,1.0
1150,6,1150,1.0,0,0,0,3,0,1.0
3010,9,2370,3.5,1,0,640,4,0,2.0
690,7,690,0.0,0,0,0,1,0,1.0
1100,7,1100,1.0,0,0,0,3,0,1.0
1270,6,1270,1.0,0,0,0,2,0,1.5
1740,7,1040,1.75,0,2,700,2,0,1.5
1330,7,1330,2.5,0,0,0,3,0,3.0
2410,9,2410,2.5,0,0,0,4,0,2.0
1870,8,1750,2.25,1,0,120,3,0,2.0
3860,9,2870,3.25,0,1,990,4,0,2.0
1720,8,1320,1.75,0,0,400,3,0,1.0
900,6,900,1.0,0,0,0,2,0,1.0
1370,7,900,1.5,0,0,470,4,0,1.0
1460,7,1040,1.75,0,0,420,3,0,1.0
1410,7,1410,1.75,0,0,0,3,0,1.0
910,6,910,1.0,0,0,0,2,0,1.0
3410,9,3410,2.5,1,0,0,5,0,2.0
2620,8,1770,3.25,1,0,850,3,0,1.0
2380,8,1540,2.5,0,0,840,5,0,1.0
3710,8,2290,3.5,0,0,1420,4,0,2.0
1760,7,1760,2.25,0,0,0,3,0,2.0
2340,8,1610,2.5,0,1,730,4,0,1.0
3160,8,3160,3.75,0,0,0,6,0,2.0
3610,9,2070,2.75,0,4,1540,6,0,1.0
3410,8,3410,3.25,0,0,0,3,0,2.0
2410,7,1210,3.0,0,0,1200,4,0,1.0
1800,7,1800,2.0,1,0,0,4,0,1.5
1600,7,1090,2.25,0,0,510,3,0,1.0
1560,6,780,1.75,0,0,780,3,0,1.0
2170,8,2170,1.75,0,2,0,2,0,1.0
1150,7,1150,2.0,0,0,0,1,0,1.0
2380,7,1820,1.75,0,1,560,4,0,2.0
2010,7,2010,2.5,0,0,0,3,0,2.0
910,7,910,1.0,0,0,0,3,0,1.0
1140,8,1140,2.5,0,0,0,2,0,3.0
1820,7,1820,2.75,0,0,0,3,0,2.0
970,5,570,1.0,0,0,400,1,0,1.0
2460,7,1230,1.75,0,0,1230,6,0,1.0
1290,7,1290,1.75,1,0,0,3,0,1.0
3280,9,3280,2.5,0,0,0,5,0,2.0
1020,7,1020,1.0,0,0,0,2,0,1.0
1160,7,880,3.0,0,0,280,2,0,2.0
2000,7,2000,2.75,0,0,0,4,0,2.0
2280,7,2280,2.75,0,0,0,4,0,1.0
1520,7,1520,1.5,0,0,0,4,0,1.0
1930,8,1180,2.75,0,0,750,4,0,1.0
2000,8,1260,2.75,0,0,740,3,0,1.0
1920,8,1920,2.5,0,0,0,3,0,2.0
1420,7,1420,1.0,0,4,0,3,0,1.0
620,6,620,1.0,0,0,0,2,0,1.0
2163,7,2163,3.0,0,0,0,4,0,2.0
880,6,880,1.0,0,0,0,3,0,1.0
3800,10,3800,2.75,1,3,0,4,0,2.0
2070,7,1390,2.75,1,0,680,4,0,1.0
960,6,960,1.0,0,0,0,3,0,1.0
3530,7,2380,3.5,0,0,1150,5,0,2.0
1720,7,1140,1.75,0,0,580,3,0,1.0
1330,7,1210,1.75,0,0,120,3,0,2.0
3080,9,3080,2.5,0,0,0,3,0,2.0
1370,7,1370,1.0,0,0,0,3,0,1.0
2860,9,2860,2.75,0,0,0,5,0,2.0
2070,8,2070,2.5,0,0,0,4,0,2.0
2860,8,2860,2.5,0,0,0,5,0,2.0
1410,8,1410,2.0,1,0,0,3,0,1.0
1730,7,970,1.75,0,0,760,3,0,1.0
2490,7,2490,3.0,0,0,0,4,0,2.0
1020,7,1020,1.0,0,0,0,3,0,1.0
1740,7,1740,2.5,0,0,0,3,0,2.0
2420,7,2420,2.75,0,0,0,4,0,1.5
1150,6,1150,1.5,0,0,0,4,0,1.5
2790,8,2790,2.5,0,0,0,3,0,2.0
3450,11,3450,2.5,0,0,0,5,0,2.0
7050,13,4320,5.5,1,2,2730,5,0,1.0
1010,7,1010,1.0,0,0,0,3,0,1.0
1300,6,1300,1.5,0,0,0,2,0,1.5
4850,10,4850,4.0,0,0,0,5,0,2.0
2150,8,2150,2.25,0,0,0,4,0,2.0
920,6,920,1.0,0,0,0,2,0,1.0
1260,7,1260,2.25,0,0,0,3,0,3.0
3915,9,3915,3.5,0,0,0,4,0,2.0
1780,7,1230,2.25,0,0,550,3,0,1.0
1320,7,870,1.75,0,0,450,4,0,1.0
1390,7,1390,1.5,0,0,0,3,0,2.0
3050,8,1950,2.5,0,0,1100,3,0,1.5
2460,9,2460,2.5,0,0,0,4,0,2.0
1040,7,1040,1.0,1,0,0,3,0,1.0
1090,7,1090,1.5,0,0,0,2,0,1.5
2170,7,2170,2.5,0,0,0,4,0,2.0
2828,8,2828,2.5,0,0,0,3,0,2.0
1600,8,1180,1.75,0,0,420,3,0,1.0
1840,7,1840,2.0,0,0,0,3,0,2.0
2320,7,2320,2.5,0,0,0,4,0,2.0
2410,7,1550,2.5,0,0,860,2,0,1.0
1770,7,1170,1.75,0,0,600,3,0,1.0
3160,9,3160,2.5,0,0,0,5,0,2.0
2250,7,1330,1.75,0,0,920,4,0,1.0
2810,10,2810,2.25,0,0,0,4,0,2.0
2170,7,2170,2.5,0,0,0,3,0,2.0
2570,8,2570,2.5,0,0,0,4,0,2.0
1790,7,920,1.5,1,0,870,2,0,1.0
1420,7,960,1.75,0,0,460,3,0,2.0
2510,7,1280,2.0,1,0,1230,4,0,1.0
900,6,900,1.0,0,0,0,2,0,1.0
1170,6,1170,1.0,0,0,0,3,0,1.0
2920,9,2920,2.25,0,0,0,4,0,2.0
1400,7,1040,2.25,0,0,360,3,0,1.0
1280,7,1280,1.75,0,0,0,3,0,1.0
1000,7,1000,1.0,0,0,0,3,0,1.0
720,6,720,1.0,0,0,0,2,0,1.0
1540,8,1230,2.75,0,0,310,3,0,2.0
5370,8,5370,4.75,1,0,0,7,0,1.5
1270,7,1270,2.5,0,0,0,2,0,3.0
1970,7,1300,1.75,0,0,670,3,0,1.0
1650,7,860,2.0,0,0,790,4,0,1.0
1460,6,1460,2.0,0,0,0,5,0,1.5
1750,7,1150,1.0,0,0,600,3,0,1.0
1290,7,1290,1.0,0,0,0,3,0,1.5
2740,8,1820,2.75,0,3,920,4,0,1.5
1610,7,1610,2.5,0,0,0,3,0,2.0
3720,9,2720,3.0,0,0,1000,4,0,2.5
1880,7,1080,1.5,0,0,800,4,0,1.0
2490,7,1610,2.75,0,0,880,4,0,1.5
1210,7,1210,2.0,0,0,0,3,0,1.0
1130,9,800,2.0,0,0,330,2,0,2.0
2290,7,1190,1.75,0,0,1100,5,0,1.0
3620,10,2370,3.0,0,4,1250,3,1,2.0
2610,10,2160,3.25,0,0,450,4,0,2.0
1860,7,1460,1.75,0,0,400,4,0,1.0
1540,7,1070,1.75,0,0,470,3,0,1.0
880,6,880,1.0,0,0,0,2,0,1.0
1770,6,1770,2.5,0,0,0,4,0,1.5
2430,8,1630,1.75,0,2,800,3,0,1.0
1780,8,1780,2.0,1,0,0,4,0,1.5
3370,8,1920,3.0,0,0,1450,4,0,1.0
3650,8,3650,2.75,0,0,0,4,0,1.5
1780,7,1060,1.0,0,0,720,3,0,1.0
1930,9,1230,1.75,0,0,700,3,0,1.0
1500,7,1500,3.5,0,0,0,3,0,3.0
1800,7,900,1.75,0,0,900,3,0,1.0
960,7,960,1.5,0,0,0,3,0,1.0
1410,7,940,1.0,0,2,470,2,0,1.0
1090,7,1090,2.5,0,0,0,2,0,2.0
1180,7,1180,2.25,0,0,0,3,0,2.0
2450,10,2450,2.5,0,0,0,3,0,2.0
2750,10,2750,2.5,0,0,0,4,0,2.0
4150,10,4150,2.5,0,0,0,4,0,2.0
2090,8,2090,2.25,0,0,0,4,0,2.0
1120,7,1120,1.0,0,0,0,3,0,1.0
1000,7,800,1.0,0,0,200,2,0,1.0
3490,9,1840,2.5,0,4,1650,5,0,1.0
2090,10,2090,2.5,0,0,0,4,0,2.0
2190,7,2190,1.5,0,0,0,4,0,2.0
1640,7,1120,1.75,0,0,520,4,0,1.0
1460,7,1460,1.5,0,0,0,3,0,1.0
3770,8,3770,4.25,0,0,0,4,0,2.0
2240,9,1440,1.5,0,1,800,3,0,2.0
3440,8,3440,1.75,0,0,0,3,0,1.5
1990,7,1440,3.0,0,0,550,3,0,1.0
2370,8,1660,2.5,0,0,710,4,0,1.0
3080,9,3080,2.5,0,0,0,3,0,2.0
2570,8,1590,2.5,0,0,980,4,0,1.0
720,5,720,1.0,0,0,0,2,0,1.0
2690,9,2690,2.5,0,0,0,3,0,2.0
3390,8,3390,2.5,0,0,0,4,0,2.0
2560,9,2560,2.5,0,0,0,4,0,2.0
1700,7,1080,1.0,0,0,620,4,0,1.0
7350,11,4750,3.5,0,4,2600,5,0,2.0
2420,7,1360,3.0,0,0,1060,5,0,1.0
1310,7,1310,2.0,0,0,0,3,0,1.0
1100,7,1100,1.0,0,0,0,2,0,1.0
2920,9,2920,2.5,0,0,0,4,0,2.0
1600,7,1210,1.75,0,0,390,4,0,1.0
1410,7,810,1.0,0,0,600,4,0,1.0
3150,9,3150,2.5,0,0,0,4,0,2.0
1453,8,1453,2.25,1,0,0,3,0,2.0
3570,11,3570,3.5,0,0,0,4,0,2.0
1580,7,1580,2.25,0,0,0,3,0,1.0
2290,7,1490,1.75,0,0,800,4,0,1.0
2570,8,2570,1.75,0,0,0,3,0,2.0
3970,9,2970,3.25,0,2,1000,5,0,2.0
2330,7,1800,2.75,0,0,530,4,0,1.0
2120,7,2120,3.5,0,0,0,6,0,2.0
1560,7,1560,2.0,0,0,0,3,0,1.5
2050,9,1600,2.5,0,2,450,3,0,1.0
1700,7,1700,2.0,0,0,0,3,0,1.0
2230,8,2230,2.5,0,0,0,3,0,2.0
1480,7,1120,1.75,0,0,360,4,0,1.0
1530,7,1530,2.5,0,0,0,3,0,2.0
2810,9,2810,2.5,1,0,0,3,0,2.0
780,6,780,1.0,0,0,0,2,0,1.0
1170,7,1170,1.75,0,0,0,3,0,1.0
2760,9,2110,3.25,0,2,650,3,0,2.0
5230,11,5230,4.75,0,0,0,4,0,2.5
2100,7,2100,2.0,0,0,0,4,0,1.0
5620,11,4140,3.25,0,0,1480,5,0,2.0
2000,8,2000,2.5,0,0,0,3,0,2.0
910,5,910,1.0,0,0,0,2,0,1.0
1950,7,1200,2.25,0,0,750,3,0,1.0
1900,8,1900,2.5,0,0,0,4,0,2.0
2930,8,2930,2.75,0,2,0,3,0,2.0
2100,8,2100,2.5,0,0,0,3,0,2.0
2350,9,2350,2.25,1,0,0,4,0,2.0
4670,11,3820,3.5,0,3,850,4,0,2.0
2410,8,1410,2.75,0,0,1000,4,0,1.0
1530,8,1240,2.25,0,0,290,3,0,2.0
1140,8,1140,1.5,0,0,0,3,0,3.0
1720,8,1350,1.75,0,0,370,3,0,1.0
840,6,840,1.0,0,0,0,3,0,1.0
2170,7,1670,1.0,0,0,500,5,0,1.5
860,6,860,1.0,0,0,0,2,0,1.0
2423,8,2423,2.5,0,0,0,4,0,2.0
3110,8,3110,3.0,0,0,0,5,0,2.0
2050,8,2050,2.5,0,0,0,4,0,2.0
2520,8,2120,2.75,1,0,400,5,0,1.5
2170,8,2170,2.75,0,0,0,4,0,2.0
1720,7,1140,1.75,0,0,580,3,0,1.0
1170,6,1020,1.75,0,0,150,2,0,1.0
3420,10,3420,2.5,0,0,0,4,0,2.0
1620,8,1470,2.5,0,4,150,3,0,3.0
4530,9,3200,3.0,0,0,1330,5,0,1.5
1610,6,1610,2.0,0,0,0,2,0,2.0
2990,9,2990,2.5,0,0,0,4,0,2.0
1654,7,1654,2.25,0,0,0,3,0,2.0
1920,7,1070,1.75,0,0,850,3,0,1.0
1360,6,1360,1.0,0,0,0,3,0,1.0
930,5,930,1.0,0,0,0,2,0,1.0
2900,7,1450,2.5,0,0,1450,5,0,1.0
2580,7,1880,2.5,0,0,700,7,0,1.0
1490,7,1490,1.75,0,0,0,4,0,1.0
3080,10,3080,2.5,0,0,0,3,0,2.0
1240,7,1240,1.75,1,0,0,3,0,1.0
2230,7,2230,2.5,0,0,0,4,0,2.0
840,5,840,1.0,0,0,0,2,0,1.0
2520,8,1550,3.25,0,0,970,4,0,1.5
1910,7,1910,2.5,0,0,0,3,0,2.0
2450,8,2450,2.5,0,0,0,5,0,2.0
1270,7,1270,1.75,0,0,0,2,0,1.0
2010,7,2010,2.5,0,0,0,3,0,1.0
1250,6,1250,1.0,0,0,0,3,0,1.0
1760,7,1760,2.25,0,0,0,3,0,2.0
1010,6,1010,1.0,0,0,0,3,0,1.0
1760,7,880,2.0,0,0,880,2,0,1.0
2100,8,2100,2.25,0,0,0,4,0,3.0
1700,8,1700,1.75,0,0,0,3,0,1.0
2410,10,2290,2.75,1,2,120,5,0,2.0
1490,7,1490,2.25,0,0,0,3,0,2.0
2260,9,2260,2.0,0,0,0,4,0,2.0
2350,8,1690,2.5,0,0,660,4,0,1.5
1210,7,910,1.75,0,0,300,2,0,1.0
880,6,880,1.0,0,0,0,2,0,1.0
1210,7,1210,2.0,0,0,0,3,0,1.0
2370,8,2370,2.5,0,0,0,3,0,2.0
1050,7,1050,1.0,0,0,0,3,0,1.0
1460,7,1040,1.75,0,0,420,3,0,1.0
1980,7,1090,1.0,0,0,890,2,0,1.0
2060,8,2060,2.5,1,0,0,3,0,2.0
2980,9,2530,2.25,1,0,450,3,0,1.0
2510,9,2510,2.5,0,0,0,4,0,2.0
1820,8,1820,2.5,0,0,0,3,0,2.0
900,6,900,1.0,0,0,0,2,0,1.0
3130,9,3130,3.0,1,0,0,4,0,2.0
2290,8,2290,2.5,1,0,0,3,0,2.0
1670,7,1140,1.75,0,0,530,3,0,1.0
1380,7,930,1.75,0,0,450,3,0,1.0
2210,9,2210,2.75,0,0,0,4,0,2.0
2800,7,2800,1.75,0,0,0,4,0,2.0
3010,10,3010,2.5,0,0,0,3,0,2.0
1530,7,1530,2.5,1,0,0,3,0,2.0
1460,7,1460,1.75,0,0,0,3,0,1.0
1310,7,1310,2.0,0,0,0,3,0,1.0
2750,9,2750,2.5,0,0,0,3,0,2.0
2950,9,2350,3.5,0,3,600,5,0,2.0
2300,7,1190,2.5,0,0,1110,4,0,1.0
3380,8,3380,2.5,0,0,0,3,0,2.0
1580,6,1220,1.75,0,0,360,3,0,1.0
3770,9,3770,3.5,0,0,0,4,0,2.0
2400,7,2400,2.5,0,0,0,5,0,2.0
2130,7,2130,1.5,1,0,0,2,0,1.0
4290,11,2690,3.25,1,3,1600,4,0,1.0
2830,8,2830,3.0,0,0,0,4,0,2.0
2050,9,2050,2.0,0,0,0,4,0,1.5
2840,9,2840,2.75,1,0,0,4,0,2.0
6980,12,5330,4.25,1,4,1650,6,0,3.0
2480,8,2480,2.5,0,0,0,3,0,2.0
2760,8,2760,2.5,0,0,0,5,0,2.0
2610,10,2610,2.5,1,0,0,3,0,2.0
2000,8,2000,2.5,0,0,0,4,0,2.0
1430,7,1070,1.75,0,0,360,3,0,1.0
1680,6,940,2.0,0,0,740,3,0,1.0
2290,8,2290,2.25,0,0,0,5,0,2.0
1700,7,1700,2.0,0,0,0,3,0,1.0
1050,6,1050,1.0,0,0,0,2,0,1.0
5940,11,4950,3.0,0,4,990,4,0,2.0
1481,7,1481,2.25,0,0,0,3,0,2.0
1130,8,1030,2.25,0,0,100,3,0,2.0
2070,7,2070,1.75,0,3,0,3,0,1.0
1400,7,1150,2.0,0,0,250,3,0,1.0
1220,6,1090,2.0,0,0,130,5,0,1.0
1660,7,1210,1.5,0,0,450,3,0,1.0
1940,8,1140,2.5,0,0,800,4,0,1.0
1260,8,1260,2.5,0,0,0,3,0,3.0
2270,9,1310,2.5,1,0,960,4,0,1.0
5635,10,4360,4.0,0,3,1275,4,0,2.0
1540,7,1540,1.5,0,0,0,3,0,1.0
1390,7,1390,1.0,0,0,0,3,0,1.0
2810,9,2810,2.5,0,0,0,3,0,2.0
2280,8,1490,2.5,0,0,790,3,0,1.0
1200,7,1200,2.0,0,0,0,4,0,1.0
1300,7,1300,1.75,0,0,0,3,0,1.0
2500,9,2500,2.5,0,0,0,4,0,2.0
1500,8,1500,2.5,0,0,0,3,0,2.0
2020,8,1120,1.75,0,0,900,5,0,1.0
1150,5,1150,1.0,0,0,0,3,0,1.5
2000,8,2000,2.5,0,0,0,4,0,2.0
1630,7,1310,2.25,0,0,320,3,0,1.0
1340,6,1170,2.25,0,0,170,3,0,1.5
2600,8,1300,3.0,0,0,1300,5,0,1.0
3060,10,2300,3.25,0,0,760,4,0,2.0
1730,7,1730,2.5,0,0,0,3,0,2.0
3010,9,3010,2.5,0,0,0,4,0,2.0
1590,8,1280,1.0,0,1,310,3,0,1.0
2930,9,2930,3.75,1,3,0,6,0,2.0
1600,7,1600,2.5,0,0,0,3,0,2.0
2290,8,2290,2.5,0,0,0,4,0,2.0
1790,7,1190,2.0,0,0,600,3,0,1.0
780,5,780,0.75,0,0,0,1,0,1.0
1300,7,1300,2.0,0,0,0,3,0,1.0
1230,7,1230,1.5,0,0,0,3,0,1.0
880,6,880,1.0,0,0,0,2,0,1.0
1470,7,1070,1.5,0,0,400,3,0,1.0
2870,8,2870,1.75,0,1,0,3,0,1.5
2220,8,2220,2.25,0,0,0,4,0,2.0
1060,6,1060,1.0,0,0,0,2,0,1.0
2970,9,2970,2.5,1,0,0,3,0,2.0
1230,8,1010,1.75,0,0,220,3,0,2.0
3950,10,3430,3.25,1,2,520,5,0,2.0
1160,7,1160,1.0,0,0,0,3,0,1.0
1540,7,1090,1.0,0,0,450,4,0,1.5
2620,8,2620,2.5,0,0,0,4,0,2.0
1910,7,1060,2.0,0,0,850,4,0,1.0
1940,7,1940,1.75,1,0,0,3,0,1.0
1767,8,1767,2.5,0,0,0,4,0,2.0
1556,7,1556,1.5,0,0,0,2,0,1.0
2970,9,2340,3.5,1,0,630,4,0,2.0
1430,7,1430,1.0,0,0,0,3,0,1.0
1440,7,850,2.0,0,0,590,3,0,1.0
1650,7,1650,2.5,0,0,0,3,0,2.0
1160,7,1040,1.75,0,0,120,3,0,1.0
5290,11,4540,3.25,0,0,750,3,0,2.0
4550,10,2600,5.0,0,4,1950,4,1,1.0
1000,7,860,1.0,0,0,140,3,0,1.0
2440,7,1520,2.5,0,0,920,3,0,1.0
2090,8,1530,2.0,1,0,560,3,0,1.5
910,6,910,1.0,0,0,0,2,0,1.0
1384,8,1144,3.0,0,0,240,3,0,2.0
1340,7,1340,2.5,0,0,0,3,0,2.0
1560,7,1250,1.75,0,0,310,3,0,1.0
3135,9,3135,2.5,0,0,0,4,0,2.0
3850,11,3180,3.25,0,3,670,4,0,2.0
1640,8,1540,2.25,0,0,100,3,0,1.5
1180,7,1180,1.0,0,0,0,3,0,1.0
2070,7,1720,2.25,0,0,350,4,0,1.0
650,5,650,1.0,0,0,0,1,0,1.0
1470,8,1470,1.5,0,0,0,3,0,1.0
2910,9,2910,2.5,0,2,0,4,0,2.0
1890,7,1890,2.5,0,0,0,4,0,2.0
1580,6,1580,1.0,0,0,0,3,0,1.5
1340,7,1190,2.75,0,0,150,5,0,1.0
1920,8,1920,2.25,1,0,0,3,0,1.0
1930,7,1030,2.0,0,0,900,4,0,1.0
860,6,860,1.0,0,0,0,2,0,1.0
2700,7,2120,1.5,0,0,580,3,0,2.0
2030,8,1730,2.5,0,0,300,4,0,1.5
860,6,860,1.0,0,0,0,3,0,1.0
3150,9,3150,2.5,1,0,0,4,0,2.0
960,7,960,1.5,0,0,0,2,0,1.0
1420,7,860,0.75,0,0,560,3,0,1.0
1740,7,1740,2.5,0,0,0,3,0,2.0
2015,9,2015,2.75,0,4,0,3,1,2.0
1430,7,980,1.0,0,0,450,3,0,1.0
1010,7,1010,1.0,0,0,0,3,0,1.0
1750,7,1230,2.5,0,0,520,3,0,2.5
1940,8,1630,2.25,0,0,310,3,0,1.0
2660,8,1880,2.5,0,0,780,4,0,1.0
2720,9,2720,2.5,0,0,0,4,0,2.0
1010,7,1010,1.0,0,0,0,3,0,1.0
960,6,960,1.0,0,0,0,3,0,1.0
1420,7,1050,2.0,0,0,370,3,0,2.0
1995,8,1760,2.5,0,0,235,3,0,3.0
2153,8,2153,2.5,0,0,0,3,0,2.0
1800,6,900,1.0,0,0,900,2,0,1.0
1160,7,1160,2.5,0,0,0,2,0,2.0
2000,7,1000,2.75,0,0,1000,3,0,1.0
3040,8,2350,3.25,0,0,690,4,0,2.0
1580,7,1010,1.0,0,0,570,3,0,1.0
1440,7,1440,1.5,0,0,0,3,0,1.0
2730,9,2730,2.75,0,1,0,4,0,2.0
1380,8,1380,1.0,0,0,0,3,0,2.0
2034,7,1159,1.0,0,4,875,2,1,1.0
1960,7,1960,2.5,0,0,0,3,0,2.0
2440,7,2440,2.25,0,0,0,4,0,1.5
2830,10,2830,2.5,0,4,0,3,1,3.0
1030,5,1030,0.75,0,0,0,3,0,1.0
1740,8,1740,1.5,1,0,0,3,0,1.0
1810,7,1810,1.75,0,0,0,3,0,1.5
2290,7,1290,2.25,0,0,1000,5,0,1.0
730,7,730,1.0,0,0,0,1,0,1.0
3420,9,3420,2.5,0,0,0,4,0,2.0
660,5,660,1.0,0,0,0,3,0,1.0
2570,9,2570,2.5,1,0,0,4,0,2.0
1390,7,1390,2.0,0,0,0,3,0,1.0
1590,7,1590,2.0,0,0,0,3,0,1.0
2220,7,2220,2.75,0,0,0,3,0,2.0
1020,6,1020,1.0,0,0,0,2,0,1.5
1720,7,1120,2.25,0,0,600,4,0,1.0
2450,8,1340,1.75,0,0,1110,3,0,1.0
2910,8,2910,2.5,0,0,0,4,0,2.0
730,7,730,1.0,0,0,0,1,0,1.0
3920,11,3920,3.0,1,4,0,3,1,2.0
1550,7,1550,1.5,0,0,0,3,0,2.0
3070,8,2100,2.5,0,0,970,4,0,1.0
3250,10,3250,2.5,0,0,0,4,0,2.0
1580,7,1220,2.25,0,0,360,3,0,1.0
2060,6,2060,1.5,0,0,0,3,0,1.5
2240,7,2240,1.5,1,0,0,3,0,1.0
2300,7,1340,2.25,0,0,960,4,0,1.5
1210,6,1210,1.0,0,0,0,3,0,1.0
1310,8,1120,1.5,0,0,190,2,0,2.0
1050,7,1050,1.0,0,0,0,3,0,1.5
1000,6,1000,1.0,0,0,0,2,0,1.0
1190,6,1190,1.0,0,0,0,3,0,1.0
2360,8,2180,2.0,0,0,180,3,0,1.0
1840,6,1130,1.0,0,0,710,2,0,1.5
1830,8,1830,2.5,0,0,0,3,0,2.0
2550,8,1750,2.5,0,0,800,4,0,1.0
2980,8,2980,3.0,0,2,0,6,0,1.5
1840,8,1840,2.5,0,0,0,4,0,2.0
3180,7,3180,2.5,0,0,0,4,0,2.0
4600,10,3180,3.5,1,0,1420,5,0,2.0
2500,8,1500,1.75,1,0,1000,4,0,1.0
2470,8,2470,2.5,0,0,0,4,0,2.0
1060,7,1000,2.0,0,0,60,2,0,1.0
3920,9,3920,3.25,0,0,0,5,0,2.0
1380,7,1380,2.0,0,0,0,3,0,2.0
3370,9,3370,3.5,0,3,0,4,0,2.0
1360,7,1120,1.5,0,0,240,3,0,2.0
1760,7,1050,1.0,0,0,710,3,0,1.0
1140,6,980,1.0,0,1,160,2,0,1.0
1420,8,1420,2.0,0,0,0,3,0,1.5
2430,7,2430,2.5,0,0,0,3,0,2.0
1390,8,1390,1.75,0,0,0,2,0,1.0
1330,6,1330,1.0,0,0,0,3,0,1.0
1960,7,1090,1.75,0,0,870,3,0,1.0
980,7,980,1.0,0,0,0,3,0,1.0
1230,8,990,1.75,0,0,240,2,0,1.0
1980,7,1260,2.25,0,0,720,5,0,1.0
2820,8,2230,3.25,0,0,590,5,0,2.0
1150,7,1150,1.0,0,0,0,3,0,1.5
2610,8,2610,2.5,0,0,0,4,0,2.0
990,7,990,1.0,0,0,0,2,0,1.0
3780,10,3780,2.75,0,0,0,4,0,2.0
3710,9,3710,2.5,0,0,0,4,0,2.0
1200,8,1200,1.5,0,0,0,2,0,3.0
2050,7,2050,2.5,0,0,0,4,0,2.0
2110,9,2110,2.5,1,0,0,3,0,1.0
1280,7,1280,1.0,0,0,0,2,0,1.0
1370,7,1020,2.0,0,0,350,2,0,1.0
2910,7,1510,2.75,0,0,1400,5,0,1.0
1350,8,1350,2.0,0,0,0,2,0,1.0
2550,8,2550,2.75,0,0,0,3,0,2.0
2220,8,1620,2.25,0,0,600,3,0,2.0
2970,9,2040,3.25,0,3,930,3,0,2.0
1920,7,960,1.75,0,0,960,4,0,1.0
2680,9,2680,2.5,0,0,0,2,0,1.0
3280,7,3280,2.5,0,0,0,4,0,2.0
1110,8,1110,1.5,0,0,0,2,0,3.0
2240,7,1250,2.5,0,2,990,4,0,1.0
1010,7,1010,1.0,0,0,0,3,0,1.5
2270,7,1290,2.25,0,0,980,4,0,1.0
3760,8,2740,3.25,0,0,1020,4,0,2.0
2620,8,2620,2.5,1,0,0,4,0,2.0
2570,7,2570,2.0,0,0,0,3,0,1.0
2770,9,2770,2.0,0,0,0,3,0,2.0
3420,10,3420,2.5,0,0,0,4,0,2.0
1530,7,1530,2.5,0,0,0,3,0,2.0
3470,9,3470,3.5,0,0,0,7,0,2.0
1530,7,1070,1.75,0,0,460,3,0,1.0
1540,6,1540,2.0,0,0,0,3,0,1.0
2630,7,1690,2.75,0,0,940,4,0,1.0
820,6,820,1.0,0,0,0,3,0,1.5
620,5,620,1.0,0,0,0,1,0,1.0
2230,7,2230,2.5,0,0,0,3,0,2.0
940,6,940,1.0,0,0,0,3,0,1.0
1450,6,1050,1.0,0,0,400,3,0,1.0
2300,6,1150,2.0,0,0,1150,4,0,1.0
1860,7,1260,1.75,0,0,600,3,0,1.0
1680,7,1680,1.5,1,0,0,3,0,1.0
1240,7,1240,1.75,0,0,0,3,0,1.0
1550,7,1550,1.75,0,0,0,3,0,2.0
2800,9,2800,3.5,0,0,0,3,0,1.0
4400,11,4400,3.25,0,0,0,4,0,2.0
2340,8,2340,1.75,0,0,0,3,0,1.0
2110,7,2110,2.5,0,0,0,4,0,2.0
790,6,790,1.0,0,0,0,2,0,1.0
1530,7,1530,1.75,0,0,0,3,0,1.0
1050,7,1050,1.0,0,0,0,3,0,1.0
1440,7,1000,1.0,0,0,440,3,0,1.0
2390,8,1390,2.75,0,0,1000,3,0,1.0
2280,9,960,2.5,0,0,1320,3,0,1.0
1240,6,1240,1.0,0,0,0,3,0,1.0
2500,9,1490,2.75,0,2,1010,4,0,1.0
2060,7,1280,2.75,0,0,780,4,0,1.0
2110,7,2110,2.5,0,0,0,4,0,2.0
1320,7,990,1.0,0,0,330,3,0,1.0
2490,8,2090,2.0,0,2,400,4,0,1.5
960,7,960,1.5,0,0,0,2,0,2.0
1740,8,1180,2.25,0,0,560,3,0,1.0
2010,8,2010,3.0,0,0,0,4,0,2.0
4260,11,3280,4.0,1,0,980,4,0,2.0
1690,7,1690,2.5,0,0,0,3,0,2.0
1370,5,1370,1.0,0,2,0,4,0,1.5
2320,7,2320,2.5,0,0,0,4,0,2.0
940,6,940,1.0,1,0,0,3,0,1.0
760,6,760,1.0,0,0,0,2,0,1.0
2430,7,2430,1.75,0,0,0,4,0,1.5
3690,10,3690,2.5,0,2,0,4,0,2.0
2830,9,2170,2.5,0,0,660,4,0,2.0
1720,7,1120,2.5,0,0,600,4,0,1.0
2790,8,2790,2.5,0,0,0,4,0,2.0
1680,7,1680,2.5,0,0,0,3,0,2.0
1830,7,1200,1.75,0,1,630,3,0,1.0
1640,6,1640,1.0,0,0,0,4,0,1.5
3500,10,2570,3.5,1,0,930,5,0,2.0
940,6,940,1.0,0,0,0,2,0,1.0
7400,13,6290,5.5,1,3,1110,5,0,2.0
1780,8,1310,2.25,0,0,470,4,0,1.0
2740,8,2740,2.5,0,0,0,4,0,2.0
2770,8,2770,2.25,0,0,0,3,0,2.0
1770,8,1770,2.5,0,0,0,2,0,3.0
1310,7,1310,1.75,0,0,0,4,0,1.0
3470,8,1750,2.75,0,0,1720,4,0,1.0
1470,7,1470,1.75,0,0,0,3,0,1.0
3820,9,3820,2.5,0,0,0,3,0,2.0
1930,7,1930,1.75,1,0,0,3,0,1.0
2010,7,1510,1.75,0,0,500,3,0,1.5
1980,8,1180,1.75,0,0,800,3,0,1.0
1100,7,1100,1.0,0,0,0,2,0,1.0
2230,7,1510,2.0,0,0,720,4,0,1.5
2540,8,2340,1.5,0,3,200,5,0,2.0
1920,8,1920,2.25,0,0,0,3,0,2.0
1890,8,1890,2.5,0,0,0,4,0,2.0
4120,11,3070,3.5,1,0,1050,4,0,2.0
1970,8,1970,2.0,0,3,0,3,0,2.0
1130,7,1130,1.0,0,0,0,2,0,1.0
4010,9,2560,3.5,0,3,1450,5,0,2.0
1600,7,1600,1.75,0,0,0,3,0,1.0
1790,8,1790,1.5,0,0,0,4,0,1.5
2340,7,1170,1.75,0,0,1170,4,0,1.0
2590,8,2590,2.25,0,0,0,4,0,2.0
2470,7,1270,2.25,0,0,1200,4,0,1.0
910,7,910,1.0,0,0,0,3,0,1.0
2790,8,2790,2.5,0,0,0,4,0,2.0
2950,10,2950,2.5,0,0,0,4,0,2.0
4910,11,3110,3.5,0,0,1800,4,0,1.5
2060,8,1330,2.0,0,0,730,3,0,1.5
1400,7,1400,1.0,0,0,0,3,0,1.5
1830,8,1830,3.25,0,0,0,3,0,3.0
2740,9,2740,2.5,0,0,0,3,0,2.0
1992,6,1288,2.75,0,4,704,2,1,1.5
2800,9,2800,2.25,0,4,0,5,1,2.0
4910,10,2560,2.75,1,0,2350,4,0,1.0
1540,6,770,1.0,0,0,770,4,0,1.0
1510,6,950,1.75,0,0,560,3,0,1.0
1660,7,1350,1.0,0,0,310,3,0,1.5
1460,7,1460,2.0,0,0,0,3,0,1.5
1620,7,940,1.75,0,0,680,3,0,1.0
1430,8,1430,2.25,0,0,0,3,0,3.0
1740,8,1740,2.5,0,0,0,3,0,2.0
4410,9,2330,3.25,0,0,2080,5,0,2.0
3130,9,2430,3.5,0,0,700,4,0,2.0
780,6,780,1.0,0,0,0,2,0,1.0
3520,8,2100,3.0,0,0,1420,5,0,2.0
2380,8,2380,1.75,0,0,0,3,0,1.5
1010,7,670,1.75,0,0,340,2,0,1.0
1730,8,1730,1.5,0,0,0,3,0,2.0
1900,9,1450,1.5,0,0,450,1,0,1.5
1400,7,1150,1.5,0,0,250,2,0,1.0
1170,7,1170,1.75,0,0,0,3,0,1.0
2100,8,2100,2.5,0,0,0,3,0,2.0
1920,7,1060,1.75,0,0,860,4,0,1.0
1590,8,1590,2.0,0,0,0,3,0,2.0
2150,8,1140,1.75,0,4,1010,3,0,1.0
3190,11,3190,2.5,0,0,0,4,0,2.0
2020,9,1620,2.75,0,0,400,4,0,1.0
960,6,960,1.0,0,0,0,3,0,1.5
3930,9,3930,3.5,0,0,0,4,0,2.0
1290,7,1290,1.0,0,0,0,2,0,1.0
3470,11,2500,3.5,0,0,970,4,0,2.0
1060,6,760,1.0,0,0,300,3,0,1.0
1640,7,1640,2.25,0,0,0,3,0,2.0
1580,8,1580,1.75,0,0,0,3,0,1.0
2710,8,1910,3.0,0,2,800,5,0,1.0
940,6,940,1.0,0,0,0,3,0,1.0
1300,7,1300,1.75,0,0,0,3,0,1.0
1310,7,960,1.0,0,0,350,3,0,1.0
2060,8,2060,2.5,0,0,0,3,0,2.0
1830,8,1400,2.25,0,0,430,3,0,1.0
1920,7,1920,1.5,0,1,0,4,0,2.0
1670,7,1670,2.75,0,0,0,3,0,1.5
2950,7,1700,2.25,0,0,1250,6,0,1.0
1460,7,730,1.75,0,2,730,3,0,1.0
1650,7,860,1.5,0,0,790,2,0,1.0
1910,8,1910,2.5,0,0,0,3,0,2.0
1550,7,1550,1.75,0,0,0,3,0,1.5
1830,8,1430,1.75,0,1,400,3,0,1.0
1445,7,1300,2.25,0,0,145,3,0,2.0
3831,9,3831,2.75,1,4,0,5,1,2.0
3500,10,2360,3.0,1,0,1140,4,0,2.0
1400,8,1400,3.25,0,0,0,2,0,3.0
1280,7,1280,1.5,0,0,0,2,0,1.0
1620,7,1620,1.75,0,0,0,3,0,2.0
4230,10,4230,2.75,0,0,0,4,0,2.0
1890,8,1890,2.25,0,0,0,3,0,1.0
790,7,790,1.0,0,0,0,2,0,1.0
1810,7,1010,2.0,0,0,800,3,0,1.0
850,6,850,1.0,0,0,0,3,0,1.0
1770,8,1210,2.75,0,0,560,2,0,1.0
1510,7,980,1.75,0,0,530,3,0,1.0
1983,9,1983,2.5,0,0,0,4,0,2.0
1800,8,1800,1.75,0,0,0,3,0,2.0
2580,8,2580,3.0,0,0,0,4,0,2.0
1010,6,1010,1.0,0,0,0,3,0,1.0
910,6,910,1.0,0,0,0,3,0,1.0
2140,8,2140,2.5,0,0,0,4,0,2.0
1480,7,740,2.0,0,2,740,3,0,1.0
1310,6,850,1.0,0,0,460,2,0,1.0
1000,6,1000,1.0,0,0,0,3,0,1.0
1950,6,1950,1.5,0,0,0,4,0,1.5
1170,6,1170,1.0,0,0,0,4,0,1.0
780,6,780,1.0,0,0,0,2,0,1.0
2140,7,1330,2.5,0,0,810,5,0,1.0
3140,10,3140,2.75,0,1,0,4,0,2.0
1240,6,960,1.0,0,0,280,2,0,1.0
2280,8,1880,2.5,0,0,400,3,0,2.0
1710,8,1710,1.5,0,0,0,3,0,2.0
960,6,960,1.0,0,0,0,2,0,1.0
2250,9,2250,2.5,0,0,0,3,0,2.0
1720,7,1720,2.75,0,0,0,3,0,1.0
2160,7,2160,2.5,0,0,0,5,0,2.0
2620,8,1870,3.0,1,0,750,4,0,1.0
3600,9,3600,2.5,0,0,0,4,0,2.0
2740,7,2740,2.5,0,0,0,3,0,2.0
1320,7,1320,2.5,0,0,0,3,0,2.0
900,6,900,1.0,0,0,0,2,0,1.0
2100,7,1050,2.0,0,0,1050,4,0,1.0
2800,9,2800,3.0,0,0,0,4,0,2.0
810,5,810,1.0,0,0,0,2,0,1.0
1090,7,1090,1.5,0,0,0,2,0,2.0
1470,7,1470,1.75,0,0,0,3,0,1.0
1130,8,1130,2.25,0,0,0,3,0,1.5
3500,8,2430,2.75,0,0,1070,6,0,2.0
580,5,580,0.5,0,0,0,2,0,1.0
1190,8,1190,2.25,0,0,0,3,0,3.0
2950,8,1520,2.25,0,2,1430,3,0,1.0
1860,7,1860,2.25,0,0,0,3,0,2.0
2370,7,2370,2.25,1,0,0,3,0,2.0
3550,8,3550,2.5,0,0,0,6,0,2.0
2250,7,1310,2.5,0,0,940,5,0,1.0
1400,8,1400,2.25,0,0,0,3,0,2.0
3600,9,1940,2.75,1,2,1660,6,0,1.0
1800,8,1800,2.5,0,0,0,3,0,2.0
690,6,690,1.0,0,0,0,2,0,1.0
4430,10,2680,2.75,0,3,1750,6,0,2.0
1760,7,1760,1.75,0,0,0,3,0,1.0
1880,8,1880,2.5,0,0,0,4,0,2.0
1680,8,1680,1.75,0,0,0,3,0,1.5
3180,10,2390,2.5,0,0,790,4,0,1.0
1680,8,1240,1.75,0,0,440,3,0,1.0
2980,9,2980,2.75,0,0,0,5,0,2.0
1420,7,1420,2.5,0,0,0,3,0,3.0
3500,8,3500,3.75,0,0,0,5,0,1.5
3320,9,2650,2.5,1,0,670,4,0,2.0
1120,7,1120,1.0,0,0,0,3,0,1.0
1370,7,1370,1.0,0,0,0,3,0,1.0
4225,11,4225,4.5,0,0,0,4,0,2.0
1060,7,1060,1.0,0,0,0,3,0,1.0
1690,7,1360,2.0,0,0,330,3,0,1.0
1520,7,1120,1.0,0,0,400,3,0,1.0
3290,10,3290,2.25,1,0,0,4,0,1.5
2260,7,1280,2.5,0,0,980,3,0,1.5
1310,7,1310,1.0,0,0,0,4,0,1.5
2190,8,2190,1.75,0,0,0,4,0,1.0
2600,8,1300,2.5,0,0,1300,2,0,1.0
3190,10,2160,3.5,0,3,1030,4,0,2.0
1310,7,1310,1.0,0,0,0,3,0,1.0
1680,7,1680,2.0,0,0,0,2,0,2.0
1340,7,1340,1.0,0,0,0,2,0,1.0
2540,8,2540,2.25,0,0,0,3,0,2.0
2340,8,2340,2.5,0,0,0,4,0,2.0
1260,6,690,1.0,0,0,570,2,0,1.0
1280,8,1060,2.5,0,0,220,2,0,2.0
3250,10,2260,2.25,0,0,990,3,0,1.0
2320,8,2040,1.75,0,3,280,3,0,2.0
2630,8,2630,2.25,0,2,0,3,0,2.5
1340,7,1340,2.0,0,0,0,3,0,2.0
3730,11,3730,3.25,0,2,0,4,0,3.0
1550,7,1550,1.75,0,0,0,3,0,1.5
2270,7,1380,2.25,0,0,890,3,0,1.0
1230,6,1230,1.0,0,0,0,3,0,1.5
2160,7,1080,2.75,0,3,1080,4,0,1.0
1560,8,1560,1.75,0,0,0,2,0,1.0
3720,9,2090,3.0,0,4,1630,5,0,2.0
1010,6,810,1.0,0,2,200,2,0,1.0
2140,7,1240,1.75,0,0,900,3,0,1.0
2060,8,2060,2.5,1,0,0,3,0,2.0
1710,7,1510,1.75,0,0,200,2,0,1.0
1940,7,1080,1.0,0,0,860,4,0,1.0
2310,9,2310,2.5,1,0,0,3,0,2.0
1870,8,1870,2.5,0,0,0,3,0,2.0
2560,9,2560,2.5,1,0,0,3,0,2.0
2920,7,1540,3.0,0,2,1380,3,0,1.5
1230,6,1230,1.0,0,0,0,1,0,1.5
2300,7,1840,2.5,0,0,460,4,0,1.0
1010,6,1010,1.0,0,0,0,3,0,1.0
1320,7,1320,1.0,0,0,0,3,0,1.0
2014,7,2014,2.5,0,0,0,3,0,2.0
1580,7,1130,1.75,0,0,450,4,0,1.0
2560,8,2560,2.5,0,0,0,4,0,2.0
2580,7,1880,3.0,0,0,700,6,0,1.5
1080,5,1080,1.0,0,0,0,3,0,1.0
3240,10,3240,2.75,0,0,0,5,0,2.0
1860,7,1860,1.0,1,0,0,4,0,1.5
1920,7,1920,1.75,0,0,0,4,0,2.0
2760,9,1840,3.0,0,1,920,4,0,2.0
1140,6,990,1.0,0,0,150,3,0,1.0
1840,7,940,1.75,0,0,900,3,0,1.0
2140,7,1840,2.0,0,0,300,4,0,2.0
2420,8,1750,2.25,0,0,670,3,0,1.0
1820,7,1820,2.5,0,0,0,4,0,2.0
1340,7,1060,1.75,0,0,280,2,0,2.0
1910,7,1210,2.5,0,0,700,4,0,1.0
2490,9,2490,2.5,0,0,0,3,0,2.0
940,7,940,1.0,0,0,0,2,0,1.0
910,7,910,1.0,0,0,0,2,0,1.0
1720,9,1720,2.5,0,0,0,3,0,2.0
2770,9,2770,2.5,0,0,0,4,0,2.0
1620,7,1620,1.0,0,0,0,4,0,1.5
700,6,700,1.0,1,0,0,2,0,1.0
1120,7,1120,1.0,0,0,0,1,0,1.5
1050,8,950,2.5,0,0,100,2,0,2.0
1830,7,1830,1.75,0,0,0,3,0,1.0
2450,7,1770,2.25,0,0,680,3,0,1.0
1200,6,1200,1.0,0,0,0,3,0,1.0
3010,10,1940,4.25,0,3,1070,4,0,2.0
1960,7,1960,2.5,0,0,0,4,0,2.0
2150,8,2150,2.5,0,0,0,3,0,2.0
1410,7,1410,2.0,0,0,0,3,0,2.0
2990,9,2990,2.5,0,0,0,4,0,2.0
2530,8,2530,2.5,0,0,0,3,0,2.0
940,5,940,1.0,0,0,0,2,0,1.0
2260,8,1520,1.75,0,0,740,3,0,1.0
2420,7,2420,2.5,0,0,0,3,0,2.0
1430,7,1430,1.75,0,0,0,3,0,1.0
1510,7,1040,2.5,0,0,470,3,0,1.0
2650,8,2650,2.5,0,0,0,4,0,2.0
1760,7,920,1.75,0,0,840,3,0,1.0
1110,7,1110,1.5,0,0,0,3,0,1.0
3330,9,2610,3.5,1,0,720,5,0,2.0
1150,7,1150,1.0,0,0,0,3,0,1.0
900,6,900,1.0,0,0,0,2,0,1.0
1850,7,1850,2.5,0,0,0,3,0,2.0
2090,8,1490,2.0,0,0,600,3,0,1.5
1540,8,1540,2.0,0,0,0,3,0,2.0
1760,7,1760,2.5,0,0,0,3,0,1.5
1680,8,1680,2.5,0,0,0,3,0,2.0
2650,8,2650,2.5,0,0,0,4,0,2.0
1990,8,1420,2.25,0,2,570,4,0,1.5
1690,8,1690,2.5,0,0,0,3,0,2.0
4140,8,4140,3.5,0,0,0,5,0,2.0
1720,8,1350,2.25,0,0,370,4,0,1.0
1420,7,1420,1.0,0,0,0,3,0,1.0
1630,7,1630,1.75,0,0,0,3,0,1.0
1850,6,1110,1.5,0,0,740,4,0,1.5
930,7,930,1.0,0,3,0,2,0,1.0
2090,8,1890,1.0,0,2,200,3,0,1.5
1680,9,1120,2.5,0,0,560,3,0,2.0
2480,8,2480,2.5,0,0,0,4,0,2.0
770,7,770,1.0,0,0,0,2,0,1.0
3370,9,1970,2.75,0,3,1400,4,0,1.0
2240,7,1540,2.75,0,0,700,4,0,2.0
1260,7,1260,1.75,0,0,0,3,0,1.0
1120,6,1120,1.0,0,0,0,2,0,1.0
1480,7,1480,1.75,0,0,0,3,0,1.0
1360,6,1360,1.0,0,0,0,3,0,1.0
2470,9,2470,2.5,0,0,0,3,0,2.0
1270,8,1270,1.5,0,0,0,3,0,3.0
1580,7,1080,1.5,0,0,500,3,0,1.0
2660,7,2660,2.25,0,0,0,6,0,2.0
1320,8,990,2.5,0,0,330,2,0,2.0
2190,7,2190,1.75,0,0,0,5,0,1.0
2910,8,2910,2.5,0,0,0,4,0,2.0
1840,5,1840,1.75,0,0,0,4,0,1.0
1010,6,1010,1.0,0,0,0,3,0,1.0
3060,9,3060,2.5,0,0,0,4,0,2.0
1580,6,980,1.75,0,0,600,5,0,1.0
2780,8,1870,2.75,0,0,910,3,0,1.5
2500,8,1600,2.25,0,0,900,4,0,1.0
1340,8,1120,1.5,0,0,220,2,0,2.0
1410,7,1410,1.75,0,0,0,3,0,2.0
960,7,960,1.0,1,0,0,3,0,1.0
1690,7,1690,2.5,0,0,0,3,0,2.0
1960,8,1960,2.25,0,0,0,4,0,2.0
2220,8,1700,2.75,0,0,520,3,0,2.0
1550,7,1550,1.75,0,0,0,3,0,1.0
1450,7,1250,2.5,0,0,200,4,0,1.5
900,7,900,1.5,0,2,0,2,0,1.0
2380,9,2380,2.5,0,0,0,3,0,2.0
3085,7,1560,2.0,0,0,1525,3,0,1.0
2040,7,1470,2.5,0,0,570,3,0,2.0
3430,8,3430,2.5,0,0,0,4,0,2.0
2240,7,1140,2.75,0,0,1100,4,0,1.0
2210,7,1470,2.75,0,0,740,4,0,1.5
2110,9,2110,2.5,0,0,0,4,0,2.0
850,6,850,1.0,0,0,0,2,0,1.0
3310,9,3310,2.75,0,0,0,4,0,2.0
2290,8,2290,2.5,1,0,0,4,0,2.0
1860,8,1860,2.0,0,0,0,3,0,2.0
3470,10,2560,2.5,1,3,910,3,0,2.0
1290,6,790,1.0,0,0,500,3,0,1.0
1360,7,730,2.0,0,0,630,3,0,1.0
1560,7,1220,1.5,0,0,340,3,0,1.0
2370,8,1930,2.25,0,0,440,3,0,1.0
1280,8,1020,1.0,0,2,260,2,0,1.0
1540,7,1540,2.25,0,0,0,3,0,2.0
2900,11,2900,2.5,0,0,0,4,0,2.0
2700,8,2700,1.75,0,0,0,4,0,1.5
1980,7,1980,2.0,0,0,0,4,0,1.0
3030,9,2220,3.25,0,2,810,3,0,2.0
2380,7,1690,3.75,1,0,690,3,0,1.5
3450,10,3450,2.5,0,0,0,4,0,2.0
1410,7,1410,2.0,0,0,0,3,0,1.0
1180,6,1180,1.5,0,0,0,3,0,1.0
1680,7,840,1.75,0,0,840,4,0,1.0
1920,8,1920,2.25,0,0,0,3,0,2.0
1400,7,1400,1.75,0,0,0,3,0,1.0
3660,10,3660,3.25,0,0,0,3,0,2.0
970,7,970,1.5,0,0,0,3,0,1.0
1460,8,1460,2.5,0,0,0,3,0,2.0
1170,7,1170,2.0,0,0,0,3,0,1.0
780,5,780,1.0,0,0,0,2,0,1.0
2370,9,2370,2.5,0,0,0,3,0,2.0
1990,7,1990,2.5,0,0,0,5,0,2.0
3230,9,3230,2.5,1,0,0,4,0,2.0
2870,7,1650,2.75,0,0,1220,5,0,1.0
2670,7,1800,2.75,0,0,870,5,0,2.0
1910,6,1910,2.5,0,0,0,4,0,1.0
3630,8,1850,2.75,1,2,1780,4,0,1.0
1840,7,1440,1.75,0,0,400,3,0,1.0
1870,8,1870,1.75,0,0,0,3,0,1.0
3040,10,3040,2.5,0,0,0,3,0,2.0
3860,10,2940,2.5,1,2,920,4,0,2.0
1800,7,1800,1.75,0,0,0,4,0,1.0
1970,7,1970,1.75,0,0,0,4,0,1.5
1720,7,1520,1.5,1,0,200,5,0,1.5
960,6,960,1.0,0,0,0,3,0,1.0
480,5,480,1.0,0,0,0,1,0,1.0
1333,7,1333,2.25,0,3,0,3,0,3.0
4220,10,4220,3.5,0,0,0,4,0,3.0
820,6,820,1.0,0,0,0,2,0,1.0
2060,8,2060,2.5,0,0,0,3,0,2.0
3190,10,3190,2.5,0,0,0,4,0,2.0
1730,7,1730,2.5,0,0,0,3,0,2.0
1490,5,1490,1.0,0,0,0,3,0,1.5
1070,7,1070,1.0,0,2,0,3,0,1.0
2580,8,1480,2.75,0,0,1100,5,0,1.0
1670,8,1670,2.5,0,0,0,3,0,2.0
2970,9,1560,1.75,0,4,1410,4,0,1.0
3580,8,2140,3.5,0,0,1440,5,0,1.5
1070,6,1070,1.0,0,0,0,2,0,1.0
2080,7,1080,1.75,0,2,1000,3,0,1.0
1070,6,870,1.0,0,0,200,4,0,1.0
2080,8,2080,2.5,0,0,0,3,0,2.0
2160,10,2160,2.0,0,0,0,3,0,1.0
2190,8,2190,2.5,0,0,0,3,0,2.0
1030,7,1030,1.0,0,0,0,2,0,1.0
1560,7,1060,2.75,0,3,500,4,0,1.0
4150,11,3510,3.0,0,4,640,5,0,2.5
790,6,790,1.0,0,0,0,2,0,1.0
870,6,870,1.75,0,0,0,2,0,1.0
2940,9,2940,2.5,0,0,0,4,0,2.0
4300,11,4300,3.5,0,0,0,4,0,2.0
760,5,760,0.75,0,0,0,1,0,1.0
1330,8,1330,1.75,0,0,0,2,0,1.0
1410,7,780,1.5,0,0,630,3,0,1.0
1880,7,1130,1.75,0,0,750,4,0,1.0
1150,7,1150,1.5,0,0,0,2,0,2.0
2490,8,2020,3.5,0,0,470,3,0,2.0
720,6,720,1.0,0,2,0,2,0,1.0
1410,7,910,1.0,0,0,500,3,0,1.0
2030,8,2030,2.5,0,0,0,4,0,2.0
1970,8,1380,2.25,0,0,590,3,0,1.0
2250,7,1420,1.75,0,0,830,4,0,1.5
2350,7,1410,1.75,0,0,940,4,0,1.5
4910,10,4000,3.0,0,0,910,3,0,2.0
2550,8,1880,3.5,0,2,670,4,0,2.0
1510,7,1150,2.25,0,0,360,3,0,1.0
4320,11,3190,4.0,0,0,1130,4,0,2.0
1330,7,1330,1.75,0,0,0,3,0,1.0
1690,7,1210,2.0,0,0,480,3,0,1.0
2680,8,1540,2.25,0,1,1140,3,0,1.0
1370,8,1370,2.75,0,0,0,3,0,3.0
830,7,830,1.5,0,0,0,2,0,2.0
1980,8,1980,2.5,0,0,0,4,0,2.0
3770,10,2940,4.0,0,0,830,4,0,2.0
2290,9,2290,3.0,0,0,0,4,0,2.0
1864,7,1864,1.0,0,0,0,3,0,1.0
2330,8,1970,1.75,0,0,360,3,0,1.0
1180,7,1180,1.0,0,0,0,3,0,1.0
1640,7,940,1.0,0,0,700,2,0,1.0
2180,7,1140,1.75,1,2,1040,3,0,1.0
2200,8,2200,2.25,0,0,0,4,0,2.0
1340,8,1120,1.5,0,0,220,2,0,2.0
2280,7,1270,4.0,0,0,1010,6,0,1.0
1150,7,800,2.0,0,0,350,3,0,2.0
4180,11,4180,3.0,0,0,0,4,0,2.0
1590,8,1590,2.5,0,0,0,2,0,2.0
1250,6,1250,1.0,0,0,0,3,0,1.0
3610,8,3610,3.0,0,0,0,5,0,2.0
1690,7,1690,1.0,0,0,0,3,0,1.0
2540,8,2540,2.75,0,0,0,3,0,2.0
1590,9,1060,2.25,0,0,530,3,0,2.0
1930,8,1130,1.75,0,2,800,4,0,1.0
2242,8,2242,2.5,0,0,0,4,0,2.0
1250,7,1250,1.0,0,0,0,3,0,1.0
2890,9,2890,2.5,0,0,0,5,0,2.0
1500,7,1500,1.75,0,0,0,3,0,1.0
2050,8,2050,2.5,0,0,0,4,0,2.0
1840,8,1840,2.5,0,0,0,3,0,2.0
2400,8,1800,2.5,0,0,600,4,0,1.0
1590,7,1590,2.5,0,0,0,3,0,2.0
1860,8,1860,1.75,0,0,0,3,0,1.5
1340,7,1340,1.75,0,0,0,4,0,1.0
3020,9,3020,2.75,1,0,0,4,0,2.0
1800,8,1270,2.25,0,0,530,3,0,1.0
1170,7,1170,1.75,0,0,0,3,0,1.0
1720,7,1720,2.5,0,0,0,3,0,2.0
3420,9,2890,2.5,1,0,530,3,0,1.0
2280,8,1300,2.75,0,0,980,5,0,1.0
5450,9,5450,3.25,0,0,0,4,0,1.5
1540,7,1540,2.5,0,0,0,3,0,2.0
1630,8,1630,1.5,0,0,0,3,0,1.5
3220,8,3220,2.5,0,0,0,4,0,2.0
800,7,800,1.0,0,0,0,2,0,1.0
1710,9,1140,2.25,0,0,570,3,0,2.0
2280,9,2280,2.5,0,3,0,3,0,2.5
3410,10,3410,2.75,1,0,0,4,0,2.0
2424,9,2424,2.5,0,0,0,3,0,2.0
990,6,990,1.75,0,0,0,2,0,1.0
5370,10,5370,3.5,0,0,0,4,0,2.0
2850,9,2850,2.5,0,0,0,4,0,2.0
2610,7,1390,1.75,0,0,1220,3,0,1.0
1660,7,1010,2.0,0,0,650,3,0,1.0
2200,8,2200,2.5,0,0,0,4,0,2.0
1040,6,1040,1.0,0,0,0,3,0,1.0
2100,7,2100,2.5,0,0,0,3,0,2.0
1590,7,1590,2.0,0,0,0,4,0,1.0
1100,8,1100,2.5,0,0,0,2,0,2.0
2060,9,1800,2.25,0,0,260,3,0,2.0
800,7,800,1.0,0,0,0,2,0,1.0
2550,8,1750,2.5,0,3,800,3,0,1.0
1700,7,1700,1.75,0,0,0,3,0,2.0
1840,8,1540,2.25,0,0,300,3,0,1.5
1230,8,1230,2.25,0,0,0,3,0,3.0
1610,7,1010,1.0,0,0,600,3,0,1.5
2520,8,1410,2.0,0,0,1110,3,0,1.5
2310,8,1580,1.75,0,2,730,3,0,1.0
750,8,750,2.5,0,0,0,2,0,2.0
2260,9,2260,1.75,0,0,0,4,0,1.0
1820,7,1200,1.5,0,0,620,3,0,1.0
4390,10,3320,4.25,0,3,1070,4,0,2.0
2520,9,2520,2.75,0,0,0,4,0,2.0
3220,10,3220,2.5,0,0,0,4,0,2.0
2600,9,1840,2.5,0,0,760,4,0,1.0
1430,7,995,2.75,1,0,435,2,0,2.0
2280,8,2280,2.0,0,0,0,2,0,1.0
3570,10,2710,3.0,0,2,860,3,0,2.0
2420,8,1500,1.5,0,2,920,5,0,1.0
2870,9,1980,2.25,1,0,890,4,0,1.5
2100,8,2100,2.5,0,0,0,4,0,2.0
870,7,870,1.0,0,0,0,2,0,1.0
2330,9,2330,2.5,0,0,0,3,0,2.0
1680,8,1680,1.75,0,0,0,4,0,2.0
3750,10,3750,3.0,0,0,0,4,0,2.0
1820,8,1820,1.0,0,0,0,4,0,2.0
1770,7,1270,2.5,0,0,500,3,0,1.5
4800,10,3580,4.5,1,0,1220,6,0,2.0
2080,8,2080,2.5,0,0,0,3,0,2.0
3140,9,2500,2.5,0,0,640,3,0,2.0
1160,7,1160,1.75,0,0,0,3,0,1.0
2930,8,2930,2.0,0,0,0,4,0,1.5
1930,7,1930,2.5,0,0,0,3,0,2.0
1940,8,1440,1.75,0,1,500,3,0,1.0
3990,8,2910,3.5,0,0,1080,5,0,2.0
1260,7,1160,2.5,0,0,100,3,0,3.0
833,5,833,1.0,0,0,0,2,0,1.0
1200,7,1200,2.0,0,0,0,3,0,1.0
4450,9,3650,2.75,0,0,800,5,0,2.0
2780,9,2780,2.5,0,0,0,3,0,2.0
1860,9,1860,2.25,1,0,0,3,0,3.0
2720,8,1840,2.75,0,2,880,4,0,1.5
1940,7,970,2.5,0,0,970,3,0,1.0
2290,8,2290,2.0,1,0,0,4,0,1.0
1630,7,1100,2.25,0,0,530,3,0,1.0
1840,7,1160,1.0,0,0,680,2,0,1.0
1020,7,1020,1.0,0,0,0,2,0,1.0
1320,7,940,1.75,0,0,380,4,0,1.0
760,4,760,0.75,0,0,0,2,0,1.0
1620,8,1540,2.25,0,0,80,3,0,2.5
3700,10,1850,3.0,1,0,1850,4,0,1.0
1120,7,1120,1.0,0,0,0,2,0,1.0
2390,7,2390,2.5,0,0,0,4,0,2.0
3320,9,3320,2.5,0,0,0,4,0,2.0
2300,8,2300,2.25,0,0,0,4,0,2.0
7270,12,6420,6.5,0,0,850,5,0,2.0
1840,8,1840,2.0,0,2,0,3,0,1.0
1140,7,1140,1.0,0,0,0,3,0,2.0
1500,6,890,1.0,0,0,610,3,0,1.0
1120,7,1120,1.0,1,0,0,3,0,1.0
1570,7,1180,2.25,0,0,390,3,0,1.0
1150,7,870,1.0,0,0,280,2,0,1.0
4660,11,4660,4.25,1,2,0,5,0,2.0
2390,9,2390,2.5,0,0,0,3,0,2.0
1320,7,1320,1.75,0,0,0,3,0,1.0
3100,7,3100,2.75,0,0,0,5,0,2.0
2530,8,2530,2.5,0,0,0,3,0,1.0
3230,9,3230,2.25,1,0,0,3,0,2.0
2540,8,1870,2.5,0,0,670,4,0,2.0
2120,7,1420,2.25,0,0,700,4,0,2.0
1611,10,1611,2.5,0,2,0,2,0,2.0
1750,7,1470,1.75,0,0,280,3,0,1.0
1340,8,1340,1.75,0,0,0,2,0,1.0
1780,8,1780,2.0,0,0,0,3,0,1.0
2430,8,2430,2.5,0,0,0,4,0,2.0
1530,8,1530,1.75,0,0,0,3,0,3.0
1560,8,1140,1.0,0,0,420,3,0,1.0
1300,7,1300,1.0,0,0,0,4,0,1.5
2500,7,1250,1.75,0,0,1250,4,0,1.0
3350,10,1760,2.5,1,2,1590,4,0,1.0
4720,10,3190,3.25,0,2,1530,3,0,2.0
1400,8,1110,1.75,0,0,290,2,0,2.0
1510,7,1510,1.5,0,0,0,3,0,1.5
2395,8,2395,2.5,0,0,0,2,0,1.0
2700,9,2700,2.5,1,0,0,4,0,2.0
1060,6,1060,1.0,0,0,0,2,0,1.0
2160,8,2160,1.75,0,0,0,4,0,2.0
2190,8,2190,2.25,0,0,0,4,0,2.0
2010,8,2010,2.75,0,0,0,4,0,2.0
1430,7,1430,1.75,0,0,0,3,0,1.0
3310,9,3310,2.5,0,2,0,3,0,2.0
2180,7,1750,2.25,0,0,430,3,0,1.0
1920,7,1070,1.5,1,0,850,4,0,1.0
2760,8,1780,2.75,0,2,980,4,0,1.5
2810,9,1540,2.5,0,3,1270,5,0,1.0
2441,8,2441,2.5,0,0,0,4,0,2.0
3060,10,3060,2.25,1,0,0,5,0,2.0
3430,10,3430,2.5,0,0,0,4,0,2.0
2610,8,2610,2.5,0,0,0,3,0,2.0
2300,9,2300,2.5,0,2,0,3,0,2.0
1240,7,1240,1.75,0,0,0,3,0,1.0
670,5,670,1.0,0,0,0,1,0,1.0
4030,8,3310,2.75,0,2,720,4,0,2.0
3920,9,3030,3.25,0,0,890,5,0,2.0
1800,8,1400,2.75,0,0,400,4,0,1.0
3260,9,3260,2.75,0,0,0,4,0,2.0
1480,8,1480,2.25,0,0,0,3,0,3.0
3000,7,3000,2.5,0,0,0,4,0,2.0
2075,7,2075,2.5,0,0,0,3,0,1.0
2120,7,2120,2.5,0,0,0,3,0,2.0
4510,12,4510,4.5,1,2,0,4,0,2.0
3160,8,2650,2.5,0,0,510,3,0,2.0
3020,7,1510,2.25,0,0,1510,5,0,1.0
2240,7,1120,1.75,0,0,1120,5,0,1.0
2120,7,2120,1.5,0,0,0,5,0,1.5
1270,6,1270,1.0,0,0,0,2,0,1.0
1850,7,1280,1.75,0,0,570,3,0,1.0
3520,10,3140,2.5,0,3,380,4,0,2.0
2350,8,2350,2.5,0,0,0,4,0,2.0
2514,8,2024,3.5,0,0,490,3,0,2.0
1770,7,1770,2.25,0,0,0,4,0,2.0
3670,10,2410,3.5,0,0,1260,6,0,2.0
1660,7,1660,1.0,0,0,0,3,0,1.0
1010,7,1010,1.0,0,0,0,2,0,2.0
2490,8,2490,2.5,0,3,0,3,0,2.0
770,6,770,1.0,0,0,0,2,0,1.0
2070,7,2070,2.25,0,0,0,3,0,2.0
1410,8,1410,2.0,0,0,0,4,0,1.5
770,6,770,1.0,0,0,0,2,0,1.0
1840,7,1840,2.5,0,0,0,4,0,2.0
810,6,810,1.0,0,0,0,2,0,1.0
1690,8,1690,2.0,0,0,0,3,0,1.0
1190,5,1190,1.0,0,0,0,3,0,1.5
1900,7,1900,2.5,0,0,0,5,0,2.0
1270,8,1270,2.0,0,0,0,3,0,3.0
2950,9,2950,2.5,0,0,0,3,0,2.0
2160,8,2160,1.75,1,0,0,4,0,2.0
2280,7,1290,2.5,0,0,990,4,0,1.0
1320,7,1320,1.0,0,0,0,3,0,1.5
1400,7,1400,1.0,0,0,0,2,0,1.0
1940,8,1740,1.5,0,0,200,3,0,2.0
2080,8,1580,2.75,0,3,500,3,0,1.0
1960,7,1260,2.0,0,0,700,4,0,1.5
1760,8,1760,2.5,0,0,0,3,0,2.0
3680,10,3680,4.0,0,0,0,4,0,2.0
1860,8,1860,1.75,0,0,0,4,0,1.0
1450,7,820,1.5,0,0,630,2,0,1.0
2260,8,1450,1.75,0,2,810,4,0,1.0
1500,7,1000,1.5,0,0,500,3,0,1.0
2100,10,1320,2.25,0,0,780,3,0,2.0
1290,8,1290,2.25,0,0,0,2,0,3.0
3490,9,2150,2.5,0,4,1340,3,1,2.0
3040,7,3040,2.5,0,0,0,3,0,2.0
1510,8,1510,1.75,0,0,0,2,0,1.0
1250,7,1050,1.0,0,0,200,2,0,1.0
2220,8,1110,2.25,1,0,1110,4,0,1.0
2270,9,2130,3.0,0,0,140,3,0,2.0
2450,8,2450,2.25,0,0,0,3,0,2.0
1500,7,1500,1.0,0,0,0,3,0,1.0
1460,7,960,1.75,0,0,500,3,0,1.0
1390,6,1390,1.0,0,0,0,3,0,1.0
1640,8,1640,2.25,0,0,0,3,0,2.0
3780,9,2430,3.5,1,0,1350,3,0,2.0
1940,8,1940,2.5,0,0,0,4,0,2.0
1470,7,1070,1.0,0,0,400,3,0,1.0
1350,7,1350,1.75,1,0,0,4,0,1.0
1070,6,910,2.0,0,0,160,2,0,1.0
1370,6,1370,1.5,0,0,0,3,0,1.0
2120,8,2120,2.25,0,0,0,4,0,2.0
1700,7,850,2.0,0,0,850,4,0,1.0
1910,7,1010,2.25,0,0,900,2,0,1.0
870,6,570,1.0,0,0,300,2,0,1.0
1300,7,1300,1.5,0,0,0,3,0,1.0
3890,8,3260,2.75,0,1,630,3,0,2.0
1000,7,990,2.5,0,0,10,2,0,2.0
2050,8,2050,2.25,0,0,0,4,0,2.0
1710,7,1320,1.0,0,0,390,5,0,1.5
4210,9,4210,3.5,0,0,0,4,0,2.0
2650,9,2650,2.5,0,0,0,4,0,2.0
2680,8,1340,2.5,0,0,1340,4,0,1.0
5060,11,5060,5.5,1,0,0,4,0,2.0
2400,9,2400,2.25,0,0,0,4,0,1.0
960,7,960,1.0,0,0,0,3,0,1.0
2360,7,2360,2.5,0,0,0,3,0,2.0
1500,7,1500,2.0,0,0,0,4,0,1.5
3160,8,1930,3.0,0,3,1230,4,0,1.0
1310,7,1310,1.0,0,0,0,3,0,1.0
2420,9,2420,2.0,0,0,0,4,0,1.0
1260,6,700,1.75,0,0,560,3,0,1.0
2180,8,1410,3.0,0,0,770,3,0,1.5
1080,6,1080,1.0,0,0,0,2,0,1.0
2450,9,2450,2.75,0,0,0,4,0,1.0
1980,7,1980,2.5,0,0,0,3,0,2.0
2815,9,2815,3.5,0,0,0,5,0,2.0
2780,10,2530,3.5,0,4,250,4,0,2.0
1800,8,1800,2.5,0,0,0,3,0,2.0
1230,7,1230,2.0,0,0,0,3,0,1.0
1120,7,1120,1.0,0,0,0,3,0,1.0
1280,7,1140,1.0,0,0,140,2,0,1.0
1640,6,1040,1.0,0,0,600,3,0,1.0
3380,9,1690,2.0,0,0,1690,4,0,1.0
2140,9,2140,1.5,0,0,0,3,0,1.5
2320,7,1400,1.75,0,0,920,2,0,1.0
1700,7,1340,2.25,0,0,360,3,0,1.0
2350,10,2000,2.5,0,2,350,2,0,3.0
1030,8,680,2.0,0,0,350,2,0,2.0
1100,7,1100,1.0,0,0,0,2,0,1.0
1610,7,1610,2.25,0,0,0,3,0,2.0
2040,7,1020,1.75,0,0,1020,4,0,1.0
1740,7,1740,1.75,0,0,0,3,0,1.5
2380,7,2380,2.5,0,0,0,4,0,2.0
2160,8,2160,2.0,1,0,0,3,0,1.0
2140,8,1220,2.25,0,2,920,5,0,1.0
850,7,850,1.0,0,0,0,2,0,1.0
3510,9,3510,3.25,1,0,0,5,0,2.0
1600,7,1400,1.0,0,0,200,3,0,1.5
1920,8,1520,2.25,0,0,400,3,0,1.0
1280,7,1280,2.25,0,0,0,2,0,2.0
2590,9,2590,2.25,0,0,0,4,0,2.0
4360,10,4360,4.0,1,0,0,4,0,2.0
1930,8,1930,1.75,0,0,0,3,0,1.0
1070,7,830,1.0,0,0,240,2,0,1.0
3320,9,3320,2.5,0,0,0,4,0,2.0
1900,7,1120,1.5,0,0,780,3,0,1.0
3500,10,3500,2.5,0,2,0,4,0,2.0
2320,9,1730,2.5,0,0,590,3,0,1.0
2360,8,1990,3.25,0,0,370,5,0,2.0
1180,7,1180,1.0,0,0,0,3,0,1.0
1290,8,1290,2.5,0,0,0,2,0,3.0
980,8,980,2.5,0,0,0,2,0,3.0
1300,7,1300,1.75,0,0,0,3,0,1.0
4090,8,3670,2.5,0,0,420,4,0,2.0
3890,9,2860,3.5,1,0,1030,4,0,2.0
1160,7,860,1.0,0,0,300,2,0,1.0
1310,6,1310,1.5,0,0,0,2,0,1.5
1840,7,1840,1.5,0,0,0,4,0,1.5
1630,8,1630,2.5,0,0,0,3,0,1.0
2330,9,2330,1.75,0,0,0,3,0,2.0
1560,6,780,1.75,0,0,780,3,0,1.0
2800,8,1400,2.0,1,0,1400,5,0,1.0
2500,8,1600,2.25,1,0,900,4,0,1.0
1560,7,1560,1.75,0,0,0,3,0,1.0
1890,9,1200,2.75,0,0,690,4,0,2.0
1100,7,1100,1.5,0,0,0,3,0,1.0
1070,6,1070,1.0,0,0,0,3,0,1.0
3340,10,3340,2.5,0,2,0,4,0,2.0
1250,6,1250,1.0,0,0,0,3,0,1.0
1840,7,1500,1.75,0,0,340,3,0,1.0
1520,8,1520,1.75,0,0,0,3,0,1.0
1710,7,1710,2.0,0,0,0,3,0,1.0
2940,8,2940,2.5,0,0,0,4,0,2.0
2430,8,1810,2.25,1,0,620,3,0,2.0
2500,7,1580,2.75,0,0,920,3,0,1.0
2220,7,2220,2.0,0,0,0,3,0,1.0
1640,7,1020,2.0,0,0,620,3,0,1.0
2120,7,1360,2.5,0,0,760,3,0,1.0
1180,8,1180,1.5,1,0,0,3,0,1.0
2610,8,1320,2.0,0,0,1290,6,0,1.0
4660,12,4660,3.5,0,4,0,3,1,2.0
1360,8,1140,2.25,1,0,220,3,0,2.0
1590,6,1090,1.0,0,0,500,5,0,1.5
2690,9,2690,2.5,0,0,0,4,0,2.0
2770,8,2400,2.5,0,0,370,4,0,2.0
1940,8,1940,1.75,0,0,0,3,0,1.5
3340,8,3340,2.25,0,0,0,3,0,1.0
2400,8,2400,2.75,0,0,0,4,0,2.0
1060,7,1060,1.0,0,0,0,2,0,1.0
2810,8,1490,1.5,0,2,1320,4,0,1.0
1510,7,1510,1.75,0,0,0,3,0,2.0
1090,8,1090,1.5,0,0,0,2,0,3.0
1200,6,1200,1.0,0,0,0,3,0,1.0
1950,8,1450,2.25,0,1,500,4,0,1.0
1410,8,1410,3.25,0,0,0,3,0,3.0
1290,7,820,1.5,1,0,470,3,0,1.0
1680,7,960,1.75,0,0,720,3,0,1.0
1280,7,1280,2.5,0,0,0,3,0,2.0
2650,9,2650,2.5,0,0,0,4,0,2.0
1100,7,1100,2.0,0,0,0,3,0,1.0
1700,8,1160,2.5,0,0,540,3,0,1.0
2145,8,2145,1.75,0,0,0,3,0,1.5
1950,7,1210,1.75,0,0,740,3,0,1.0
1680,8,1680,1.75,0,2,0,3,0,1.0
2960,8,2360,2.75,0,1,600,4,0,1.0
2300,9,2300,1.75,0,0,0,3,0,1.0
2230,8,2230,2.5,0,0,0,3,0,2.0
2340,7,2340,1.75,0,0,0,5,0,2.0
1260,7,1260,1.0,0,0,0,2,0,1.0
1740,8,1120,2.5,1,0,620,3,0,2.0
2180,8,1240,2.5,0,0,940,3,0,1.0
1780,6,1780,1.0,0,0,0,4,0,1.5
1480,7,1080,2.0,0,0,400,3,0,1.0
2470,8,2470,2.5,0,0,0,4,0,2.0
1970,6,1230,2.5,0,0,740,3,0,1.5
2990,8,1880,2.75,0,1,1110,4,0,1.0
2900,9,2900,2.75,0,0,0,4,0,2.0
1890,7,1670,2.0,0,0,220,4,0,1.5
830,7,830,1.5,0,0,0,2,0,2.0
2000,7,1400,1.75,1,0,600,3,0,1.0
2890,9,2890,2.5,0,0,0,4,0,2.0
1870,7,1870,1.5,0,0,0,3,0,1.0
2330,6,1430,2.0,0,0,900,3,0,1.5
1550,8,1280,3.0,0,0,270,3,0,2.0
1710,7,1560,1.0,0,0,150,3,0,1.5
1530,7,890,1.0,0,0,640,3,0,1.0
2010,8,2010,2.25,0,0,0,3,0,2.0
1640,7,1640,2.0,0,0,0,3,0,1.0
3220,10,3220,2.75,0,0,0,4,0,2.0
1490,7,1490,2.0,0,0,0,3,0,1.0
2300,7,2300,3.0,0,0,0,3,0,1.0
1610,6,1010,1.5,0,0,600,4,0,1.0
1790,7,1410,1.75,0,0,380,3,0,1.0
1730,7,1730,2.25,0,0,0,4,0,1.0
1380,7,1080,1.5,0,0,300,3,0,1.0
1880,7,1020,1.75,0,0,860,4,0,1.0
1580,8,1280,1.5,0,2,300,2,0,1.0
1300,8,1300,2.0,0,0,0,2,0,1.0
2280,8,1520,2.75,0,0,760,4,0,1.5
1980,8,1360,1.75,0,0,620,3,0,1.0
630,5,630,1.0,0,0,0,1,0,1.0
1850,7,1850,2.0,0,0,0,3,0,1.0
2030,7,1230,2.75,0,0,800,4,0,1.0
1340,7,1340,1.75,0,0,0,3,0,1.0
1970,8,1970,2.5,0,0,0,3,0,2.0
3160,9,2360,3.25,0,0,800,4,0,2.0
2320,8,1820,1.75,0,0,500,4,0,1.5
1340,7,1040,1.5,0,0,300,3,0,2.0
5000,10,5000,5.0,0,0,0,5,0,2.0
1690,8,1690,2.5,0,0,0,3,0,2.0
3760,10,3150,3.5,1,0,610,5,0,2.0
2320,8,2320,2.5,0,0,0,3,0,1.5
2340,7,1170,2.0,0,0,1170,4,0,1.0
4340,7,2550,3.25,0,0,1790,7,0,2.0
1990,7,1390,2.25,1,0,600,3,0,1.0
1100,7,1100,1.0,0,0,0,3,0,1.0
2980,7,2480,2.75,0,0,500,6,0,1.5
3500,10,2460,3.5,1,0,1040,4,0,2.0
2620,9,2620,3.0,0,0,0,4,0,2.0
2770,9,2440,2.25,0,1,330,4,0,2.0
1930,7,1930,3.5,0,2,0,4,0,1.5
1780,7,1780,1.5,0,0,0,3,0,1.0
3350,11,3350,2.5,0,0,0,4,0,2.0
1790,7,1290,2.25,0,0,500,3,0,1.0
1770,7,1050,1.75,0,0,720,4,0,1.0
2240,7,1120,1.75,0,0,1120,3,0,1.0
1680,7,840,1.75,0,0,840,3,0,1.0
1700,7,850,2.25,1,0,850,3,0,1.0
1070,6,970,1.0,0,0,100,3,0,1.0
1430,5,1430,1.0,0,0,0,4,0,1.5
2770,10,2770,2.5,1,0,0,3,0,2.0
730,5,730,1.0,0,0,0,1,0,1.0
1690,7,1690,1.0,0,0,0,5,0,1.5
1830,7,1170,2.25,0,3,660,3,0,1.0
2020,7,1430,1.75,0,0,590,4,0,1.0
3220,10,3220,2.5,0,0,0,4,0,2.0
1900,9,1460,2.25,1,0,440,4,0,1.0
3600,8,2410,2.5,0,0,1190,5,0,1.0
1630,7,980,1.5,0,0,650,3,0,1.0
1760,8,1760,2.5,0,2,0,3,0,2.0
3240,9,1840,2.5,0,0,1400,4,0,1.0
1080,7,1080,1.0,0,0,0,2,0,1.0
7320,11,7320,4.0,0,0,0,5,0,2.0
1050,7,1050,2.0,0,0,0,3,0,1.0
2480,9,2480,2.25,0,0,0,4,0,2.0
1740,7,1740,1.75,0,0,0,3,0,1.0
1620,7,1620,1.0,0,0,0,3,0,1.5
3090,9,3090,3.0,0,0,0,4,0,2.0
2920,11,2920,2.25,1,0,0,4,0,1.0
2010,8,1330,2.25,0,0,680,3,0,1.0
2330,8,1950,3.0,0,0,380,3,0,2.5
2580,9,2580,2.25,1,0,0,4,0,2.0
3080,9,3080,2.5,0,0,0,4,0,2.0
2835,8,2835,2.5,0,0,0,4,0,2.0
2060,7,1420,1.75,0,0,640,2,0,1.0
2400,7,1200,3.0,0,0,1200,4,0,1.0
910,6,910,1.0,0,0,0,2,0,1.0
1290,7,1290,1.75,0,0,0,3,0,1.0
1800,7,1370,1.75,0,0,430,3,0,1.0
2080,9,2080,2.5,1,0,0,3,0,2.0
1630,8,1630,1.75,0,0,0,3,0,1.0
2680,8,2680,2.0,0,0,0,4,0,1.0
830,7,830,1.0,0,0,0,2,0,1.0
2320,9,2060,3.5,1,0,260,3,0,2.0
2120,6,1440,1.75,0,0,680,2,0,1.0
3640,10,3640,3.0,1,0,0,5,0,2.0
2750,7,2150,3.25,1,1,600,5,0,2.0
5310,12,3090,5.0,1,4,2220,4,0,1.0
2460,9,2460,2.25,0,0,0,4,0,1.0
790,6,790,1.0,0,0,0,1,0,1.0
5640,11,4900,3.25,1,2,740,4,0,2.0
5990,11,4050,4.75,0,4,1940,5,1,2.0
2710,9,1910,2.25,0,0,800,5,0,1.0
1300,7,1300,1.5,1,0,0,3,0,1.0
2210,8,2210,2.5,0,0,0,4,0,2.0
2290,8,2290,2.25,0,0,0,3,0,2.0
1930,7,1930,2.0,0,0,0,4,0,1.5
2440,8,1320,1.5,0,0,1120,3,0,1.0
3160,9,3160,2.75,0,0,0,4,0,2.0
2490,8,2490,2.5,0,0,0,3,0,2.5
2320,8,2160,3.0,0,0,160,4,0,2.0
1910,8,1430,2.25,0,0,480,3,0,1.0
1860,8,1860,2.5,0,0,0,4,0,2.0
4260,8,4100,2.5,0,0,160,4,0,1.5
2130,7,1330,2.0,0,0,800,3,0,1.5
1420,7,970,1.0,0,0,450,3,0,1.0
2150,8,1450,2.25,0,0,700,3,0,1.0
1700,7,1700,2.25,0,0,0,4,0,2.0
2930,10,2930,2.5,0,0,0,4,0,2.0
2310,8,2310,2.5,0,3,0,3,0,1.0
2670,10,2670,2.5,0,0,0,3,0,1.0
1110,7,1110,1.0,0,0,0,3,0,1.0
1300,7,1300,1.0,0,0,0,3,0,1.0
2150,8,2150,2.5,0,0,0,3,0,2.0
3190,9,3190,3.25,0,0,0,3,0,2.0
1440,7,1440,1.5,0,0,0,3,0,1.0
1490,8,1490,2.25,0,0,0,2,0,1.5
1800,7,1200,2.25,0,2,600,3,0,1.0
2690,10,2690,2.5,0,3,0,3,0,2.0
1390,7,1390,2.5,0,0,0,2,0,2.0
2420,9,2420,2.5,0,0,0,3,0,1.0
2009,8,2009,2.5,0,0,0,4,0,2.0
2070,7,2070,2.5,0,0,0,3,0,2.0
3240,10,3240,2.5,0,0,0,3,0,2.0
2760,9,2760,2.5,0,0,0,5,0,2.0
1240,6,1240,2.0,0,0,0,1,0,2.0
2730,8,1530,2.75,0,0,1200,4,0,1.0
2380,10,2380,2.5,1,0,0,4,0,2.0
1150,6,800,1.0,0,0,350,3,0,1.0
1360,7,680,2.0,0,0,680,2,0,1.0
1400,7,1400,1.75,0,0,0,3,0,1.0
2450,8,2450,2.5,0,0,0,4,0,2.0
1390,8,1130,2.5,0,0,260,2,0,2.0
1670,7,1670,1.0,1,0,0,2,0,1.0
1680,7,960,1.75,0,0,720,3,0,1.0
2530,8,2530,2.5,0,0,0,4,0,2.0
2019,8,2019,2.5,0,3,0,4,0,2.0
2980,9,2980,2.5,1,0,0,4,0,2.0
1560,7,1560,2.5,0,0,0,3,0,2.0
1650,6,1650,2.0,0,0,0,4,0,1.0
550,7,550,1.0,0,0,0,1,0,2.0
1520,7,1520,2.0,0,0,0,3,0,1.0
1160,7,860,1.0,0,0,300,2,0,1.0
1160,6,580,1.0,0,0,580,2,0,1.0
910,7,910,1.0,0,0,0,2,0,1.0
1350,9,870,2.5,0,0,480,2,0,2.0
1510,7,1510,1.0,0,0,0,2,0,1.0
2790,10,2370,3.0,1,4,420,3,1,2.0
1540,8,1540,1.75,0,0,0,3,0,1.0
1330,7,1330,2.0,0,0,0,3,0,1.0
2400,8,2400,2.75,0,0,0,5,0,2.0
2330,8,1600,2.25,0,1,730,4,0,2.0
1670,7,1670,2.5,0,0,0,3,0,2.0
1260,7,820,1.75,0,0,440,3,0,1.0
700,7,700,1.0,0,0,0,2,0,1.0
1790,7,1220,2.25,0,0,570,3,0,1.0
2080,7,1050,1.75,0,0,1030,4,0,1.0
1180,7,1180,2.0,0,0,0,2,0,1.0
2020,7,1260,2.75,0,0,760,3,0,1.0
1150,6,1150,1.0,0,0,0,3,0,1.5
1210,7,1210,1.0,0,0,0,4,0,1.5
1270,7,1270,1.0,0,3,0,3,0,1.5
1700,6,1080,2.0,0,0,620,4,0,1.0
2460,8,2460,2.5,0,0,0,4,0,2.0
1360,8,1360,1.5,0,0,0,3,0,3.0
2830,10,2830,2.5,0,0,0,2,0,2.0
2060,8,2060,3.0,0,0,0,3,0,2.0
1860,7,1860,2.0,0,0,0,5,0,2.0
4140,11,4140,2.75,0,0,0,4,0,2.0
1800,8,1800,2.5,0,0,0,4,0,2.0
3440,11,3440,2.5,0,0,0,3,0,2.0
1982,8,1982,2.5,0,0,0,4,0,2.0
3680,10,3680,2.5,1,0,0,4,0,2.0
3180,10,3180,2.5,1,0,0,5,0,2.0
2800,7,2800,3.25,0,0,0,4,0,2.0
2720,10,2500,2.5,1,2,220,4,0,2.0
1290,6,1290,1.0,0,0,0,3,0,1.5
1680,7,840,2.0,0,0,840,4,0,1.0
1560,7,1210,2.5,0,0,350,3,0,1.0
4230,10,3860,3.25,0,0,370,5,0,2.0
2610,8,2610,1.75,1,0,0,4,0,1.0
1360,7,1360,1.75,0,0,0,3,0,1.0
1940,7,970,1.5,0,0,970,2,0,1.0
3030,8,3030,3.5,0,2,0,3,0,2.0
3300,10,3300,2.5,0,0,0,4,0,2.0
1400,7,1400,2.25,0,0,0,3,0,2.0
2340,8,1270,2.0,0,0,1070,4,0,1.0
1180,7,940,1.0,0,1,240,2,0,1.0
670,7,670,1.0,0,0,0,1,0,1.0
2540,9,2540,2.5,0,0,0,4,0,2.0
3770,10,3770,3.5,1,0,0,4,0,2.0
1900,6,1900,1.75,0,0,0,3,0,1.5
2900,8,2900,2.5,0,0,0,4,0,2.0
1640,6,1640,1.0,0,0,0,3,0,2.0
2840,8,1420,2.75,0,0,1420,6,0,1.0
1860,8,1860,2.25,0,0,0,4,0,1.0
4500,8,3000,3.25,0,4,1500,5,0,2.0
1700,7,1700,1.0,0,0,0,3,0,1.5
1250,7,1250,1.75,0,0,0,2,0,1.0
1630,8,1630,1.75,0,0,0,3,0,3.0
2030,8,2030,2.5,0,0,0,4,0,2.0
2860,7,1720,2.5,0,2,1140,4,0,1.5
1860,7,1860,2.25,0,0,0,3,0,1.0
3430,10,3430,2.5,0,0,0,4,0,2.0
2490,8,1690,3.0,0,0,800,4,0,1.5
2430,9,1530,2.75,0,0,900,3,0,1.0
1820,7,1240,2.25,0,0,580,3,0,1.0
2240,7,1340,2.5,0,0,900,5,0,1.0
2050,8,2050,2.5,0,2,0,3,0,2.0
1480,7,1480,2.0,0,0,0,4,0,1.0
1420,8,1310,2.5,0,0,110,3,0,2.0
1350,7,1350,2.25,0,0,0,3,0,2.0
1830,7,1830,2.0,0,0,0,4,0,1.5
1630,7,830,1.0,0,0,800,2,0,1.0
2350,8,1800,1.75,0,0,550,3,0,1.0
1250,7,790,1.75,0,0,460,2,0,1.0
1867,9,1867,2.5,0,0,0,4,0,2.0
3310,8,2440,2.5,0,2,870,3,0,2.0
3240,9,3240,2.5,0,0,0,4,0,2.0
2770,8,1600,2.5,0,0,1170,4,0,1.0
1660,7,960,1.75,0,0,700,3,0,1.0
4260,10,4260,3.25,0,0,0,5,0,2.0
1820,7,1090,1.5,0,0,730,5,0,1.0
2320,8,2320,2.5,0,0,0,3,0,2.0
1820,7,1320,2.25,0,0,500,3,0,1.0
880,7,880,1.0,0,0,0,2,0,1.0
2070,7,2070,2.0,0,0,0,4,0,1.5
1950,8,1350,2.25,0,0,600,4,0,1.0
2010,9,1450,2.5,0,0,560,3,0,1.0
3160,10,3160,2.5,0,0,0,4,0,2.0
3160,10,3160,2.25,0,0,0,4,0,1.0
1720,7,1720,2.5,0,0,0,3,0,2.0
2100,6,2100,2.5,0,0,0,4,0,1.5
2980,9,2980,2.5,0,0,0,4,0,2.0
1530,7,1150,3.0,1,0,380,3,0,1.0
1140,7,1140,1.0,0,0,0,3,0,1.0
2160,8,2160,2.5,0,0,0,4,0,2.0
3450,11,2690,3.25,0,0,760,3,0,2.0
1700,7,850,1.75,1,0,850,3,0,1.0
1870,7,1870,2.0,1,0,0,3,0,1.0
800,6,800,1.75,0,0,0,2,0,1.0
1160,7,1160,2.0,0,0,0,3,0,1.0
1810,8,1210,1.75,0,0,600,3,0,1.0
1260,8,1260,1.5,0,0,0,3,0,1.5
710,7,710,1.0,0,0,0,2,0,2.0
1300,6,1300,1.0,0,0,0,3,0,1.0
2480,10,2380,2.25,0,2,100,4,0,2.0
1330,6,1330,1.0,0,0,0,4,0,1.5
2450,9,2450,2.5,0,0,0,3,0,2.0
990,6,990,2.0,0,0,0,2,0,1.0
3420,9,3420,2.5,0,0,0,4,0,2.0
1360,7,1140,2.75,0,2,220,3,0,1.0
1970,7,1970,1.5,0,0,0,3,0,1.0
1180,7,1180,1.0,0,0,0,3,0,1.0
2490,9,2490,2.5,0,0,0,3,0,2.0
1550,8,1550,2.25,0,0,0,2,0,2.0
6490,11,3940,4.25,1,3,2550,5,0,2.0
3390,7,3390,3.5,0,2,0,5,0,2.0
2390,7,1610,2.75,0,0,780,3,0,1.0
1630,8,1020,1.75,0,0,610,3,0,2.0
2670,7,1370,3.0,0,0,1300,5,0,1.0
2420,7,1420,2.0,0,0,1000,3,0,1.0
2000,7,1300,2.5,0,0,700,3,0,1.0
1220,8,1220,1.5,0,0,0,3,0,3.0
1010,7,1010,1.5,0,0,0,3,0,1.0
1920,8,960,1.75,1,0,960,3,0,1.0
1040,7,1040,1.0,0,0,0,2,0,1.0
1470,7,1040,1.0,0,0,430,3,0,1.0
5040,11,5040,4.25,0,0,0,5,0,2.0
1600,8,1600,2.25,0,0,0,3,0,2.0
1500,6,1500,1.0,0,0,0,4,0,1.5
2920,8,2920,2.75,0,0,0,5,0,2.0
2410,8,2410,2.25,0,0,0,4,0,2.0
2100,7,1780,2.75,0,0,320,4,0,1.5
1820,7,1120,1.0,0,0,700,3,0,1.0
1280,7,1280,1.0,0,0,0,3,0,1.5
1360,8,1360,1.5,0,0,0,3,0,1.0
2550,8,2550,2.5,0,0,0,3,0,2.0
2250,8,2250,2.5,0,0,0,4,0,2.0
1640,6,1640,2.0,0,0,0,3,0,1.5
1960,9,1600,3.0,0,0,360,3,0,2.0
1370,7,1370,1.5,0,0,0,3,0,2.0
3010,9,3010,2.5,0,0,0,4,0,2.0
2990,8,2990,2.5,0,0,0,5,0,2.0
2220,8,2220,2.5,0,0,0,3,0,2.0
1660,7,1660,1.5,0,0,0,3,0,1.5
1550,7,1550,1.75,0,0,0,3,0,2.0
2210,9,2210,2.5,0,0,0,3,0,2.0
1300,8,1300,2.0,0,0,0,2,0,1.0
2070,8,2070,2.5,0,0,0,4,0,2.0
2650,8,1610,2.25,1,0,1040,4,0,1.0
3420,9,3420,2.5,0,0,0,4,0,2.0
1480,8,1180,3.25,0,0,300,3,0,2.0
3110,9,3110,2.75,0,0,0,4,0,2.0
910,6,910,1.0,0,0,0,3,0,1.0
1350,7,900,1.5,0,2,450,3,0,1.0
990,7,990,1.0,0,0,0,2,0,1.0
1970,7,1970,2.5,0,0,0,3,0,2.0
3490,9,2460,3.5,0,4,1030,5,0,2.0
1700,6,1700,1.0,0,0,0,3,0,1.0
1940,7,1300,1.5,0,0,640,3,0,1.0
1220,6,1220,1.0,0,0,0,3,0,1.0
1830,7,1830,2.5,0,0,0,3,0,2.0
3230,8,3230,2.75,0,0,0,4,0,2.0
2080,8,1540,1.75,0,0,540,3,0,2.0
2080,8,2080,2.5,0,0,0,4,0,2.0
2910,8,2350,2.5,0,0,560,4,0,2.0
5330,10,3570,3.75,0,2,1760,5,0,2.0
2100,7,1450,2.5,0,0,650,3,0,1.0
1020,6,1020,1.0,0,0,0,1,0,1.0
3440,10,3440,2.5,0,0,0,4,0,2.0
990,6,990,1.0,0,0,0,2,0,1.0
2350,7,2350,2.25,0,0,0,4,0,1.5
1950,8,1950,2.5,0,0,0,2,0,3.0
2150,8,2150,2.5,1,0,0,3,0,2.0
1460,6,1460,1.5,0,0,0,3,0,1.0
1920,7,1120,1.0,0,2,800,3,0,1.0
3040,10,3040,2.75,1,0,0,3,0,2.0
2500,8,2500,2.25,1,0,0,4,0,2.0
1410,7,1410,2.25,0,2,0,3,0,2.0
1410,8,1410,2.0,0,0,0,2,0,1.5
1900,7,1540,2.25,0,0,360,3,0,1.0
2930,7,1750,3.0,0,0,1180,5,0,1.0
2680,9,2680,2.5,0,0,0,2,0,1.0
3030,9,2700,3.25,1,0,330,4,0,1.5
940,6,940,1.0,0,0,0,3,0,1.0
2330,8,1380,1.75,0,0,950,5,0,1.0
3090,10,3090,3.75,0,0,0,5,0,2.0
1480,6,940,1.0,0,0,540,3,0,1.0
3150,9,1620,3.5,0,0,1530,5,0,1.0
1790,8,1790,2.5,0,0,0,3,0,3.0
3140,10,3140,2.5,1,0,0,4,0,2.0
3150,9,3150,3.0,0,0,0,4,0,2.0
2030,7,1590,2.25,0,0,440,4,0,1.0
3720,10,3720,3.5,0,2,0,4,0,1.0
4280,11,4280,3.25,1,0,0,4,0,2.0
2070,7,1080,2.25,0,0,990,5,0,1.0
1180,7,1180,1.75,0,0,0,3,0,1.0
1870,7,1120,1.5,0,0,750,3,0,1.0
4220,10,4220,3.5,0,0,0,4,0,2.0
1550,7,1050,1.0,0,0,500,2,0,1.0
2880,8,2270,3.5,0,2,610,5,0,2.0
1410,7,1410,2.0,0,0,0,3,0,1.0
1450,8,1180,2.25,0,0,270,3,0,2.0
2170,8,2170,2.5,0,0,0,4,0,2.0
2230,7,1400,2.75,0,0,830,4,0,1.0
3420,10,3420,3.5,1,0,0,5,0,2.0
3330,9,2330,3.0,0,3,1000,4,0,1.5
2240,8,2240,2.25,0,0,0,4,0,2.0
1260,7,1260,1.0,0,0,0,3,0,1.0
1910,7,1080,1.0,0,0,830,3,0,1.0
2810,9,2810,2.5,0,0,0,4,0,2.0
1750,7,1150,1.5,0,0,600,3,0,1.0
2090,9,2090,2.5,1,2,0,3,0,2.0
1540,7,1540,1.0,0,0,0,4,0,1.5
2890,10,2890,2.75,0,0,0,4,0,2.0
2390,8,1470,1.75,0,0,920,4,0,1.0
1560,8,1560,1.75,0,0,0,2,0,2.0
2090,7,1280,1.75,0,0,810,4,0,1.0
2450,8,1750,1.75,0,0,700,3,0,2.0
1070,8,1070,1.75,0,0,0,2,0,3.0
2720,9,2720,2.5,0,0,0,3,0,2.0
2760,10,2760,2.25,0,0,0,3,0,2.0
1460,6,1460,1.75,0,0,0,3,0,1.0
3280,11,2670,2.5,0,3,610,3,0,1.0
2370,9,2370,2.5,0,0,0,3,0,2.0
3280,10,3280,2.75,0,0,0,4,0,2.0
2406,8,2406,2.5,0,0,0,5,0,2.0
4440,10,3140,3.5,1,3,1300,8,0,2.0
3890,9,3890,2.75,0,0,0,5,0,2.0
780,6,780,1.0,0,0,0,2,0,1.0
2480,8,2480,3.5,0,0,0,3,0,2.0
1330,7,1330,1.0,0,0,0,3,0,1.0
2600,8,2600,2.5,0,0,0,3,0,2.0
1620,7,1620,2.25,0,0,0,3,0,2.0
1630,10,1330,2.25,0,0,300,2,0,2.0
1070,7,870,1.0,0,0,200,2,0,1.0
1550,7,1550,1.5,0,0,0,3,0,1.0
1260,7,1260,1.75,0,0,0,3,0,1.0
2560,9,2560,2.5,0,0,0,4,0,2.0
2220,7,2220,2.0,0,0,0,4,0,1.0
1910,8,1910,2.5,0,0,0,3,0,2.0
1190,7,1190,1.0,0,0,0,3,0,1.0
1570,8,1570,1.75,0,0,0,4,0,1.5
2780,9,2780,2.5,0,2,0,3,0,2.0
2810,9,2810,2.5,0,0,0,4,0,2.0
3500,9,2950,2.75,0,2,550,5,0,2.0
1460,7,1460,2.0,0,0,0,3,0,1.0
1760,7,1760,1.5,0,0,0,3,0,1.0
2150,8,2150,2.5,0,0,0,4,0,2.0
1840,8,1840,2.5,0,0,0,3,0,2.0
1700,7,1700,1.75,0,0,0,3,0,1.0
1660,7,1610,2.5,0,0,50,3,0,3.0
1954,8,1954,2.5,0,0,0,4,0,2.0
1410,6,1410,2.0,0,3,0,3,0,1.0
1200,8,1030,1.5,0,0,170,3,0,2.0
1830,7,1060,1.75,0,0,770,4,0,1.0
2020,8,2020,2.5,0,0,0,4,0,2.0
1010,6,1010,1.0,0,0,0,2,0,1.0
2220,7,1320,1.75,0,0,900,4,0,1.0
2810,8,2070,3.75,0,2,740,4,0,2.0
2100,7,1410,3.5,0,0,690,5,0,2.0
1710,7,1030,2.0,0,0,680,4,0,1.0
1720,8,1720,2.5,0,0,0,3,0,2.0
2540,8,2540,2.5,0,0,0,3,0,2.0
1460,7,1460,1.75,0,0,0,3,0,1.0
1260,8,1260,2.5,0,0,0,3,0,3.0
2230,7,2230,2.5,0,0,0,4,0,2.0
2380,9,1450,2.25,1,0,930,3,0,1.0
1610,7,1610,1.0,0,0,0,2,0,1.0
820,6,820,1.0,0,0,0,3,0,1.0
1320,7,1320,1.75,0,0,0,3,0,1.0
2650,8,2230,3.5,0,0,420,4,0,2.0
1820,7,1260,2.25,0,0,560,3,0,1.0
1740,7,1380,2.25,0,0,360,3,0,1.0
2050,7,2050,2.25,0,0,0,4,0,2.0
3130,8,2190,3.25,0,0,940,3,0,2.0
3120,9,1940,2.5,1,2,1180,3,0,2.0
2240,8,1380,2.5,0,0,860,4,0,1.0
1020,6,1020,1.0,0,0,0,3,0,1.0
3330,9,3330,2.5,0,0,0,4,0,2.0
2360,8,2360,2.75,0,0,0,4,0,2.0
1910,8,1210,2.75,0,0,700,3,0,1.0
1620,7,1620,1.0,0,0,0,4,0,1.5
730,5,730,1.0,0,0,0,2,0,1.0
3160,8,2160,1.75,0,0,1000,3,0,1.0
720,6,720,1.0,0,0,0,1,0,1.0
4250,10,2870,4.25,0,3,1380,4,0,2.0
1210,6,1210,1.0,0,0,0,3,0,1.0
2520,8,2520,2.5,0,0,0,4,0,2.0
1880,7,1880,2.5,0,0,0,3,0,2.0
2440,8,1910,2.75,0,0,530,4,0,1.0
970,7,970,1.0,0,0,0,3,0,1.5
3110,9,3110,2.5,0,0,0,4,0,2.0
2050,6,1430,2.0,0,0,620,5,0,1.0
1340,7,1340,2.5,0,0,0,2,0,2.0
1040,7,1040,1.0,0,0,0,3,0,1.0
2190,8,1990,2.0,0,0,200,4,0,1.5
4360,10,3940,4.0,0,4,420,4,1,2.5
1780,7,980,1.75,0,0,800,3,0,1.0
1490,7,1490,2.0,0,0,0,3,0,1.0
2320,7,2320,3.0,0,0,0,4,0,2.0
1280,8,1080,2.25,0,0,200,3,0,2.0
3030,9,3030,2.5,1,0,0,4,0,2.0
1800,7,1000,1.5,0,2,800,2,0,1.0
2200,7,1100,2.25,0,0,1100,5,0,1.0
2120,8,2120,2.5,0,0,0,3,0,2.0
3810,8,3810,2.5,0,0,0,5,0,1.5
1540,7,1200,1.75,0,0,340,3,0,1.0
3550,9,3550,2.75,0,0,0,4,0,2.0
1900,6,1900,1.75,0,0,0,4,0,1.0
3260,8,3260,2.25,0,0,0,7,0,2.0
3030,9,2380,2.5,1,0,650,4,0,1.0
1120,6,1120,1.0,0,0,0,3,0,1.0
2950,9,2950,2.75,0,0,0,3,0,2.0
1990,8,1990,2.75,0,0,0,3,0,1.0
1950,6,1530,1.5,0,0,420,3,0,1.0
1840,7,920,1.75,0,0,920,4,0,1.0
2340,8,1340,2.25,1,0,1000,3,0,1.0
1350,7,1350,1.75,0,0,0,3,0,1.0
1250,6,1250,1.0,0,0,0,3,0,1.0
2360,7,1260,2.0,0,0,1100,4,0,1.0
1160,7,970,1.5,0,0,190,2,0,2.0
1400,8,1400,2.5,0,0,0,3,0,3.5
1250,6,1250,1.75,0,0,0,4,0,1.0
3040,9,2100,2.75,0,0,940,4,0,2.0
1440,7,1090,1.75,0,2,350,3,0,1.0
1850,8,1850,3.0,0,0,0,4,0,2.0
3990,9,3990,3.25,0,0,0,4,0,2.0
1900,8,1900,2.5,0,0,0,2,0,2.0
1140,7,1140,2.0,0,0,0,3,0,1.0
1300,7,1300,1.0,0,0,0,3,0,2.0
2190,8,2190,2.25,0,0,0,3,0,2.0
2780,10,2780,2.75,0,2,0,3,0,3.0
2750,8,2750,2.0,0,0,0,4,0,1.0
3520,8,1980,3.0,0,0,1540,4,0,1.0
2610,8,2080,3.25,0,0,530,5,0,2.0
3130,9,2550,3.5,0,0,580,4,0,2.0
2300,8,2300,2.5,0,0,0,4,0,2.0
1290,7,1290,1.0,0,0,0,4,0,1.5
2770,8,1570,1.75,1,0,1200,3,0,1.0
1480,7,1480,1.75,1,0,0,3,0,1.0
1120,7,900,1.0,0,0,220,2,0,1.0
890,6,890,1.0,0,0,0,2,0,1.0
1810,7,1290,1.75,0,0,520,3,0,1.0
2080,8,2080,2.75,0,0,0,5,0,2.0
760,6,760,1.0,0,0,0,2,0,1.0
900,6,900,1.0,0,0,0,2,0,1.0
1070,7,1070,1.0,0,0,0,3,0,1.0
740,6,740,1.0,0,0,0,2,0,1.0
3010,9,3010,2.75,0,0,0,5,0,2.0
3030,9,3030,2.5,0,0,0,4,0,2.0
1000,5,760,1.0,0,0,240,2,0,1.0
2140,8,1690,1.75,1,0,450,3,0,2.0
1400,7,900,1.0,0,0,500,2,0,1.0
980,7,980,1.0,0,0,0,3,0,1.0
2800,8,2800,2.5,0,0,0,4,0,2.0
1600,6,1600,1.0,0,0,0,4,0,1.0
3020,10,3020,3.5,1,0,0,4,0,2.0
1630,7,1630,2.5,0,0,0,4,0,2.0
1610,7,1610,2.0,0,0,0,3,0,1.0
2890,10,2890,2.5,0,0,0,3,0,2.0
1580,6,790,1.5,0,0,790,4,0,1.0
3020,9,1600,2.5,0,0,1420,4,0,1.0
2550,9,2550,2.5,0,0,0,3,0,2.0
1700,7,1060,2.75,0,0,640,3,0,1.0
1500,6,900,1.0,0,0,600,3,0,1.0
1310,6,1310,1.0,0,0,0,2,0,1.0
4220,8,2600,2.25,0,0,1620,4,0,1.0
2470,8,2470,3.0,0,0,0,6,0,2.0
1220,6,720,2.0,0,0,500,3,0,1.0
1910,7,1430,2.75,0,0,480,4,0,1.0
2600,7,1620,2.75,0,0,980,4,0,1.5
1630,6,1630,1.5,0,0,0,3,0,1.0
1450,8,1450,1.5,0,0,0,2,0,1.0
4010,10,4010,2.75,0,0,0,4,0,2.0
1310,7,1310,2.0,0,0,0,3,0,1.0
3120,9,3120,2.25,1,0,0,5,0,2.0
2290,9,2290,2.5,0,0,0,3,0,2.0
1850,8,1850,2.5,0,0,0,3,0,2.0
1920,7,1920,2.5,0,0,0,3,0,2.0
2230,7,1650,2.5,0,0,580,4,0,1.0
1740,6,1050,1.0,0,0,690,2,0,1.0
1970,7,1970,2.5,0,0,0,3,0,2.0
850,6,600,0.75,0,0,250,3,0,1.0
2040,8,2040,2.5,0,0,0,4,0,2.0
1380,7,1380,3.25,0,0,0,3,0,3.0
1240,7,1110,1.5,0,0,130,4,0,1.0
1670,7,1370,1.5,0,0,300,3,0,1.0
1660,7,830,1.0,0,0,830,1,0,1.0
3650,9,3650,2.5,0,0,0,4,0,2.0
2970,8,1610,2.75,0,2,1360,4,0,1.0
1070,6,1070,1.5,0,0,0,3,0,1.0
3560,10,3560,2.5,0,0,0,4,0,2.0
1710,7,1710,2.5,0,2,0,3,0,2.0
1420,7,1420,2.0,0,0,0,3,0,1.0
1870,7,1870,2.0,0,2,0,4,0,1.0
2770,9,2770,3.5,0,0,0,4,0,2.0
1350,6,1200,1.0,0,0,150,3,0,1.0
1770,9,1770,2.5,0,0,0,3,0,2.0
1640,7,1110,2.5,0,0,530,3,0,1.0
1750,7,870,2.0,0,2,880,3,0,1.0
2350,9,2350,2.25,0,0,0,4,0,1.0
1940,9,1940,2.25,0,0,0,3,0,2.0
2210,8,2210,2.5,0,0,0,3,0,2.0
1990,7,1030,1.75,0,0,960,3,0,1.0
990,6,990,1.0,0,2,0,2,0,1.5
3720,11,3720,3.25,0,2,0,4,0,2.0
2390,7,1990,2.25,0,0,400,3,0,1.0
1050,7,740,2.25,0,0,310,3,0,2.0
1860,7,1160,1.75,0,0,700,3,0,1.0
3870,10,2520,3.25,0,0,1350,6,0,2.0
1690,8,1410,2.5,0,0,280,3,0,2.0
3450,10,2640,3.75,0,4,810,4,0,2.0
2330,8,1450,2.25,1,0,880,4,0,1.0
700,6,700,1.0,0,0,0,1,0,1.0
2250,8,2250,2.5,0,0,0,4,0,2.0
790,7,790,1.0,0,0,0,2,0,1.0
1430,7,1430,2.0,0,0,0,3,0,1.0
1720,7,1220,2.25,0,0,500,3,0,1.0
1440,8,1440,1.75,0,0,0,3,0,1.0
3223,9,3223,3.0,0,0,0,5,0,2.0
1496,8,1248,1.75,0,0,248,3,0,2.0
2570,7,1420,3.0,0,0,1150,4,0,1.0
2090,8,2090,2.5,0,0,0,4,0,2.0
1520,7,1520,2.5,0,0,0,3,0,2.0
1540,7,940,1.75,0,0,600,3,0,1.0
610,5,610,1.0,0,0,0,1,0,1.0
2030,7,2030,1.75,0,0,0,5,0,1.0
2360,8,2360,2.5,0,0,0,4,0,2.0
1700,7,850,1.75,1,0,850,4,0,1.0
3430,10,3430,2.5,1,0,0,4,0,2.0
2240,8,1250,1.75,0,0,990,3,0,1.0
1750,8,1750,2.0,0,0,0,2,0,2.0
2350,8,1720,1.75,0,0,630,4,0,1.0
1050,7,1050,1.0,0,0,0,2,0,1.5
3545,10,2610,2.5,0,0,935,3,0,1.0
3780,10,3780,2.5,0,0,0,3,0,1.5
1880,7,1880,1.75,0,0,0,3,0,1.0
1175,6,1175,1.0,1,0,0,3,0,1.0
2960,10,2960,2.5,0,0,0,4,0,2.0
1980,9,1980,2.0,0,0,0,3,0,1.0
1410,7,1410,2.0,0,0,0,3,0,1.5
4440,10,3140,3.5,0,3,1300,4,0,2.0
2320,8,2320,1.75,0,2,0,3,0,1.0
1170,7,870,1.0,0,0,300,3,0,1.0
1680,8,1680,2.5,0,0,0,3,0,2.0
2280,8,2280,2.5,0,0,0,2,0,1.0
3050,10,3050,2.5,0,0,0,3,0,2.0
4180,7,4180,3.0,0,0,0,5,0,2.0
2680,8,2680,2.5,0,0,0,4,0,2.0
1510,7,1510,1.75,0,0,0,3,0,1.0
2080,8,1180,2.25,0,0,900,2,0,1.0
3150,8,2130,2.75,1,0,1020,3,0,1.5
1080,6,1080,1.0,0,0,0,4,0,1.5
1680,7,1680,2.5,0,0,0,3,0,2.0
1470,8,1470,1.0,0,0,0,3,0,1.0
2755,8,2755,2.5,0,0,0,4,0,2.0
2430,8,2430,2.25,0,0,0,3,0,1.0
1630,9,1360,3.5,0,0,270,3,0,2.0
1390,7,1390,2.0,0,0,0,4,0,3.0
1510,6,860,1.0,0,0,650,3,0,1.0
2200,7,1440,3.0,0,0,760,5,0,1.0
2600,8,2600,3.0,0,0,0,4,0,1.0
1330,6,1330,1.0,1,0,0,4,0,1.0
2140,7,1290,1.75,1,0,850,3,0,1.0
1480,7,1480,1.5,1,0,0,3,0,1.5
1560,7,1560,2.0,0,0,0,4,0,1.0
2100,8,2100,2.5,0,0,0,5,0,1.0
2220,7,2220,2.5,0,0,0,4,0,2.0
2060,9,1140,1.75,0,2,920,3,0,1.0
2700,7,1380,1.75,0,0,1320,4,0,1.0
1960,8,1240,2.75,1,0,720,3,0,1.0
420,4,420,1.0,0,0,0,1,0,1.0
2920,8,2320,2.5,1,0,600,5,0,2.0
1400,7,1400,2.0,0,0,0,3,0,1.0
1347,7,1347,2.25,0,0,0,3,0,3.0
2030,7,2030,1.75,0,0,0,4,0,1.5
1580,8,1580,2.25,0,0,0,3,0,3.0
1020,7,1020,1.5,0,0,0,2,0,2.0
1470,7,1470,1.75,0,0,0,4,0,1.5
1310,7,1310,1.75,1,0,0,3,0,1.0
1700,7,850,2.0,0,0,850,4,0,1.0
1900,6,1900,2.0,1,0,0,5,0,1.5
2320,8,2320,2.25,0,0,0,4,0,2.0
2710,8,1650,3.5,0,0,1060,3,0,2.0
3020,9,2080,3.5,0,0,940,3,0,2.0
1960,7,1060,2.0,0,2,900,4,0,1.0
2460,8,1560,2.5,0,0,900,3,0,1.5
3820,10,3280,3.5,1,0,540,4,0,2.0
1370,7,1370,1.5,0,0,0,3,0,2.0
680,6,680,1.0,0,0,0,3,0,1.0
3300,9,3300,2.25,0,0,0,4,0,3.0
2880,7,2880,2.5,0,3,0,3,0,2.0
2160,7,1530,2.75,0,0,630,5,0,1.5
1800,7,1440,2.25,0,0,360,4,0,1.0
1940,7,1940,2.75,0,0,0,5,0,2.0
1960,7,1000,2.75,0,0,960,4,0,1.0
2050,6,2050,1.75,0,0,0,3,0,2.0
1160,7,1160,1.0,1,0,0,3,0,1.0
1260,6,1260,1.75,0,0,0,3,0,1.0
1370,7,1370,1.75,0,0,0,3,0,1.0
1120,7,1120,1.0,0,0,0,3,0,1.0
2160,8,2160,2.25,0,0,0,3,0,2.0
3890,10,2260,3.25,1,0,1630,5,0,1.0
1050,6,1050,1.5,0,0,0,3,0,1.0
1580,7,1100,1.75,0,1,480,3,0,1.0
1680,6,840,1.75,0,0,840,2,0,1.0
1720,8,1720,1.75,1,0,0,3,0,2.0
2360,8,2360,2.25,1,0,0,4,0,2.0
1730,6,1730,1.0,0,0,0,4,0,1.5
1810,7,1280,2.25,0,0,530,3,0,1.0
3680,9,2480,2.75,0,3,1200,4,0,2.0
1870,7,1870,1.5,0,2,0,3,0,2.0
1950,7,1150,2.5,0,0,800,4,0,1.0
1410,8,1410,3.25,0,0,0,3,0,3.0
1250,6,1250,1.0,0,0,0,3,0,1.0
840,5,840,1.0,0,0,0,2,0,1.0
2340,7,2340,2.5,0,0,0,3,0,2.0
1660,7,1660,2.5,0,0,0,4,0,2.0
2080,8,1430,2.5,0,0,650,3,0,1.0
1960,7,1960,2.0,0,0,0,4,0,1.0
1490,7,1490,1.0,0,0,0,4,0,1.0
2360,8,1710,2.75,1,0,650,3,0,1.0
670,6,670,1.0,0,0,0,2,0,1.0
960,6,960,1.0,0,0,0,3,0,1.0
2950,10,2070,2.25,1,0,880,3,0,1.0
1760,8,1560,2.0,0,1,200,5,0,1.0
1110,7,1110,1.0,0,0,0,3,0,1.5
1370,8,1100,3.25,0,0,270,3,0,2.0
740,6,740,1.0,0,0,0,2,0,1.0
2680,9,2680,2.25,0,0,0,3,0,1.0
1600,8,1130,1.75,0,0,470,4,0,1.0
2860,8,1710,1.75,0,0,1150,4,0,1.0
3060,8,3060,3.5,0,0,0,5,0,2.0
1250,7,1250,2.0,0,0,0,3,0,1.0
1500,7,1030,1.75,0,0,470,3,0,1.0
1981,8,1981,2.5,0,0,0,3,0,2.0
1360,7,1360,1.75,0,0,0,3,0,1.0
3070,9,3070,2.5,0,0,0,5,0,2.0
2520,8,1440,2.5,0,0,1080,4,0,1.0
2650,7,1460,1.75,0,0,1190,3,0,1.0
1800,8,1800,2.5,0,0,0,3,0,2.0
2720,9,2720,2.5,0,0,0,4,0,2.0
3440,10,3440,2.75,0,0,0,4,0,2.0
1590,7,1190,1.75,0,0,400,3,0,1.5
1380,7,1380,1.75,0,0,0,3,0,1.0
2720,9,2720,3.0,0,0,0,4,0,2.0
1220,8,1220,1.5,0,0,0,2,0,1.5
1320,8,1320,1.75,0,0,0,3,0,1.0
1320,7,1020,1.0,0,0,300,2,0,1.0
1940,7,1940,2.5,0,0,0,3,0,1.5
2370,7,1650,3.0,0,0,720,4,0,1.5
1050,6,800,1.5,0,0,250,3,0,1.0
1370,7,1370,1.75,0,1,0,3,0,1.0
1440,7,1440,1.0,0,0,0,3,0,1.5
2460,7,1370,1.0,1,0,1090,3,0,1.5
1380,7,1380,1.0,0,0,0,3,0,1.0
2130,7,1440,2.0,0,0,690,5,0,1.0
3316,9,3316,2.5,0,0,0,3,0,2.0
5810,10,3790,5.0,1,0,2020,4,0,2.0
2260,7,2260,2.5,0,0,0,4,0,2.0
1410,7,1050,1.0,0,0,360,3,0,1.0
980,8,980,1.0,0,0,0,2,0,2.0
3530,10,3530,4.25,1,0,0,5,0,2.0
2520,8,1570,2.75,1,3,950,5,0,1.0
1730,7,1730,1.5,0,0,0,4,0,1.5
1350,7,1350,2.0,0,0,0,4,0,1.0
3390,8,2530,1.5,0,0,860,4,0,2.0
1760,7,1160,2.0,0,0,600,3,0,1.0
1390,7,1390,1.5,0,0,0,3,0,1.0
1930,7,1120,2.5,0,0,810,4,0,1.0
2940,9,2220,3.0,0,1,720,4,0,2.0
1520,7,790,1.75,0,0,730,3,0,1.0
1400,7,870,1.75,0,0,530,3,0,1.0
1470,7,1470,2.0,0,0,0,2,0,1.5
2810,8,2810,2.5,0,0,0,4,0,2.0
2100,9,2100,2.5,0,0,0,3,0,2.0
810,6,810,1.0,0,0,0,2,0,1.0
2250,8,1500,2.75,1,0,750,4,0,1.5
2160,7,1670,1.75,0,0,490,3,0,1.0
2980,7,2070,4.0,0,0,910,5,0,1.5
2330,7,1710,2.75,0,0,620,4,0,1.5
3150,9,3150,3.5,0,0,0,4,0,2.0
1030,7,1030,1.0,0,0,0,3,0,1.0
2520,7,1360,2.75,0,0,1160,3,0,1.0
2220,8,2220,1.75,0,2,0,3,0,1.0
1460,7,1460,1.5,0,0,0,3,0,1.0
2400,8,2400,2.5,0,0,0,4,0,2.0
1180,6,1180,1.0,0,0,0,2,0,1.0
2580,9,1760,3.25,0,1,820,3,0,1.5
700,6,700,1.0,0,0,0,1,0,1.0
3400,8,1870,2.5,0,4,1530,3,0,1.0
2885,8,2885,3.25,0,0,0,4,0,2.0
3520,8,2200,3.75,0,0,1320,4,0,1.5
3040,11,3040,2.75,0,0,0,4,0,2.0
1180,7,1180,1.75,0,0,0,3,0,1.0
1680,7,1680,1.5,0,0,0,3,0,1.5
980,7,980,1.5,0,0,0,2,0,2.0
740,6,740,1.0,0,0,0,2,0,1.0
3600,9,2610,4.0,0,0,990,6,0,2.0
2860,8,2860,2.5,0,0,0,4,0,2.0
1030,7,1030,1.5,0,0,0,3,0,1.0
2020,6,1010,2.5,0,0,1010,3,0,1.0
1970,8,1970,2.75,0,0,0,4,0,1.0
2120,9,2120,2.25,0,0,0,3,0,2.0
2420,8,2420,2.75,0,0,0,4,0,2.0
940,7,940,1.0,0,0,0,3,0,1.0
1570,9,1280,2.25,0,0,290,2,0,2.0
2440,8,2440,2.5,0,0,0,3,0,2.0
1790,8,1790,2.5,0,0,0,3,0,2.0
2820,8,1550,2.5,1,0,1270,5,0,1.0
1240,7,1240,2.0,0,0,0,3,0,1.0
1860,8,1460,2.5,0,0,400,4,0,1.0
1910,8,1910,2.5,0,0,0,3,0,2.0
1390,7,1390,2.25,0,0,0,3,0,3.0
1840,8,1360,1.75,0,2,480,5,0,1.0
2090,8,2090,2.5,0,0,0,4,0,2.0
2230,7,1330,3.0,0,0,900,5,0,1.0
1630,7,850,2.0,0,0,780,3,0,1.0
1260,7,1170,2.25,0,0,90,2,0,2.0
1510,8,1510,1.75,0,0,0,3,0,1.0
4000,9,4000,4.0,0,0,0,4,0,2.0
2570,8,2570,2.5,0,0,0,5,0,2.0
2311,9,2311,2.5,0,0,0,4,0,2.0
3060,8,2040,2.0,0,0,1020,4,0,2.0
6210,11,4760,4.5,0,2,1450,7,0,2.5
1200,7,1200,1.0,0,0,0,3,0,1.0
8670,13,6120,6.25,0,4,2550,5,0,2.0
2200,7,1400,2.5,1,1,800,3,0,1.0
1930,7,1500,1.5,0,0,430,3,0,1.0
4810,12,4810,0.0,0,0,0,0,0,2.0
1540,8,1540,1.5,0,0,0,3,0,2.0
3200,7,3200,2.5,0,0,0,4,0,2.0
1620,6,850,1.0,0,0,770,2,0,1.0
2680,8,1380,2.5,1,0,1300,4,0,1.0
1810,7,980,2.0,0,0,830,3,0,1.0
1460,8,1460,1.75,1,0,0,3,0,1.0
1690,7,1690,2.5,0,0,0,3,0,2.0
3050,9,2330,3.0,1,0,720,4,0,2.0
1140,7,1140,2.0,0,0,0,3,0,1.0
2400,7,1310,2.5,0,0,1090,4,0,1.0
2720,9,2250,3.5,0,0,470,4,0,2.0
1360,7,960,1.75,0,0,400,3,0,1.0
1677,7,1677,2.25,0,0,0,4,0,2.0
1700,7,1700,2.0,0,0,0,4,0,2.0
1460,7,1460,1.5,0,0,0,3,0,1.0
2110,9,2110,2.25,0,0,0,4,0,2.0
3120,9,3120,2.75,0,0,0,4,0,2.0
1580,7,790,1.75,0,0,790,3,0,1.0
1980,7,1090,1.75,0,1,890,3,0,1.0
1910,9,1910,2.75,0,0,0,2,0,3.0
1910,7,1010,2.0,0,0,900,5,0,1.0
1300,7,1300,1.0,0,0,0,3,0,1.0
3050,8,3050,2.5,0,0,0,3,0,1.0
1600,8,1600,2.25,0,3,0,3,0,1.0
1710,7,1130,1.75,0,0,580,3,0,1.0
1140,8,760,2.0,1,0,380,2,0,2.0
3070,9,2400,3.75,1,0,670,4,0,2.0
2210,7,2210,1.5,0,0,0,3,0,1.5
3280,8,2270,3.0,0,0,1010,4,0,2.0
3640,9,3640,2.5,0,0,0,4,0,2.0
920,6,920,1.0,0,0,0,2,0,1.0
2450,9,2450,3.5,0,0,0,5,0,2.0
2630,8,1690,2.75,0,0,940,5,0,1.0
2870,9,2870,2.5,0,0,0,3,0,2.0
3300,7,2390,2.5,1,0,910,4,0,1.0
2410,8,2410,2.5,0,0,0,4,0,2.0
1920,8,1920,2.5,0,0,0,3,0,2.0
3990,10,3990,3.5,1,0,0,4,0,2.0
1990,7,1270,2.75,0,0,720,4,0,1.0
2840,9,2840,2.25,0,0,0,3,0,2.0
1210,6,1210,1.5,0,0,0,2,0,1.5
1690,7,1690,2.0,0,0,0,3,0,1.0
3160,11,2160,2.5,1,3,1000,3,0,1.0
3560,8,2810,3.5,0,0,750,5,0,2.0
3270,7,3270,3.0,0,0,0,5,0,2.0
1840,7,1040,1.0,0,0,800,3,0,1.0
3550,11,3550,3.75,0,0,0,4,0,2.0
2930,9,1580,2.75,0,3,1350,4,0,1.0
1510,7,1090,1.0,0,0,420,2,0,1.0
3090,8,2990,2.5,0,0,100,5,0,1.0
290,1,290,0.0,0,0,0,0,0,1.0
1770,7,1350,1.75,0,0,420,4,0,1.0
2520,9,2520,2.5,0,0,0,4,0,2.0
1510,7,1010,1.0,0,0,500,2,0,1.0
1540,6,1540,2.0,0,0,0,4,0,1.0
2980,7,1680,3.0,0,0,1300,5,0,1.0
1100,7,620,1.0,0,0,480,2,0,1.0
1110,7,1110,1.0,0,0,0,3,0,1.5
1730,8,1730,2.5,0,0,0,3,0,2.0
2010,7,1220,2.25,0,0,790,4,0,1.0
1780,7,1780,2.0,0,0,0,3,0,1.0
3930,11,3930,2.5,0,0,0,4,0,2.0
2110,7,1100,1.75,0,0,1010,5,0,1.0
2380,8,2380,2.5,0,0,0,4,0,2.0
2220,7,2220,2.5,0,0,0,4,0,2.0
1440,7,790,1.0,0,0,650,3,0,1.0
2660,7,1480,2.0,1,0,1180,4,0,1.5
1450,7,1450,1.0,1,0,0,4,0,1.0
1810,6,1010,1.0,0,0,800,2,0,1.0
4720,11,4720,4.25,0,4,0,4,0,3.0
870,6,870,1.0,0,0,0,1,0,1.0
900,6,900,1.0,0,2,0,2,0,1.0
1360,7,1360,1.0,0,0,0,4,0,1.0
1300,7,1300,1.75,0,0,0,3,0,1.0
1440,7,1440,1.75,0,0,0,3,0,1.0
2320,8,1510,2.5,0,0,810,4,0,1.5
5320,11,5320,4.0,0,0,0,4,0,2.0
1840,7,1840,1.5,0,0,0,5,0,1.5
1090,5,1090,1.0,0,0,0,3,0,1.5
3190,10,2560,3.5,0,0,630,3,0,2.0
1720,6,860,2.0,0,0,860,4,0,1.0
1460,7,980,1.5,0,2,480,3,0,1.0
1240,7,1240,1.0,0,0,0,3,0,1.0
2280,9,2280,2.5,0,0,0,4,0,2.0
1710,7,1710,1.0,0,0,0,4,0,1.5
3650,7,2200,2.25,0,4,1450,3,0,2.0
2510,9,2510,2.25,0,0,0,4,0,2.0
1430,8,1430,2.25,0,0,0,3,0,3.0
2350,7,1740,2.5,0,0,610,3,0,2.0
1470,7,1070,1.75,0,2,400,3,0,1.0
3060,9,3060,3.5,0,0,0,4,0,2.0
6640,12,6350,5.5,0,4,290,5,1,2.0
1750,7,1750,2.0,0,0,0,5,0,1.0
2410,8,2410,1.75,0,0,0,3,0,1.0
2460,8,2100,3.25,0,0,360,3,0,2.0
860,7,860,1.0,0,0,0,2,0,1.0
1380,7,1380,2.0,0,0,0,3,0,1.5
1210,7,1210,1.0,0,0,0,3,0,1.0
1350,8,1350,2.0,0,0,0,2,0,1.0
2100,8,2100,1.75,0,0,0,3,0,1.5
1280,7,1060,1.0,0,0,220,2,0,1.0
2560,8,2150,2.25,1,0,410,3,0,1.5
2000,8,2000,2.5,0,0,0,3,0,2.0
1230,7,1060,2.5,0,0,170,2,0,2.0
2220,7,1170,2.75,0,0,1050,4,0,1.0
2880,7,2880,3.0,0,0,0,6,0,2.0
1460,5,1260,1.0,0,0,200,3,0,1.0
1830,8,1350,2.25,0,0,480,3,0,1.0
1640,8,1640,2.0,0,0,0,3,0,1.0
2930,9,2760,2.5,1,0,170,4,0,2.0
1420,7,830,2.0,0,0,590,3,0,1.0
4360,12,4360,3.5,0,0,0,4,0,2.0
1430,7,1430,1.5,1,0,0,3,0,1.0
4030,10,4030,3.75,0,0,0,4,0,2.0
1250,7,1250,2.0,0,0,0,2,0,1.0
2660,9,2660,2.5,0,2,0,4,0,2.0
1120,7,1120,1.0,0,0,0,3,0,1.0
1160,6,820,1.0,0,0,340,4,0,1.0
2960,9,2960,2.5,0,2,0,3,0,2.0
2000,7,1260,2.75,0,0,740,5,0,1.0
1620,8,1540,2.25,0,0,80,3,0,3.0
2340,9,2340,2.5,1,2,0,3,0,2.0
2000,7,1100,1.75,0,0,900,4,0,1.0
2220,8,1770,3.25,0,0,450,3,0,1.5
1690,7,1690,1.5,0,0,0,3,0,1.0
4280,10,2710,4.0,0,0,1570,5,0,2.0
1380,7,1380,2.0,0,0,0,3,0,1.0
1440,8,1440,1.75,0,0,0,2,0,1.0
1720,7,1170,1.75,0,0,550,3,0,1.0
2790,8,2790,2.75,0,0,0,4,0,2.0
3830,7,2450,4.5,0,0,1380,9,0,2.5
1640,8,1640,2.25,0,0,0,3,0,2.0
2240,8,1470,2.5,1,0,770,4,0,1.0
1690,8,1690,2.0,0,0,0,2,0,1.0
1980,7,1220,2.0,0,0,760,2,0,1.5
1440,7,870,2.0,0,0,570,2,0,1.0
2270,7,1360,2.25,0,0,910,4,0,1.0
3220,8,3220,2.5,0,0,0,4,0,1.5
1460,7,1140,2.25,0,0,320,3,0,2.0
1260,7,1260,1.5,0,0,0,2,0,2.0
1970,7,1970,2.5,0,0,0,3,0,2.0
4080,10,4080,2.5,0,0,0,4,0,2.0
2020,7,1300,2.75,0,0,720,4,0,1.0
1380,7,930,1.75,0,0,450,3,0,1.0
1320,7,1320,1.75,0,0,0,3,0,1.0
1670,7,990,1.75,0,2,680,3,0,1.0
1940,8,1200,3.0,0,0,740,5,0,1.0
3650,9,2750,2.75,1,0,900,5,0,2.0
2980,8,1540,2.75,0,0,1440,5,0,1.0
2290,8,2290,2.5,0,0,0,0,0,2.0
1370,7,1370,1.0,0,0,0,2,0,1.5
1100,6,1100,1.0,0,0,0,2,0,1.0
1300,8,1300,2.5,0,0,0,3,0,3.0
2780,9,2780,2.5,1,0,0,4,0,2.0
1570,8,1200,1.75,0,0,370,3,0,1.0
1070,7,1070,1.0,0,0,0,3,0,1.0
1180,8,1180,1.75,0,0,0,2,0,1.0
2380,7,2380,2.5,0,0,0,4,0,2.0
2360,8,1560,2.0,0,3,800,3,0,2.0
2290,8,2290,2.5,0,0,0,3,0,2.0
1840,8,1300,1.75,0,2,540,2,0,1.0
1180,7,1180,1.0,0,0,0,2,0,1.5
1170,6,1170,2.0,0,0,0,3,0,1.0
830,6,830,1.0,0,0,0,2,0,1.0
1790,8,1790,2.5,0,0,0,3,0,2.0
1260,6,1260,1.0,0,0,0,4,0,1.5
2460,8,2460,0.0,0,0,0,0,0,2.0
3000,8,3000,2.5,0,0,0,4,0,2.0
1330,7,1330,1.75,0,0,0,2,0,1.0
2026,8,2026,2.5,0,0,0,3,0,2.0
1840,8,1840,1.5,1,0,0,3,0,1.0
3620,10,2790,3.5,1,2,830,5,0,2.0
3830,9,2030,2.5,1,4,1800,4,0,1.0
2080,7,1380,2.25,0,2,700,3,0,1.0
2970,9,2200,3.5,0,2,770,4,0,2.0
890,6,890,1.0,0,0,0,3,0,1.0
2000,7,1200,2.5,0,0,800,4,0,1.0
1720,8,1360,3.25,0,0,360,3,0,2.0
2210,8,2210,2.75,0,0,0,3,0,2.0
2550,8,1580,2.25,0,0,970,4,0,1.0
3700,10,3700,2.5,0,0,0,4,0,2.0
1800,8,1220,2.0,0,0,580,3,0,1.0
3870,10,3870,3.5,0,0,0,5,0,2.0
2280,8,2280,2.5,0,0,0,3,0,2.0
1270,7,1270,1.75,0,0,0,3,0,2.0
1900,7,1100,1.75,0,4,800,2,1,1.0
1030,7,830,1.0,0,0,200,3,0,1.0
1400,7,1400,2.25,0,0,0,3,0,2.0
1990,7,1570,2.5,0,0,420,3,0,1.0
1500,7,1500,1.0,0,0,0,3,0,1.0
1580,7,1580,1.0,0,0,0,3,0,1.5
1480,8,1480,2.0,0,0,0,2,0,3.0
3220,8,3220,2.5,0,0,0,5,0,2.0
3150,9,3150,2.5,1,0,0,4,0,2.0
2850,9,1920,2.75,1,0,930,3,0,1.0
1130,7,880,1.0,0,0,250,3,0,1.0
1250,6,1040,1.0,0,0,210,2,0,1.0
1980,8,1980,2.25,0,0,0,4,0,2.0
1150,7,1150,1.0,0,0,0,3,0,1.5
1530,7,1530,1.75,0,0,0,3,0,1.0
1910,7,1210,1.75,0,0,700,4,0,1.0
1710,7,1400,3.25,0,0,310,3,0,2.0
1530,7,1530,1.75,0,0,0,3,0,1.0
950,7,850,1.0,0,2,100,2,0,1.0
1460,7,1460,1.0,0,0,0,3,0,1.0
2220,9,2220,2.25,0,0,0,4,0,2.0
2680,9,1870,3.25,0,0,810,5,0,2.0
1560,7,1110,2.25,0,0,450,3,0,1.0
2156,9,2156,2.5,0,0,0,4,0,2.0
860,7,860,1.0,0,0,0,2,0,1.0
2750,9,1960,2.5,0,0,790,4,0,2.0
1440,8,1100,1.5,0,0,340,2,0,2.0
1690,7,1190,1.75,0,0,500,3,0,1.0
2670,9,2670,2.5,0,0,0,4,0,2.0
1590,7,1590,1.75,0,0,0,3,0,1.0
1330,7,900,2.25,0,0,430,3,0,1.0
3300,8,2060,2.5,0,0,1240,6,0,1.0
1550,7,1550,2.0,0,0,0,3,0,1.5
1870,7,1200,2.0,0,0,670,4,0,1.0
1660,6,830,1.75,0,0,830,4,0,1.0
2450,9,2030,2.5,0,0,420,4,0,1.0
720,6,720,1.0,0,0,0,2,0,1.0
2250,8,2250,1.75,0,0,0,4,0,1.0
1790,7,1790,2.25,0,0,0,4,0,2.0
2890,8,2890,2.5,0,0,0,4,0,2.0
1580,8,1200,2.25,0,0,380,3,0,1.0
2170,8,2170,2.5,0,0,0,5,0,2.0
1979,7,1329,2.0,0,2,650,3,0,1.0
890,7,750,1.75,0,0,140,3,0,1.5
2840,9,2840,3.0,0,0,0,3,0,2.0
3790,10,3790,3.25,0,4,0,3,0,2.0
2300,8,1310,1.75,0,0,990,3,0,1.0
1430,7,1430,1.5,0,0,0,3,0,1.0
1840,7,1200,2.25,0,0,640,3,0,1.0
2110,8,1340,2.5,1,0,770,3,0,1.0
1940,8,1940,2.5,1,0,0,3,0,2.0
1290,7,980,1.0,0,0,310,3,0,1.0
1620,7,590,2.0,0,0,1030,3,0,1.0
2020,9,1730,2.5,0,0,290,4,0,2.0
1640,8,1640,1.5,0,0,0,3,0,1.0
3880,11,3700,4.0,0,3,180,3,0,2.0
2220,8,2220,2.5,0,0,0,4,0,2.0
1720,7,1720,2.5,0,0,0,3,0,1.5
2800,8,2800,2.5,0,0,0,4,0,2.0
4060,9,2960,3.5,0,0,1100,5,0,2.0
1070,7,1070,1.0,0,0,0,2,0,1.0
3596,8,1798,2.5,0,0,1798,6,0,1.0
2200,8,2200,2.5,0,3,0,2,0,1.0
1510,7,1510,1.0,0,0,0,3,0,1.0
1490,7,1120,1.0,0,0,370,3,0,1.0
1270,8,1060,2.25,0,0,210,3,0,2.0
2000,8,1540,1.5,0,0,460,3,0,1.0
2090,8,2090,2.5,0,0,0,3,0,2.0
1290,6,790,1.0,0,0,500,3,0,1.0
1590,7,1590,1.0,0,0,0,4,0,1.5
3310,9,3310,2.5,0,0,0,4,0,2.0
1290,7,1020,1.5,0,0,270,3,0,1.0
910,7,910,1.0,0,0,0,3,0,1.0
2270,8,1540,2.5,0,0,730,4,0,1.0
990,6,990,1.0,0,0,0,2,0,1.0
1830,7,1830,2.25,0,0,0,4,0,2.0
1680,7,1680,1.75,0,0,0,3,0,1.5
2990,7,2990,2.75,0,0,0,4,0,2.0
1760,7,1540,2.0,0,0,220,3,0,1.5
2150,8,2150,2.5,0,0,0,3,0,2.0
1020,6,1020,1.0,0,0,0,4,0,1.5
1370,7,1370,1.5,0,0,0,3,0,1.0
1620,7,1620,1.0,0,0,0,3,0,1.5
3390,9,2610,3.5,0,0,780,4,0,2.0
2000,8,2000,2.5,0,0,0,4,0,2.0
1280,7,1280,1.0,0,0,0,3,0,1.0
2230,8,1430,3.25,0,1,800,3,0,1.0
2180,7,1420,2.5,0,0,760,3,0,1.0
3550,11,2260,3.5,1,2,1290,4,0,1.0
1240,6,1040,1.0,0,0,200,3,0,1.0
2000,8,2000,1.75,0,0,0,3,0,1.0
1440,6,1080,1.0,0,0,360,4,0,1.0
5780,11,4260,4.75,1,0,1520,5,0,2.0
2120,7,1060,3.25,0,0,1060,6,0,1.0
1726,7,1726,1.75,0,0,0,3,0,2.0
1790,7,1390,2.25,0,0,400,3,0,1.0
1320,7,1320,2.0,0,0,0,3,0,1.5
1960,7,1290,2.25,0,0,670,3,0,1.0
2780,8,2780,3.25,0,0,0,3,0,2.0
3230,8,1880,2.75,0,2,1350,5,0,1.0
1430,7,980,1.0,0,0,450,3,0,1.0
2540,8,2540,2.5,0,0,0,4,0,2.0
2500,9,2500,2.5,0,0,0,4,0,2.0
2960,9,2960,2.5,0,0,0,4,0,2.0
1660,7,1660,1.0,0,0,0,3,0,1.0
2340,8,1170,2.25,0,0,1170,4,0,1.0
1650,7,1650,2.5,0,0,0,3,0,2.0
2470,8,1780,2.5,0,0,690,2,0,2.0
2030,7,2030,2.25,0,0,0,4,0,2.0
860,7,860,1.0,0,0,0,2,0,1.0
1440,7,1440,2.5,0,0,0,3,0,2.0
3560,10,2290,2.5,1,2,1270,4,0,1.0
1570,9,1570,1.75,1,0,0,2,0,3.0
2840,9,2330,3.25,0,3,510,4,0,2.0
860,5,860,1.0,0,0,0,2,0,1.0
2040,8,2040,2.25,1,0,0,4,0,2.0
1940,7,1030,1.75,0,0,910,4,0,1.0
2020,7,1710,2.25,0,0,310,4,0,2.0
2692,9,2692,2.75,0,0,0,3,0,2.0
2260,9,2260,2.5,0,0,0,4,0,1.0
1160,6,1160,1.75,0,0,0,2,0,1.0
1710,7,1710,2.0,0,0,0,3,0,2.0
2910,8,2910,1.75,0,0,0,3,0,1.5
1250,7,1250,1.75,1,0,0,2,0,1.0
1230,7,1230,1.0,0,0,0,4,0,1.5
2520,7,1260,1.75,0,2,1260,4,0,1.0
900,7,900,1.0,0,0,0,2,0,2.0
2220,9,1640,2.0,0,0,580,3,0,2.0
1350,7,1350,1.75,0,0,0,2,0,1.0
4210,9,3280,3.75,0,0,930,6,0,2.0
1320,7,1320,1.75,0,0,0,3,0,1.0
1530,7,1180,1.75,0,0,350,3,0,1.0
1800,7,1000,2.0,0,0,800,4,0,1.0
3140,10,3140,2.5,0,0,0,4,0,2.0
2230,8,2230,2.5,0,0,0,4,0,2.0
2910,9,2910,2.5,0,0,0,4,0,2.0
1710,7,1010,1.75,0,0,700,4,0,1.0
3740,9,2760,3.5,0,0,980,5,0,2.0
4170,10,4170,3.75,0,2,0,5,0,2.0
990,7,840,1.0,0,0,150,3,0,1.0
6563,10,5153,3.5,0,0,1410,6,0,2.0
3290,9,3290,3.0,0,0,0,4,0,2.0
2344,7,1544,1.75,0,0,800,5,0,1.5
1900,7,1900,2.75,0,0,0,3,0,2.0
940,7,940,1.0,0,0,0,3,0,1.0
3560,11,3560,2.5,0,0,0,4,0,2.0
1890,8,1890,1.5,0,0,0,4,0,1.0
2930,9,2930,2.5,0,0,0,4,0,2.0
1690,8,1690,1.75,0,0,0,3,0,1.0
3860,8,2930,2.5,0,0,930,4,0,2.0
2230,8,1150,3.0,0,0,1080,5,0,1.0
1880,7,1120,1.0,0,0,760,4,0,1.0
1180,7,1180,1.5,0,0,0,3,0,1.0
4190,9,3490,3.0,1,2,700,4,0,2.5
3850,10,3000,4.5,1,2,850,4,0,2.0
1450,8,1450,2.25,0,0,0,3,0,3.0
3180,8,2530,4.0,0,0,650,4,0,2.0
2170,8,2170,2.5,0,0,0,5,0,2.0
1680,7,1680,1.75,0,0,0,5,0,1.0
1830,7,1830,2.25,0,0,0,4,0,2.0
4890,13,4890,3.25,0,0,0,4,0,2.0
1940,7,1240,2.25,1,0,700,3,0,1.0
2040,7,1120,1.75,0,0,920,3,0,1.0
1600,7,1600,2.5,0,0,0,3,0,2.0
1240,7,1050,1.5,0,0,190,2,0,2.0
1950,7,1950,2.5,0,0,0,3,0,2.0
2440,7,1640,2.75,0,2,800,4,0,1.5
1950,8,1950,1.5,0,0,0,3,0,1.0
2020,9,2020,1.75,1,0,0,3,0,1.0
2720,8,1800,3.0,0,0,920,4,0,2.0
4130,10,2860,4.0,0,4,1270,4,1,2.0
4060,10,4060,3.25,0,0,0,4,0,2.0
670,6,670,1.0,0,0,0,1,0,1.0
2310,8,2310,2.25,0,0,0,4,0,2.0
4130,10,4130,3.5,0,2,0,4,0,2.0
3900,10,2520,3.0,1,4,1380,4,0,1.0
1850,8,1850,2.5,0,0,0,4,0,2.0
1410,7,1410,1.0,0,0,0,2,0,1.0
1509,8,1509,2.5,0,0,0,3,0,3.0
1050,6,1050,1.75,0,2,0,2,0,1.5
2590,9,2590,2.75,0,0,0,3,0,2.0
2130,8,1370,1.75,0,0,760,3,0,1.0
3120,8,1660,1.5,0,3,1460,4,0,1.0
1220,7,1220,1.0,1,0,0,3,0,1.0
2120,7,2120,2.5,0,0,0,3,0,2.0
1600,7,1600,1.0,0,0,0,4,0,1.5
2420,9,2420,2.5,1,0,0,4,0,2.0
3460,10,2830,4.0,0,0,630,5,0,2.0
2500,9,1560,1.75,1,0,940,5,0,1.0
1410,7,1410,1.0,0,0,0,3,0,1.0
1120,6,1120,1.0,0,0,0,2,0,1.0
2140,8,2140,2.5,0,0,0,3,0,2.0
2720,10,2160,2.5,0,3,560,2,0,1.0
2240,7,1480,1.5,0,0,760,3,0,1.5
2470,7,2470,2.5,0,0,0,3,0,2.0
2960,8,1790,3.0,0,0,1170,6,0,1.0
2100,8,2100,2.5,0,0,0,4,0,2.0
4120,10,4120,2.5,0,0,0,4,0,2.0
2130,7,1730,2.5,0,0,400,4,0,1.5
1620,7,1040,1.75,0,0,580,33,0,1.0
930,7,930,1.0,0,2,0,2,0,1.0
1920,8,1920,2.5,0,0,0,4,0,2.0
2650,8,2650,2.75,0,0,0,4,0,2.0
1360,7,1360,1.5,0,0,0,3,0,1.0
2050,8,1300,1.75,1,0,750,3,0,1.5
3100,9,3100,2.5,0,0,0,3,0,2.0
1740,7,1740,2.25,0,0,0,3,0,1.0
2700,9,2700,2.5,0,3,0,3,0,2.0
1470,7,770,1.0,0,0,700,2,0,1.0
1360,8,1360,2.25,0,0,0,2,0,3.0
3810,10,3810,4.5,0,4,0,6,0,1.0
1730,7,1250,1.5,0,0,480,3,0,1.0
2480,8,2480,2.25,0,0,0,3,0,2.0
2120,7,1060,2.0,0,0,1060,4,0,1.0
1660,7,1010,2.0,0,0,650,3,0,1.0
2400,7,2400,2.5,0,0,0,5,0,2.0
1490,8,1490,2.0,0,0,0,3,0,3.0
2483,8,2483,3.0,0,0,0,4,0,2.0
2240,7,2240,3.0,0,0,0,4,0,2.0
4610,10,2500,3.75,0,0,2110,4,0,1.0
2960,9,2960,3.0,1,0,0,5,0,2.0
2580,8,1290,3.5,0,0,1290,6,0,1.0
2140,8,2140,1.5,0,0,0,6,0,1.5
2530,9,1570,2.25,1,0,960,4,0,1.0
2290,8,2290,2.25,1,0,0,3,0,2.0
2420,7,1420,2.5,0,2,1000,6,0,1.0
4130,10,4130,4.5,0,0,0,5,0,2.0
2223,8,2223,2.5,0,0,0,4,0,2.0
960,6,960,1.0,0,0,0,3,0,1.0
1410,7,1410,1.5,0,0,0,3,0,1.0
1450,7,1450,2.0,0,0,0,3,0,1.5
2620,10,2620,3.0,0,0,0,5,0,2.0
2570,8,1480,2.5,0,0,1090,3,0,1.0
1270,7,1270,1.75,0,0,0,3,0,1.0
2400,7,1250,2.25,0,0,1150,3,0,1.5
1370,7,1370,2.25,0,0,0,3,0,2.0
2930,9,2930,2.5,0,0,0,4,0,2.0
1190,8,1190,1.5,0,0,0,2,0,2.0
3710,10,2910,3.75,0,0,800,3,0,2.0
1250,7,1250,1.0,0,0,0,3,0,1.0
3140,8,1670,1.75,0,0,1470,3,0,1.0
2090,9,2090,2.5,0,0,0,3,0,2.0
1530,7,1030,2.5,0,0,500,3,0,1.0
1680,7,1680,1.5,1,0,0,6,0,1.5
2120,7,2120,2.25,0,0,0,3,0,2.0
1600,7,1600,2.0,0,0,0,4,0,1.0
1890,8,1890,1.75,0,3,0,3,0,1.0
1450,7,850,1.0,0,0,600,2,0,1.0
2154,9,2154,2.5,0,0,0,4,0,2.0
2830,7,1840,3.5,0,0,990,4,0,1.5
1470,8,1470,1.0,0,0,0,2,0,1.5
2910,8,2910,2.75,0,0,0,5,0,2.0
2140,7,1550,2.25,0,0,590,4,0,1.0
3420,9,3420,2.5,0,0,0,4,0,2.0
1930,8,1930,1.5,0,0,0,2,0,2.0
2850,9,2850,2.5,0,0,0,4,0,2.0
1560,5,780,2.5,0,0,780,2,0,1.0
1230,7,1230,1.0,0,0,0,4,0,1.5
3830,9,3830,3.25,0,0,0,4,0,2.0
3190,10,3190,3.75,0,4,0,4,1,2.0
1460,8,1180,2.5,0,0,280,3,0,2.0
1360,8,1040,3.5,0,0,320,3,0,2.0
3840,10,3840,4.25,0,0,0,3,0,2.0
1770,8,1270,1.75,0,0,500,3,0,1.0
1290,6,1050,1.0,0,0,240,4,0,1.0
4140,10,3160,3.5,0,0,980,4,0,2.0
3390,8,2440,4.5,0,0,950,6,0,2.0
2210,8,1560,1.75,1,1,650,3,0,1.0
790,6,790,1.0,0,0,0,2,0,1.0
2400,8,1560,2.5,0,2,840,3,0,1.0
1960,7,1960,2.5,0,0,0,3,0,2.0
1180,7,1180,1.0,0,0,0,3,0,1.0
2150,7,1260,1.0,0,0,890,2,0,1.5
2820,9,2820,2.5,0,0,0,4,0,2.0
1230,6,1230,2.0,0,0,0,3,0,1.5
3080,9,3080,2.75,0,0,0,5,0,2.0
1610,7,1610,2.5,0,0,0,3,0,2.0
1980,7,1980,1.0,0,0,0,4,0,1.5
1600,7,1600,1.0,0,0,0,2,0,1.0
1440,6,1440,2.0,0,0,0,4,0,1.0
1340,7,890,1.0,0,0,450,2,0,1.0
1120,6,920,1.0,0,0,200,3,0,1.0
1500,7,1500,1.5,0,0,0,3,0,1.0
2330,8,1330,1.75,0,1,1000,5,0,1.0
4190,9,2040,2.75,0,0,2150,4,0,1.0
2520,9,2520,2.5,0,0,0,4,0,2.0
3410,8,1710,2.75,0,4,1700,4,0,1.0
1690,7,1690,2.5,0,0,0,3,0,2.0
828,6,828,1.0,0,0,0,2,0,1.0
2130,8,1430,1.75,0,0,700,3,0,1.0
2800,7,1560,2.5,0,2,1240,4,0,1.0
820,7,820,1.0,0,0,0,2,0,1.0
780,6,780,1.0,0,0,0,2,0,1.0
2200,8,1740,3.25,0,0,460,3,0,2.0
820,6,820,1.0,0,2,0,2,0,1.0
2520,10,2520,2.5,0,0,0,3,0,2.0
2450,8,2450,2.25,0,0,0,5,0,2.0
1740,7,1740,1.75,0,0,0,3,0,1.0
3400,9,3400,3.0,0,0,0,4,0,2.0
4150,10,4150,4.25,0,0,0,5,0,2.0
1180,6,1180,1.0,0,0,0,3,0,1.5
3510,9,2600,3.5,0,0,910,4,0,2.0
1540,7,1300,2.5,0,0,240,3,0,2.0
2370,8,2370,2.5,0,0,0,3,0,2.0
1450,7,1450,2.0,0,0,0,3,0,1.0
1880,7,1880,1.75,0,0,0,5,0,1.0
2750,8,2130,2.0,0,0,620,4,0,2.0
2840,9,2840,2.5,0,0,0,3,0,2.0
2440,8,2440,2.5,0,0,0,4,0,2.0
2820,8,1620,3.5,0,0,1200,6,0,1.0
2400,9,2400,1.75,0,0,0,3,0,1.0
1380,7,1380,2.0,0,0,0,3,0,1.0
980,6,980,1.0,0,0,0,2,0,1.0
1780,7,1050,1.75,0,0,730,4,0,1.0
1860,7,1140,1.5,0,0,720,3,0,1.0
1280,7,1280,1.5,0,0,0,3,0,3.0
990,7,990,1.0,0,0,0,2,0,1.0
1400,7,1400,1.0,0,0,0,3,0,1.0
2210,8,1270,2.25,0,0,940,4,0,1.0
1280,7,1280,1.0,0,0,0,3,0,1.0
2270,7,1920,2.0,0,0,350,3,0,1.0
2990,9,1740,2.5,0,2,1250,4,0,1.0
1770,7,1240,1.5,0,0,530,4,0,1.5
2980,8,1690,2.5,1,0,1290,4,0,1.0
1000,6,1000,1.0,0,0,0,2,0,1.0
970,6,970,1.0,0,0,0,2,0,1.0
1840,7,1840,2.0,0,0,0,3,0,2.0
1400,7,1000,2.75,0,0,400,3,0,1.0
1330,6,1330,1.0,0,0,0,2,0,1.5
2360,9,2360,2.5,0,3,0,3,0,2.0
1290,7,1290,1.0,0,0,0,3,0,1.5
2250,8,2250,2.5,0,0,0,4,0,2.0
1350,8,1270,2.5,0,0,80,3,0,3.0
2570,7,1970,2.0,0,0,600,6,0,1.5
3200,8,1610,2.5,0,0,1590,4,0,1.0
1300,8,1300,2.5,0,0,0,3,0,3.0
2500,9,2500,2.25,0,0,0,4,0,2.0
4300,11,4300,4.5,1,0,0,4,0,2.0
2010,7,2010,2.25,0,0,0,3,0,1.5
2040,8,1490,3.0,0,0,550,4,0,1.0
820,6,820,1.0,0,0,0,2,0,1.0
1540,8,1540,1.5,0,0,0,3,0,2.0
2360,8,2360,2.0,0,0,0,3,0,2.0
2010,8,1510,2.0,0,0,500,3,0,2.0
2410,8,2410,1.75,0,0,0,4,0,1.5
1490,7,1490,2.25,0,0,0,3,0,2.0
1870,8,1170,2.25,0,0,700,5,0,1.0
1150,7,1150,2.0,0,0,0,3,0,1.5
3050,8,3050,2.75,0,0,0,4,0,2.0
1340,7,1340,1.5,0,0,0,3,0,1.0
1540,8,1540,2.5,0,0,0,4,0,2.0
2360,7,1340,2.5,0,0,1020,3,0,1.0
3440,9,3440,2.5,0,0,0,4,0,2.0
1740,7,1740,2.5,0,0,0,4,0,1.0
960,7,960,1.0,0,0,0,3,0,1.0
1200,7,1200,1.0,0,0,0,3,0,1.0
2760,9,2760,2.5,0,0,0,3,0,2.0
2570,8,1580,2.5,0,0,990,4,0,1.5
1230,8,1020,2.25,1,0,210,2,0,2.0
1580,6,790,1.75,0,0,790,4,0,1.0
3610,10,2440,3.25,0,0,1170,3,0,2.0
3560,10,3560,2.75,1,0,0,4,0,2.0
960,6,960,1.0,0,0,0,3,0,1.0
1650,8,1350,3.0,0,0,300,2,0,3.0
1560,7,1560,1.0,0,0,0,3,0,1.5
1080,7,1080,1.0,0,0,0,1,0,1.5
2100,7,1050,2.25,0,0,1050,5,0,1.0
1430,7,1430,2.5,1,0,0,3,0,1.0
3090,9,2060,3.5,1,0,1030,5,0,2.0
1960,7,980,1.75,0,0,980,2,0,1.0
1700,7,1700,2.0,0,0,0,3,0,1.0
1320,7,1320,1.5,1,0,0,4,0,1.0
1380,7,1380,1.75,0,0,0,3,0,1.0
750,5,750,1.0,0,0,0,2,0,1.0
2310,9,1560,2.0,0,1,750,3,0,2.0
2530,8,2530,2.75,0,0,0,4,0,2.0
1170,7,880,0.75,0,0,290,1,0,1.0
950,5,950,1.0,0,0,0,2,0,1.0
2220,7,1270,1.75,0,0,950,3,0,1.0
2890,8,2090,1.5,0,4,800,4,0,2.0
3490,8,1890,3.25,1,0,1600,5,0,1.0
2190,8,2190,2.25,0,1,0,3,0,1.5
2420,10,1840,3.25,0,2,580,3,0,2.0
1790,7,1790,1.5,0,1,0,3,0,1.5
2910,10,1940,2.5,0,1,970,4,0,2.0
1230,7,1230,1.5,0,0,0,3,0,1.0
840,6,840,1.0,0,0,0,2,0,1.0
2200,8,2200,2.25,0,0,0,3,0,2.0
2480,7,1380,1.5,0,0,1100,4,0,1.0
1380,7,1380,2.0,0,0,0,4,0,1.5
1530,7,1530,1.0,0,0,0,3,0,1.0
2590,7,2000,1.0,0,0,590,4,0,1.5
3040,9,2080,2.25,0,3,960,4,0,2.0
3170,9,1910,2.5,0,0,1260,4,0,1.0
3170,8,3170,2.5,0,0,0,4,0,2.0
2630,8,1650,2.75,0,0,980,6,0,1.0
1140,7,840,1.5,0,0,300,3,0,1.0
1660,8,1660,2.25,0,0,0,3,0,1.0
2180,7,2180,3.25,0,0,0,5,0,2.0
1520,7,1520,2.0,0,0,0,2,0,3.0
1350,6,680,2.0,0,0,670,3,0,1.0
2750,8,2750,2.5,0,0,0,4,0,2.0
1520,7,1520,2.5,0,0,0,3,0,2.0
2140,8,2140,2.25,0,0,0,3,0,2.0
2040,8,1840,2.5,0,0,200,3,0,1.0
1500,7,1420,1.5,0,0,80,4,0,2.0
1580,7,870,2.0,0,0,710,3,0,1.0
2000,8,1400,1.75,0,0,600,3,0,1.0
3580,9,3240,2.5,0,0,340,3,0,1.0
1700,7,1500,2.0,0,0,200,3,0,1.5
950,6,950,1.0,0,0,0,2,0,1.0
1880,7,1880,1.75,0,0,0,4,0,1.0
1910,7,1910,1.75,0,0,0,4,0,1.0
2450,7,2450,2.5,0,0,0,4,0,2.0
1630,7,1060,1.75,0,0,570,3,0,1.0
1930,8,1930,2.0,0,0,0,2,0,1.0
2120,6,1080,2.0,0,0,1040,5,0,1.0
770,6,770,1.0,0,0,0,2,0,1.0
2080,8,1390,2.25,0,0,690,4,0,1.0
2380,8,2380,2.5,0,0,0,3,0,2.0
1630,7,1630,1.5,0,0,0,3,0,1.0
1260,7,1260,2.0,0,0,0,3,0,1.0
4130,11,4130,3.25,0,0,0,4,0,2.0
1936,8,1936,2.25,0,0,0,3,0,1.0
2400,8,2400,2.5,0,0,0,4,0,2.0
2530,7,1800,1.75,0,0,730,3,0,1.0
1240,7,1240,1.0,0,0,0,3,0,1.0
2190,8,1410,2.25,1,0,780,4,0,2.0
1910,6,1110,2.0,0,0,800,5,0,1.0
610,5,610,1.0,0,0,0,1,0,1.0
2060,8,1010,2.5,0,0,1050,3,0,2.0
2040,7,1340,1.5,0,0,700,3,0,1.0
1200,7,1200,1.0,0,0,0,3,0,1.0
1500,7,1500,2.0,0,0,0,3,0,1.0
2340,8,2340,2.5,0,0,0,3,0,2.0
3080,11,2530,3.5,0,3,550,3,0,2.0
2490,7,1390,2.5,0,0,1100,4,0,1.0
1580,7,1580,2.25,0,0,0,3,0,1.0
750,7,750,2.0,0,2,0,2,0,1.5
2070,7,2070,2.5,0,0,0,4,0,2.0
990,7,790,1.0,0,2,200,2,0,1.0
3900,8,2620,3.0,0,1,1280,5,0,1.5
3230,8,2430,2.5,0,2,800,3,0,2.0
1040,7,1040,1.0,0,0,0,2,0,1.0
2800,8,1400,2.5,0,0,1400,5,0,1.0
1960,7,1960,1.0,0,0,0,4,0,2.0
810,6,810,1.0,0,0,0,2,0,1.0
2660,9,1870,2.5,0,3,790,3,0,3.0
1780,8,1780,2.5,0,0,0,4,0,1.0
2920,9,2920,2.5,0,0,0,4,0,2.0
1760,9,1760,2.25,0,0,0,3,0,3.0
2880,8,2880,2.75,0,0,0,5,0,2.0
3180,10,2420,3.5,0,0,760,5,0,2.0
3910,11,3910,3.0,0,0,0,3,0,2.0
1820,8,1430,3.5,0,0,390,3,0,2.0
3670,8,1980,3.0,0,1,1690,5,0,1.0
2270,7,1150,2.0,0,0,1120,5,0,1.0
1890,7,1890,2.5,0,0,0,4,0,2.0
900,6,900,1.0,0,0,0,2,0,1.0
1200,7,1200,2.0,0,0,0,3,0,1.0
2240,8,2240,2.25,0,0,0,4,0,2.0
2040,8,2040,1.5,0,2,0,3,0,2.0
1750,8,1750,1.5,0,0,0,2,0,2.0
2714,9,2714,2.5,0,0,0,3,0,2.0
3020,8,3020,1.75,0,0,0,3,0,2.0
2370,8,1610,3.5,0,0,760,4,0,2.0
2490,8,1460,2.25,0,0,1030,4,0,1.0
1940,7,1090,2.0,0,3,850,3,0,1.0
1910,8,1280,2.25,0,0,630,4,0,1.0
1400,7,1040,1.75,0,0,360,3,0,1.0
2000,7,2000,2.25,0,0,0,3,0,2.0
4700,10,2930,3.75,1,0,1770,5,0,2.0
1690,5,1690,1.5,0,0,0,4,0,1.0
1440,7,1440,2.25,0,0,0,3,0,2.0
1380,7,1080,1.5,0,0,300,3,0,1.0
1620,6,1620,1.75,0,0,0,3,0,1.5
1370,7,1370,1.0,0,0,0,3,0,1.0
1320,7,1320,1.0,0,0,0,2,0,1.0
3130,9,3130,2.5,0,0,0,4,0,2.0
840,6,840,1.0,0,0,0,3,0,1.0
1310,7,1060,2.25,0,0,250,3,0,2.0
2300,7,2300,1.75,0,4,0,4,1,1.5
2290,7,1190,2.0,0,0,1100,5,0,1.0
2950,8,2950,2.75,0,0,0,4,0,1.0
680,5,680,1.0,0,0,0,1,0,1.0
840,7,840,1.0,0,0,0,2,0,1.5
1600,7,1080,2.25,0,0,520,4,0,1.0
1680,7,1180,1.75,0,0,500,3,0,1.0
880,5,880,1.0,0,0,0,2,0,1.0
2480,7,1510,2.5,0,0,970,4,0,1.0
1050,7,1050,1.0,0,0,0,3,0,1.0
1950,8,1520,1.75,0,0,430,3,0,1.0
1860,7,1090,1.75,0,0,770,4,0,1.0
2360,7,1180,1.75,0,0,1180,5,0,1.0
1800,7,1300,2.25,0,0,500,3,0,1.0
1840,8,1270,1.75,0,0,570,3,0,1.0
2760,8,2000,3.5,0,2,760,4,0,2.0
2050,8,2050,2.0,0,0,0,3,0,1.0
1530,7,1100,1.75,0,0,430,3,0,1.0
2620,7,2620,2.5,0,0,0,3,0,2.0
1340,7,1340,1.5,0,0,0,3,0,1.0
1150,7,1150,1.0,0,0,0,3,0,1.0
1600,7,1600,1.75,0,0,0,3,0,1.0
1310,8,1310,2.25,0,0,0,3,0,3.0
2750,7,1870,2.25,0,0,880,3,0,2.0
1420,7,1420,1.0,0,0,0,2,0,2.0
1020,6,1020,1.0,0,0,0,2,0,1.0
2140,7,2140,2.25,0,0,0,4,0,2.0
1240,7,1150,2.25,0,0,90,2,0,2.0
1480,7,1080,1.0,0,0,400,2,0,1.0
3360,7,1820,2.75,0,0,1540,3,0,1.0
2080,7,2080,1.75,0,0,0,4,0,2.0
2320,7,1200,3.0,0,0,1120,6,0,1.0
1880,7,940,1.75,0,0,940,3,0,1.0
2930,9,2930,2.5,0,0,0,4,0,2.0
2090,8,2090,2.5,0,0,0,3,0,2.0
1010,7,1010,2.0,0,0,0,3,0,1.5
1980,7,990,1.75,0,0,990,2,0,1.0
870,6,870,1.0,0,0,0,2,0,1.0
2960,8,1480,1.75,0,2,1480,3,0,1.0
2160,8,2160,2.25,0,0,0,2,0,3.0
1710,7,1100,1.0,0,0,610,3,0,1.0
1710,6,1710,1.0,0,0,0,4,0,1.5
3070,10,2190,3.5,0,0,880,4,0,2.0
2090,9,2090,2.5,0,0,0,3,0,1.5
1780,8,1080,2.5,0,0,700,3,0,2.0
4490,10,3200,3.5,0,0,1290,5,0,2.0
560,6,560,1.0,0,0,0,2,0,1.0
3420,10,2410,2.5,1,4,1010,3,0,1.0
1210,6,860,1.0,0,0,350,2,0,1.0
3420,8,1770,1.75,0,3,1650,4,0,1.0
1200,6,1200,1.0,0,0,0,3,0,1.0
1980,7,1300,2.25,0,0,680,3,0,1.0
2820,9,2820,2.5,0,0,0,4,0,2.0
2390,8,2390,2.5,0,0,0,2,0,1.0
2040,8,2040,2.5,0,0,0,3,0,2.0
2280,7,1340,2.0,0,0,940,5,0,1.5
1510,7,1510,1.75,0,0,0,3,0,1.5
3180,8,1910,2.0,0,0,1270,5,0,1.0
3020,8,1650,2.5,0,0,1370,5,0,1.0
2370,7,2370,2.75,0,0,0,4,0,2.0
980,7,980,1.0,0,0,0,3,0,1.0
2690,8,2690,4.0,1,0,0,7,0,1.0
1710,8,1290,3.5,0,0,420,3,0,2.0
1800,7,1800,2.5,0,0,0,3,0,2.0
3740,10,3740,3.25,0,0,0,4,0,2.0
2400,7,1250,1.75,0,0,1150,4,0,1.0
1720,6,860,1.75,0,0,860,2,0,1.0
1220,7,1220,1.5,0,0,0,3,0,1.0
2610,7,1310,2.0,0,0,1300,3,0,1.0
3110,8,3110,3.5,0,0,0,4,0,2.0
930,7,930,2.0,0,0,0,3,0,1.0
1170,7,1170,1.5,0,0,0,3,0,1.0
1480,7,740,2.0,0,0,740,2,0,1.0
3400,10,3190,2.5,0,0,210,4,0,2.0
2890,9,2890,2.25,0,0,0,3,0,3.0
2940,8,1850,2.5,0,0,1090,4,0,1.0
4680,10,3040,3.5,1,0,1640,4,0,2.0
2160,8,2160,2.5,0,0,0,3,0,2.0
1350,7,1350,1.0,0,2,0,2,0,1.0
1090,7,730,1.0,0,0,360,2,0,1.0
900,7,900,1.0,0,0,0,2,0,1.0
1580,7,960,1.5,0,0,620,4,0,1.0
1190,7,1190,1.0,0,0,0,3,0,1.0
1810,7,1810,2.25,0,0,0,3,0,2.0
1660,7,1660,2.5,0,0,0,4,0,2.0
2190,8,2190,2.5,0,0,0,3,0,2.0
1210,6,780,1.0,0,0,430,2,0,1.0
2190,9,2190,2.5,0,0,0,3,0,2.0
3680,9,3680,2.5,1,2,0,4,0,2.0
2150,7,1370,3.0,0,0,780,5,0,1.0
1840,7,1270,1.75,0,0,570,3,0,2.0
1010,6,1010,1.0,0,0,0,3,0,1.0
2610,6,1690,2.0,0,0,920,4,0,1.5
3920,10,2240,3.5,1,1,1680,4,0,1.0
3490,9,2242,2.5,0,2,1248,3,0,1.5
1480,8,1150,2.5,0,0,330,3,0,2.0
2330,8,2330,2.5,0,0,0,3,0,2.0
1230,6,1230,1.0,0,0,0,3,0,1.5
1690,7,1690,2.5,0,0,0,3,0,2.0
3000,8,3000,3.0,0,0,0,4,0,2.0
2320,6,2320,1.0,0,0,0,2,0,2.0
3100,9,1660,2.75,1,2,1440,5,0,1.0
3020,8,3020,2.5,0,0,0,3,0,2.0
1010,7,1010,1.0,0,0,0,2,0,1.0
2010,7,2010,2.0,0,0,0,4,0,1.0
1200,7,1200,1.5,0,0,0,4,0,1.0
1620,8,1540,2.25,0,0,80,3,0,2.5
690,6,690,1.0,0,0,0,1,0,1.0
2590,8,2310,1.0,0,0,280,5,0,2.0
2080,8,2080,2.5,0,0,0,3,0,2.0
2390,7,2390,3.0,0,0,0,4,0,2.0
4330,11,4330,3.25,0,0,0,4,0,2.0
1300,8,1080,3.25,0,0,220,3,0,2.0
780,5,780,1.0,0,0,0,2,0,1.0
1000,8,1000,2.25,0,0,0,2,0,3.0
1500,7,1500,1.75,0,0,0,3,0,1.0
2100,7,1230,1.75,0,0,870,3,0,1.0
1850,7,1250,2.5,0,0,600,3,0,1.0
1570,7,1070,2.25,1,0,500,3,0,1.0
1490,7,860,1.0,0,0,630,2,0,1.0
1870,7,1870,2.25,0,0,0,4,0,2.0
1540,8,1540,2.5,0,0,0,3,0,3.0
2830,8,2830,2.5,0,0,0,4,0,2.0
2160,8,1660,1.75,0,0,500,4,0,1.0
1450,6,1450,1.0,0,0,0,4,0,1.5
3440,11,3440,3.25,0,0,0,4,0,2.0
1950,7,1950,2.5,0,0,0,3,0,2.0
2200,8,1220,2.25,0,2,980,4,0,1.0
1900,7,1280,2.25,0,0,620,3,0,1.0
1560,7,1560,2.25,0,0,0,3,0,2.0
1060,7,1060,1.0,0,0,0,3,0,1.0
2110,8,1410,2.5,0,0,700,3,0,2.0
1650,8,1650,2.5,0,2,0,2,0,2.0
1110,6,1110,1.0,0,0,0,1,0,1.0
780,7,780,1.0,0,0,0,2,0,1.0
930,6,930,1.0,0,0,0,3,0,1.5
2070,7,1180,2.0,0,1,890,4,0,1.0
1757,7,1757,2.0,0,2,0,4,0,1.0
1820,7,1820,2.0,0,0,0,3,0,1.0
1140,6,1140,1.0,0,0,0,2,0,1.0
1040,7,1040,1.0,0,0,0,2,0,1.0
2450,8,1580,3.0,1,0,870,4,0,1.0
2480,9,2480,2.5,0,0,0,3,0,2.0
1060,7,1060,1.0,0,0,0,3,0,1.0
2560,8,2560,2.5,0,0,0,5,0,2.0
2544,9,2544,2.5,0,0,0,4,0,2.0
920,6,490,1.0,0,0,430,2,0,1.0
1150,7,1150,1.75,0,0,0,3,0,1.0
2420,10,2420,2.5,0,0,0,4,0,2.0
3010,8,3010,2.5,0,2,0,4,0,2.5
1640,6,1240,2.25,0,0,400,3,0,2.0
3540,8,2940,4.5,0,0,600,5,0,2.0
2290,7,1490,2.0,0,0,800,3,0,1.0
1700,7,1700,1.0,1,0,0,5,0,1.5
2480,8,1520,1.5,0,0,960,4,0,1.0
2630,9,2630,2.5,0,0,0,4,0,2.0
1140,7,1140,1.0,0,0,0,3,0,1.0
2260,9,2260,1.75,1,1,0,4,0,1.0
1780,8,1350,2.5,0,0,430,2,0,3.0
4750,10,3600,4.5,0,2,1150,4,0,2.0
3550,9,2550,3.5,0,0,1000,5,0,2.0
3190,8,3190,2.5,0,0,0,6,0,2.0
1980,8,1700,2.0,0,3,280,4,0,2.0
1220,6,770,1.0,0,0,450,2,0,1.0
2120,7,2120,2.25,0,0,0,3,0,2.0
2110,10,2110,2.0,0,0,0,3,0,1.0
3780,10,3780,3.5,0,2,0,4,0,2.0
1290,8,1290,2.25,0,0,0,2,0,3.0
1540,7,770,2.25,0,0,770,3,0,1.0
1800,7,1800,1.75,0,0,0,3,0,2.0
1840,7,1050,1.75,0,0,790,3,0,1.0
2510,8,2510,1.5,1,0,0,3,0,2.5
1370,8,1080,1.5,0,0,290,2,0,2.0
2270,9,1820,2.25,0,0,450,3,0,1.0
1670,7,1030,1.0,0,0,640,3,0,1.0
2550,9,1610,2.5,1,0,940,5,0,1.0
1850,8,1850,2.5,0,0,0,4,0,2.0
1760,7,1760,2.0,1,0,0,3,0,1.0
3240,8,2760,3.5,0,0,480,5,0,2.0
670,6,670,1.0,0,0,0,2,0,1.0
720,5,720,1.0,0,0,0,2,0,1.0
2009,8,2009,2.5,0,0,0,4,0,2.0
830,7,830,1.5,0,0,0,2,0,2.0
2280,8,2280,2.5,0,0,0,4,0,2.0
4250,9,3260,2.5,1,2,990,4,0,2.0
2100,9,1450,3.5,0,0,650,3,0,2.0
1810,7,1810,3.0,0,0,0,5,0,2.0
3440,10,3440,2.25,1,2,0,3,0,2.0
1780,6,1780,1.0,0,0,0,3,0,2.0
3250,8,3250,2.5,0,0,0,4,0,2.0
1980,7,1980,2.5,0,0,0,3,0,2.0
2540,8,1450,2.25,0,0,1090,4,0,1.0
1330,7,1330,1.0,1,0,0,3,0,1.0
2650,8,2250,2.5,0,0,400,4,0,2.0
2590,8,2590,2.5,0,0,0,4,0,2.0
3310,9,2910,3.0,0,0,400,4,0,2.5
1010,7,1010,1.0,0,0,0,3,0,1.0
1870,7,1870,2.5,0,0,0,3,0,2.0
2700,8,1450,1.75,0,0,1250,4,0,1.0
1930,7,1130,1.75,0,0,800,3,0,1.0
2500,10,2500,2.5,1,0,0,4,0,2.0
1048,7,1048,1.5,0,0,0,1,0,1.0
1830,7,1430,1.75,0,0,400,3,0,1.0
2030,8,2030,2.25,0,0,0,4,0,2.0
1230,7,1130,1.0,0,0,100,2,0,1.0
1820,7,1820,1.75,0,0,0,4,0,1.0
3690,11,3690,3.25,1,0,0,3,0,2.0
2300,8,2300,3.5,0,0,0,3,0,1.0
530,4,530,0.75,0,2,0,1,0,1.0
1600,6,1600,1.75,0,0,0,3,0,1.0
1700,7,1180,1.75,0,0,520,3,0,1.0
2030,8,1600,1.75,0,0,430,3,0,1.0
4060,10,4060,3.75,0,0,0,4,0,2.0
1520,7,1520,3.25,0,0,0,3,0,3.0
2390,7,2390,2.5,0,0,0,4,0,2.0
1050,6,1050,1.0,0,3,0,2,0,1.0
3230,10,3230,3.25,0,3,0,3,0,2.0
1760,8,1760,2.5,0,0,0,3,0,2.0
1680,7,1680,2.0,0,0,0,3,0,2.0
2200,9,1530,2.5,0,0,670,3,0,2.0
1520,8,1520,3.0,0,0,0,3,0,3.0
1980,8,1980,2.25,0,0,0,3,0,1.0
2170,7,2170,2.5,0,0,0,4,0,1.0
1920,8,1200,2.25,0,0,720,4,0,1.0
870,6,870,1.0,0,0,0,3,0,1.0
1450,7,1010,1.5,0,0,440,3,0,1.0
2980,8,1800,2.75,0,0,1180,4,0,1.0
1940,9,1940,2.0,0,0,0,3,0,1.0
980,7,980,1.0,0,0,0,3,0,1.0
1510,7,1510,1.0,0,0,0,3,0,1.5
1000,6,1000,1.5,0,0,0,3,0,1.0
2890,7,2290,3.0,0,0,600,6,0,2.5
770,6,770,1.0,0,0,0,2,0,1.0
1500,8,1120,3.0,0,0,380,3,0,2.0
920,6,920,1.0,0,0,0,2,0,1.0
1490,7,1490,1.5,0,0,0,3,0,1.5
720,6,720,1.0,0,0,0,1,0,1.0
3780,10,3780,2.5,1,0,0,4,0,2.0
4420,9,3420,3.75,0,1,1000,4,0,2.0
2140,7,2140,2.5,0,0,0,3,0,2.0
2560,9,2560,2.5,0,0,0,3,0,2.0
4860,12,4860,3.5,1,0,0,4,0,2.0
2770,7,1900,2.5,0,0,870,3,0,1.0
4170,9,2940,3.5,0,0,1230,4,0,2.0
780,7,780,1.0,0,0,0,2,0,1.0
2540,7,1600,2.75,0,0,940,4,0,1.0
2150,8,2150,2.5,0,0,0,3,0,2.0
4360,11,3400,3.25,0,3,960,4,0,2.0
1440,7,1440,1.75,0,0,0,3,0,1.0
1050,6,1050,1.0,0,0,0,1,0,1.0
2020,7,1620,1.75,0,0,400,4,0,1.0
3950,10,2100,3.25,0,0,1850,5,0,1.0
2850,8,1540,2.75,0,0,1310,3,0,1.0
2660,10,2660,2.5,1,2,0,3,0,2.0
1550,8,1160,3.5,0,0,390,3,0,2.0
3670,8,2800,4.25,0,1,870,7,0,2.0
1070,7,1070,1.0,0,0,0,2,0,1.0
1240,7,1240,1.0,1,0,0,3,0,1.0
3220,9,3220,2.75,0,0,0,5,0,2.0
1590,7,1590,2.5,0,0,0,3,0,2.0
2230,7,2230,2.5,0,0,0,4,0,2.0
3160,9,2250,2.5,1,1,910,4,0,2.0
2130,8,2130,2.25,0,0,0,3,0,2.0
3290,9,3290,2.5,0,0,0,4,0,2.0
2390,7,1750,1.75,0,0,640,4,0,1.0
1120,6,750,1.0,0,1,370,2,0,1.0
1840,7,920,2.0,0,0,920,4,0,1.0
2980,8,2180,2.75,0,2,800,3,1,1.5
4740,11,4740,3.5,0,0,0,4,0,2.0
3100,9,3100,2.5,0,0,0,4,0,2.0
3040,10,3040,2.5,0,0,0,4,0,2.0
1764,7,1764,2.0,0,0,0,4,0,1.0
1520,7,1520,2.5,0,0,0,3,0,2.0
1360,6,1360,1.0,0,0,0,4,0,1.5
2420,7,1620,1.75,0,0,800,4,0,1.0
4110,12,2720,3.25,0,4,1390,4,1,2.0
1810,7,1010,1.75,0,0,800,3,0,1.0
1780,8,1780,2.0,1,0,0,3,0,1.0
1180,8,1180,2.5,0,0,0,3,0,3.0
2890,9,2890,2.5,1,0,0,4,0,2.0
3110,8,1640,2.5,1,1,1470,3,0,1.0
2470,8,2470,2.5,0,0,0,4,0,2.0
1769,7,1769,2.0,0,0,0,3,0,1.0
1800,6,900,1.75,0,0,900,3,0,1.0
1740,8,1500,1.75,0,0,240,3,0,1.0
1790,8,1790,2.0,0,0,0,3,0,1.0
1980,6,1980,2.0,0,0,0,4,0,1.5
870,6,870,1.75,0,0,0,2,0,1.0
2360,7,1390,2.75,0,0,970,4,0,1.0
2950,9,2950,2.75,0,0,0,4,0,2.0
2240,7,1840,2.5,0,0,400,4,0,2.0
1010,7,1010,1.5,0,0,0,2,0,2.0
1824,9,1824,2.0,0,0,0,3,0,1.0
1830,7,1010,1.5,0,0,820,3,0,1.0
1610,7,1080,1.5,0,0,530,3,0,1.0
960,7,960,1.0,0,0,0,3,0,1.0
2310,7,2310,2.0,1,0,0,3,0,2.0
2440,7,2440,2.5,0,0,0,4,0,1.0
3620,9,3620,3.5,0,0,0,4,0,2.5
1080,6,1080,1.0,0,0,0,3,0,1.0
880,7,880,1.5,0,0,0,2,0,2.0
1730,7,1130,1.75,0,0,600,3,0,1.0
1130,6,1130,2.0,0,0,0,3,0,2.0
4000,7,4000,4.5,0,0,0,6,0,2.0
3990,9,3990,2.75,0,0,0,4,0,2.0
1420,7,1420,2.0,0,0,0,3,0,1.5
1250,7,1250,1.0,0,0,0,2,0,1.0
2890,8,2890,2.5,0,0,0,5,0,2.0
1120,7,1120,1.0,0,0,0,2,0,1.0
2200,7,2200,3.0,0,0,0,4,0,2.0
2760,10,2760,2.75,0,0,0,4,0,2.0
4350,10,3520,3.5,0,2,830,5,0,2.0
1640,7,1440,1.0,0,0,200,3,0,1.5
1810,7,1230,1.75,0,0,580,4,0,1.0
3400,9,2470,2.75,0,2,930,3,0,2.0
1920,8,1440,1.75,0,0,480,3,0,1.0
2810,9,2810,3.0,0,0,0,4,0,2.0
1640,7,1640,1.0,0,0,0,3,0,1.5
1350,8,1350,2.0,0,0,0,2,0,1.0
2440,8,1750,2.75,0,0,690,4,0,2.0
1780,8,1780,1.5,0,0,0,3,0,1.5
2550,7,2550,3.5,0,0,0,4,0,2.0
1200,6,1200,1.0,0,0,0,4,0,1.5
2100,8,1700,2.5,0,0,400,3,0,1.0
1360,6,680,1.0,0,0,680,2,0,1.0
3830,9,3830,3.25,0,0,0,4,0,2.0
2330,8,1330,1.5,0,0,1000,3,0,1.0
1890,6,1110,1.75,0,0,780,4,0,1.0
3555,9,3555,2.75,0,0,0,4,0,2.0
1810,8,1810,1.75,0,0,0,2,0,2.0
4140,11,4140,3.5,0,0,0,4,0,2.0
3400,7,2050,1.75,0,0,1350,3,0,1.0
1130,7,1130,3.5,0,0,0,3,0,3.0
3150,8,2460,3.5,0,0,690,5,0,2.0
1800,8,1800,2.5,0,0,0,3,0,2.0
2730,7,2080,2.75,0,0,650,5,0,1.0
2430,8,2150,3.0,0,0,280,3,0,1.0
1660,7,1660,1.75,1,0,0,3,0,1.0
2100,8,2100,2.5,0,0,0,4,0,2.0
1270,7,910,1.0,0,0,360,3,0,1.0
730,6,730,1.0,0,0,0,2,0,1.0
2550,10,2550,1.5,1,0,0,4,0,2.0
1580,8,1340,3.75,0,0,240,3,0,2.0
3040,7,3040,2.5,0,0,0,4,0,2.0
2000,8,2000,2.25,0,0,0,4,0,2.0
1630,7,1110,3.0,0,0,520,4,0,1.0
2260,8,2260,2.5,0,0,0,5,0,2.0
1800,7,1300,2.25,0,0,500,3,0,1.0
1640,6,1220,1.0,0,2,420,4,0,1.0
1270,7,1270,1.75,0,0,0,2,0,1.5
2570,8,2570,2.75,0,0,0,5,0,2.0
1920,9,1920,2.5,0,0,0,3,0,2.0
1420,6,1420,1.5,0,0,0,3,0,1.0
1250,7,1250,1.0,0,0,0,3,0,1.0
2460,8,1810,2.5,0,0,650,3,0,1.0
1060,7,1060,1.0,0,0,0,3,0,1.0
1200,7,1080,1.0,0,0,120,2,0,1.0
2590,7,1340,2.0,0,0,1250,5,0,1.0
2460,8,1650,2.5,0,0,810,4,0,1.0
1410,7,1410,1.0,0,0,0,3,0,1.0
940,6,720,1.0,0,0,220,2,0,1.0
2200,8,2200,2.5,0,0,0,5,0,2.0
1510,7,1110,1.5,0,0,400,3,0,1.0
1130,7,1130,0.75,0,0,0,2,0,1.0
4140,11,4140,5.25,0,2,0,4,0,2.0
1920,7,1920,2.5,0,0,0,4,0,2.0
1610,7,1610,1.75,0,0,0,4,0,1.0
900,6,760,1.0,0,0,140,2,0,1.0
3110,7,1560,2.0,0,0,1550,5,0,1.0
1820,7,990,2.0,0,0,830,4,0,1.0
2160,8,1080,2.25,1,0,1080,4,0,1.0
1780,7,1780,2.5,0,0,0,3,0,2.0
1060,7,820,1.0,0,0,240,2,0,1.0
1120,7,1120,1.0,0,0,0,3,0,1.0
2410,7,1780,2.75,1,0,630,4,0,1.0
2230,9,2230,2.25,0,0,0,3,0,2.0
2448,9,2448,2.5,0,0,0,4,0,2.0
730,7,730,2.75,0,0,0,2,0,1.0
2700,9,1570,3.0,0,0,1130,3,0,2.0
1540,7,1540,2.0,0,3,0,3,0,1.0
2330,7,2330,1.0,0,0,0,6,0,1.5
3310,9,3310,2.75,0,0,0,4,0,2.0
2140,7,1070,1.75,0,0,1070,3,0,1.0
3320,7,2020,2.75,1,0,1300,5,0,1.0
4390,9,3350,3.5,0,0,1040,5,0,2.0
2020,8,2020,1.75,0,0,0,4,0,1.0
2200,7,2200,2.25,0,0,0,4,0,2.0
3470,11,2270,3.25,1,3,1200,4,0,1.0
6240,11,4610,4.75,1,3,1630,5,0,1.0
1200,7,1200,1.0,0,0,0,3,0,1.0
2100,7,1050,2.25,0,0,1050,4,0,1.0
1840,8,1340,1.75,0,0,500,3,0,1.0
2950,7,2950,2.5,0,0,0,4,0,2.0
2780,8,1590,2.5,0,0,1190,4,0,1.0
1530,7,1130,1.0,0,0,400,4,0,1.0
1330,7,1330,2.0,0,0,0,3,0,1.0
2040,7,1020,2.0,1,2,1020,4,0,1.0
1870,7,1580,1.0,0,0,290,3,0,1.5
3060,8,1700,2.5,0,0,1360,4,0,1.0
2840,9,1640,2.75,0,3,1200,4,0,1.0
2920,9,2920,2.5,0,0,0,3,0,2.5
2740,7,2740,2.5,0,0,0,5,0,2.0
1850,7,1850,2.5,0,0,0,4,0,2.0
3380,8,1690,2.25,0,2,1690,4,0,1.0
1790,7,1240,2.0,0,0,550,3,0,1.0
1390,7,1230,1.0,0,0,160,3,0,1.5
1090,7,790,1.75,0,0,300,2,0,1.0
990,7,990,1.0,0,0,0,3,0,1.5
2470,9,2470,2.75,0,0,0,3,0,2.0
2900,8,1450,2.25,1,0,1450,5,0,1.0
1890,8,1890,1.75,0,3,0,3,0,1.5
2260,8,2260,2.5,0,0,0,4,0,2.0
1680,7,980,2.0,0,0,700,4,0,1.0
2120,8,2120,2.5,0,0,0,3,0,2.0
1190,7,1190,1.0,0,0,0,3,0,1.0
1440,8,1440,1.75,0,0,0,2,0,1.0
1310,7,1310,1.5,0,0,0,3,0,1.0
2800,9,2800,2.5,0,0,0,3,0,2.0
1970,8,1970,2.25,0,0,0,4,0,2.0
2890,10,2830,2.75,1,3,60,3,0,2.0
2160,7,1460,2.25,0,0,700,4,0,1.0
790,6,790,1.0,0,0,0,2,0,1.0
4610,10,4610,3.5,0,0,0,4,0,2.0
1060,7,1060,1.0,0,0,0,2,0,1.0
1160,6,1160,1.75,0,0,0,3,0,1.0
1620,8,1280,1.5,0,0,340,3,0,1.0
2900,8,1450,2.5,1,0,1450,5,0,1.0
2580,9,1850,2.0,0,0,730,4,0,2.0
1210,6,1210,1.0,0,0,0,2,0,1.5
1847,7,1847,2.5,0,0,0,4,0,2.0
1070,7,1070,1.75,0,0,0,3,0,1.0
2510,8,1290,1.75,0,2,1220,4,0,1.0
2290,8,1620,1.75,0,0,670,3,0,1.0
3070,8,3070,2.5,0,0,0,4,0,2.0
2320,8,2320,2.5,0,0,0,3,0,2.0
940,6,940,1.0,0,0,0,2,0,1.0
880,7,880,1.0,0,0,0,3,0,1.0
1560,7,1560,2.5,0,0,0,3,0,2.0
1380,7,860,1.75,0,0,520,3,0,1.0
2280,7,2280,2.25,0,0,0,3,0,1.0
4200,11,4200,2.5,0,0,0,4,0,2.0
3230,7,3230,2.75,0,4,0,3,1,2.0
1980,7,1270,1.75,0,0,710,3,0,1.0
1940,7,970,2.0,0,0,970,4,0,1.0
1670,9,1250,2.25,0,0,420,3,0,2.0
940,7,940,1.0,0,0,0,2,0,1.0
1740,7,970,1.75,0,0,770,3,0,1.0
1060,7,860,1.0,0,0,200,2,0,1.0
1270,7,1080,1.5,0,0,190,3,0,2.0
1590,6,970,1.75,0,0,620,3,0,1.5
1310,8,1160,2.5,0,0,150,2,0,2.0
2110,7,2110,2.5,1,0,0,4,0,2.0
2650,10,2650,2.5,0,0,0,4,0,2.0
2150,8,2150,2.5,0,0,0,3,0,2.0
950,6,950,1.0,0,0,0,2,0,1.0
2670,9,2000,2.5,0,3,670,3,0,2.0
1980,9,1980,2.75,0,0,0,3,0,2.0
2640,7,2640,3.0,0,0,0,4,0,2.0
1470,7,1470,2.0,0,0,0,3,0,1.0
3810,9,3810,3.5,0,0,0,4,0,2.0
2450,8,1250,2.5,1,0,1200,4,0,1.0
1720,8,1720,1.75,0,0,0,3,0,1.5
2740,9,2740,2.75,0,0,0,3,0,2.0
1890,8,1890,2.75,0,0,0,3,0,2.0
1200,6,800,1.0,0,0,400,3,0,1.0
1270,7,1270,0.75,0,0,0,3,0,1.0
3170,10,2230,2.25,0,0,940,3,0,2.0
2340,8,1930,2.5,0,0,410,4,0,2.0
2050,8,2050,2.5,0,0,0,3,0,2.0
1320,8,1320,2.75,0,0,0,3,0,3.0
4850,10,3540,4.5,0,4,1310,5,1,2.0
2540,7,1630,2.75,0,0,910,4,0,1.5
2110,7,1250,1.75,0,0,860,5,0,1.5
520,6,520,0.75,0,0,0,1,0,1.0
1660,8,1660,1.75,0,0,0,3,0,1.0
1460,8,1160,2.5,0,0,300,2,0,2.0
1920,8,1540,3.0,0,0,380,4,0,1.5
2040,7,1380,1.5,0,0,660,4,0,1.0
1440,8,1440,1.75,0,2,0,2,0,1.0
1080,7,1080,1.0,0,0,0,2,0,1.0
4460,9,3330,4.0,0,4,1130,5,0,2.0
2400,9,2400,2.5,0,0,0,4,0,2.0
1600,7,1600,2.5,0,0,0,3,0,2.0
1540,6,770,1.75,1,0,770,3,0,1.0
1770,8,1770,3.25,0,0,0,3,0,3.0
780,6,780,1.0,0,0,0,2,0,1.0
2280,7,2280,2.5,0,0,0,4,0,2.0
2080,7,1080,1.75,0,0,1000,2,0,1.0
1410,7,1410,1.75,0,0,0,3,0,1.0
2130,8,2130,2.5,0,0,0,3,0,2.0
1820,9,1820,2.0,0,0,0,3,0,3.0
2350,8,2350,2.5,1,0,0,4,0,2.0
5150,10,3700,3.5,0,2,1450,5,0,2.0
1300,6,1300,1.0,0,3,0,4,0,1.0
1950,7,1150,1.75,0,0,800,3,0,1.0
3040,7,3040,2.5,0,0,0,4,0,2.0
2080,7,1450,2.25,0,0,630,4,0,1.0
2210,8,2210,2.5,0,0,0,2,0,1.0
2110,8,1170,1.75,0,0,940,4,0,1.0
1140,7,1140,2.0,0,0,0,3,0,1.0
2960,9,2960,2.5,0,0,0,4,0,2.0
1470,7,1470,1.75,0,0,0,3,0,1.0
1530,7,1530,2.0,0,0,0,4,0,2.0
2510,9,2510,2.0,0,2,0,3,0,1.0
1620,8,1620,1.75,0,0,0,3,0,1.0
2730,8,1570,1.5,0,0,1160,2,0,1.0
2140,7,1070,1.75,0,0,1070,4,0,1.0
3680,10,2890,3.0,0,2,790,4,0,2.0
1950,7,1950,2.5,0,0,0,3,0,2.0
1730,7,1010,1.75,0,0,720,5,0,1.0
1760,8,1760,3.25,0,0,0,3,0,3.0
3560,8,1860,2.5,0,0,1700,3,0,1.0
3980,10,2480,2.5,1,1,1500,4,0,1.0
1220,6,1220,2.0,0,0,0,3,0,1.0
2020,7,2020,2.5,0,0,0,3,0,2.0
2680,8,1880,1.5,0,2,800,3,0,2.0
2440,7,2440,3.5,0,0,0,5,0,2.0
1300,8,880,1.75,0,3,420,3,0,1.0
1860,8,1860,2.5,0,0,0,3,0,2.0
1440,7,1440,2.0,0,0,0,2,0,1.5
2060,7,1030,2.25,0,0,1030,5,0,1.0
1050,7,1050,1.0,0,0,0,3,0,1.0
2680,9,2680,2.5,0,0,0,4,0,2.0
2570,8,2570,2.75,0,0,0,5,0,2.0
2820,8,1410,2.5,0,1,1410,3,0,1.0
1950,7,1320,1.5,0,2,630,3,0,1.0
1380,7,1140,2.25,0,0,240,3,0,1.0
1990,9,1260,2.0,0,0,730,4,0,1.0
2170,7,1340,2.0,0,0,830,3,0,1.0
2460,8,1900,3.5,0,0,560,3,0,2.0
1150,6,990,1.0,0,0,160,3,0,1.0
740,7,740,1.0,0,0,0,1,0,1.0
1430,7,1430,1.5,0,0,0,4,0,1.5
2030,8,1720,2.5,0,0,310,3,0,2.0
920,7,920,1.0,0,0,0,2,0,1.0
1440,8,1440,2.5,0,0,0,3,0,1.0
3250,8,1650,1.75,0,2,1600,5,0,1.0
2410,8,1990,2.5,1,0,420,4,0,1.0
1010,7,1010,1.0,0,0,0,3,0,1.0
1120,7,1120,1.5,0,0,0,3,0,1.0
920,7,920,1.0,1,0,0,3,0,1.0
1740,8,1240,2.25,0,0,500,3,0,1.0
6055,12,3555,5.0,1,3,2500,4,0,1.0
2100,7,1250,3.0,0,0,850,5,0,1.0
3360,8,2640,3.75,0,0,720,5,0,2.0
3320,9,3320,2.25,0,0,0,5,0,2.0
770,6,770,1.0,0,0,0,2,0,1.0
1920,7,1230,1.75,0,0,690,3,0,1.0
3220,9,2320,2.75,0,0,900,4,0,1.5
1490,8,1490,1.75,0,0,0,3,0,1.0
2200,7,2200,2.5,0,0,0,3,0,2.0
1180,7,1180,1.5,0,0,0,3,0,1.0
4270,11,4270,2.75,1,0,0,4,0,2.0
1180,7,1180,1.0,0,0,0,3,0,1.0
1160,7,1160,1.75,0,0,0,3,0,1.0
1570,7,1190,1.75,1,0,380,3,0,1.0
1010,7,1010,1.0,0,0,0,3,0,1.0
1780,8,1780,2.25,0,0,0,3,0,1.0
2700,10,2700,3.0,0,0,0,5,0,2.0
1460,6,1460,1.0,0,0,0,4,0,1.0
2620,8,1520,2.25,0,0,1100,4,0,1.0
980,6,860,1.0,0,0,120,2,0,1.0
3655,8,2174,3.0,0,0,1481,5,0,1.0
2927,7,2927,2.5,0,0,0,4,0,2.0
570,5,570,1.0,0,0,0,1,0,1.0
1770,6,1520,1.0,0,0,250,2,0,1.5
2830,9,2830,2.75,0,0,0,5,0,2.0
1650,7,1650,2.0,0,0,0,2,0,1.5
1240,8,1050,1.5,0,0,190,3,0,2.0
5480,11,5480,3.25,0,4,0,3,1,2.0
1310,7,870,1.75,0,0,440,3,0,1.0
2360,8,2360,2.5,0,0,0,4,0,1.0
2300,7,2300,2.5,0,0,0,4,0,2.0
1260,7,1260,1.0,0,0,0,3,0,1.0
2590,9,2590,2.5,0,0,0,3,0,2.0
1570,7,1570,2.25,0,3,0,4,0,1.0
3830,8,2130,4.75,0,0,1700,5,0,1.0
900,6,900,1.0,0,0,0,2,0,1.0
580,7,580,1.0,0,0,0,1,0,1.0
1240,7,620,2.0,0,0,620,3,0,1.0
2530,8,1530,2.5,0,0,1000,3,0,2.0
4090,11,3400,3.75,0,0,690,4,0,2.0
3630,10,3630,3.5,1,0,0,5,0,2.0
2200,7,2200,1.75,0,0,0,3,0,1.0
1520,7,1170,1.75,0,0,350,3,0,1.0
2090,9,2090,2.0,0,0,0,3,0,1.0
1670,7,1340,1.75,0,0,330,3,0,1.0
2590,9,2590,2.5,0,0,0,4,0,2.0
1090,8,970,1.5,0,0,120,2,0,1.0
1780,8,1600,2.5,0,0,180,3,0,3.0
2250,8,1350,1.75,0,1,900,5,0,1.0
830,6,830,1.0,0,0,0,2,0,1.0
1360,6,1360,1.0,0,0,0,4,0,1.5
3930,8,2330,2.5,0,4,1600,3,1,1.0
2630,9,2630,2.25,0,0,0,4,0,2.0
3250,9,2410,3.5,0,0,840,5,0,2.0
2040,8,2040,2.5,0,0,0,3,0,2.0
3250,9,3250,2.75,0,0,0,4,0,2.0
2830,9,2830,2.5,0,0,0,4,0,2.0
1410,7,1410,2.0,0,0,0,3,0,1.0
1080,7,780,1.0,0,0,300,2,0,1.0
1660,7,1660,2.25,0,0,0,3,0,2.0
4180,10,4180,4.0,0,0,0,5,0,2.0
2640,8,1770,2.25,0,0,870,4,0,1.0
1010,6,1010,1.0,0,0,0,2,0,1.0
4020,10,2830,2.75,1,4,1190,4,0,2.0
2080,7,2080,1.75,1,0,0,3,0,1.0
3780,9,2510,2.25,1,0,1270,4,0,2.0
1570,7,1080,1.75,0,0,490,3,0,1.0
1930,7,1450,1.75,0,0,480,4,0,1.5
2930,9,1860,2.75,0,0,1070,3,0,1.0
650,6,650,1.0,0,0,0,2,0,1.0
1160,7,860,1.75,0,0,300,2,0,1.0
1150,7,1150,1.5,0,0,0,3,0,1.0
870,7,870,1.0,0,0,0,2,0,1.0
2920,8,1910,2.5,0,0,1010,4,0,1.5
3610,9,3610,2.75,1,0,0,4,0,2.0
1910,8,1910,2.5,0,0,0,3,0,2.0
4040,9,2020,2.75,1,0,2020,8,0,1.0
2130,9,1080,2.75,0,0,1050,3,0,2.0
2460,7,1230,1.75,0,0,1230,5,0,1.0
1390,7,1390,1.0,0,0,0,2,0,1.0
1060,7,1060,1.0,1,0,0,3,0,2.0
2170,8,2170,2.25,0,0,0,3,0,2.0
2790,8,1410,1.75,0,0,1380,3,0,1.0
2320,8,1620,1.75,0,0,700,3,0,1.0
2820,10,2460,4.25,1,0,360,3,0,2.0
2090,7,2090,2.0,0,0,0,3,0,1.5
930,7,930,1.0,0,0,0,2,0,1.0
1210,7,1210,1.0,0,1,0,2,0,1.0
840,5,840,1.0,0,0,0,2,0,1.0
1790,6,1790,1.5,0,0,0,4,0,1.0
1200,6,1200,1.5,0,0,0,4,0,1.5
2620,8,2620,2.5,0,0,0,3,0,2.0
730,6,730,1.0,0,0,0,2,0,1.0
1120,7,1120,1.5,0,0,0,1,0,3.0
2930,9,2930,2.5,0,0,0,3,0,2.0
2290,8,2290,2.5,0,0,0,3,0,1.0
2030,8,2030,1.75,0,2,0,3,0,1.0
1310,8,1120,1.5,0,0,190,3,0,2.0
1350,7,1350,2.0,0,0,0,4,0,3.0
1960,8,1960,2.5,0,0,0,3,0,2.0
1160,7,1160,1.5,0,0,0,4,0,1.0
2560,8,1480,2.75,0,0,1080,4,0,1.0
1800,7,1200,1.75,0,0,600,3,0,1.0
1520,6,1120,1.0,0,0,400,3,0,1.0
3250,10,2500,3.5,0,0,750,3,0,2.0
2400,7,1200,2.25,0,0,1200,5,0,1.0
2840,7,1590,2.5,0,0,1250,5,0,1.0
1830,7,1830,1.5,0,0,0,5,0,1.5
1890,7,1100,2.25,0,0,790,3,0,1.0
1240,7,800,2.75,0,0,440,4,0,1.0
3780,9,1890,2.5,0,1,1890,5,0,1.0
1100,6,1100,1.0,0,0,0,3,0,1.0
2650,8,2650,2.5,0,0,0,4,0,2.0
1820,9,1820,2.0,0,0,0,3,0,3.0
1630,8,1300,1.5,0,0,330,3,0,1.0
2640,8,1750,2.75,1,0,890,3,0,1.5
1130,6,1130,1.0,0,0,0,4,0,1.5
2620,10,2620,2.5,0,0,0,3,0,1.0
3040,9,3040,3.0,0,0,0,5,0,2.0
2430,7,1730,1.5,0,0,700,4,0,1.5
4370,10,3670,2.25,1,3,700,4,0,2.5
1140,6,1140,1.0,0,0,0,3,0,1.0
1780,8,1780,2.25,0,0,0,4,0,2.0
1900,7,1190,2.5,0,0,710,5,0,1.0
2400,8,1170,2.75,0,0,1230,4,0,1.0
1400,7,1060,1.0,0,0,340,3,0,1.0
820,6,820,1.0,0,0,0,2,0,1.0
800,6,800,1.0,0,0,0,2,0,1.0
2090,7,1350,3.0,0,0,740,4,0,1.0
1560,8,1560,1.75,0,0,0,3,0,1.0
1080,7,1080,1.0,0,0,0,2,0,1.0
1930,7,1030,1.5,0,0,900,6,0,1.0
2180,8,1220,2.5,0,0,960,5,0,1.0
2600,8,2600,2.5,0,0,0,4,0,2.0
1640,7,840,1.0,0,0,800,2,0,1.0
1990,8,1290,2.25,0,0,700,4,0,1.0
2380,8,1760,2.25,0,0,620,4,0,1.0
2220,7,1220,2.0,0,2,1000,3,0,1.0
2550,7,1560,1.5,0,0,990,5,0,1.0
970,6,970,1.0,1,0,0,3,0,1.0
1670,8,1670,1.75,0,0,0,3,0,1.0
1590,6,1290,1.75,0,0,300,3,0,1.5
1850,7,1210,2.5,0,0,640,4,0,1.5
1480,8,1480,2.25,0,0,0,3,0,2.0
1130,6,1130,1.0,0,0,0,3,0,1.5
3370,9,2750,3.5,0,0,620,4,0,2.0
3640,9,2060,2.75,1,0,1580,3,0,1.0
2900,9,2900,2.5,0,0,0,3,0,2.0
1830,7,930,1.75,0,0,900,4,0,1.0
1740,7,1740,2.5,0,0,0,3,0,2.0
3950,10,2050,2.75,0,3,1900,4,0,1.0
3020,9,3020,2.5,0,0,0,4,0,2.0
3090,9,3090,2.5,1,0,0,5,0,2.0
1440,7,1440,1.0,0,0,0,4,0,1.5
1790,7,1790,1.5,0,0,0,3,0,1.5
3080,9,3080,2.75,0,0,0,3,0,2.0
1870,8,1670,1.75,0,0,200,4,0,1.0
2700,9,2700,2.5,0,0,0,4,0,2.0
1460,7,1260,1.0,0,0,200,2,0,1.0
1150,7,1150,2.5,0,0,0,3,0,3.0
1560,7,1560,1.5,0,0,0,2,0,1.0
2130,8,2130,2.25,0,0,0,4,0,2.0
2310,7,1490,2.5,0,0,820,4,0,1.5
1320,7,1320,1.0,0,0,0,3,0,1.0
2660,8,1550,2.75,1,0,1110,6,0,1.0
2540,7,1580,3.0,0,0,960,3,0,1.0
1750,7,1750,1.75,0,0,0,3,0,1.0
2450,8,2450,2.5,0,0,0,5,0,2.0
1150,7,1010,1.0,0,0,140,3,0,1.0
2570,8,2570,2.25,0,0,0,4,0,2.0
1410,7,1410,2.0,0,0,0,3,0,1.0
1870,7,1090,1.75,1,0,780,4,0,1.0
2500,8,1840,2.0,0,0,660,3,0,1.0
1360,6,1360,1.0,0,0,0,3,0,1.0
1160,7,890,1.5,0,0,270,2,0,2.0
2780,8,2780,2.5,0,0,0,4,0,2.0
2090,8,1680,2.75,0,0,410,4,0,1.5
710,6,710,1.0,0,0,0,2,0,1.0
2680,8,2680,2.5,0,0,0,3,0,2.0
1680,7,1680,2.5,0,0,0,3,0,2.0
1920,7,1300,2.25,0,0,620,3,0,1.0
1140,7,1140,1.5,0,0,0,2,0,2.0
3845,10,3845,3.5,1,0,0,4,0,2.0
1040,7,1040,1.0,0,0,0,2,0,1.0
2200,8,1500,2.75,0,0,700,4,0,1.0
1460,8,1460,2.5,0,0,0,3,0,3.0
1210,8,780,2.0,1,0,430,2,0,2.0
1280,6,1280,1.0,0,0,0,3,0,1.0
1190,9,1100,2.25,0,0,90,2,0,2.0
2380,9,2380,2.5,0,3,0,3,0,3.0
2260,9,1170,3.75,0,0,1090,3,0,2.0
2120,8,1260,1.75,0,0,860,3,0,1.0
1780,7,1240,1.5,0,0,540,3,0,1.0
2190,7,1290,1.75,0,0,900,5,0,1.0
2680,8,2680,2.5,0,0,0,4,0,2.0
1480,7,1480,1.75,0,0,0,3,0,1.0
2430,8,2430,2.5,0,0,0,4,0,2.0
3140,9,1770,2.5,0,2,1370,4,0,1.0
900,7,900,1.0,0,0,0,2,0,1.0
1560,7,1000,1.75,0,2,560,3,0,1.5
830,7,830,1.5,0,0,0,2,0,2.0
2720,8,2670,3.5,0,0,50,4,0,2.0
880,7,880,1.0,0,0,0,2,0,1.0
4110,10,2970,4.25,0,2,1140,5,0,2.0
1770,7,1770,2.5,0,0,0,3,0,2.0
1800,8,1360,2.25,0,0,440,3,0,1.0
1240,7,1240,1.5,0,0,0,2,0,2.0
1560,8,1270,2.25,0,0,290,2,0,2.0
1250,7,1250,1.0,0,0,0,3,0,1.0
1610,7,1090,2.0,1,0,520,3,0,1.0
1480,8,1480,2.5,0,0,0,3,0,3.0
1670,7,1170,1.75,0,0,500,3,0,1.0
1950,9,1610,3.0,1,0,340,3,0,3.0
3280,11,2880,3.5,1,0,400,4,0,2.0
1120,6,1120,1.0,0,0,0,3,0,1.0
2500,7,1250,3.25,0,3,1250,5,0,1.0
4350,8,2870,3.25,0,0,1480,4,0,2.0
2020,7,1010,1.0,0,0,1010,2,0,1.0
1360,7,1360,1.75,0,0,0,3,0,1.0
2200,8,2200,1.75,1,1,0,3,0,1.5
2540,9,2540,2.5,0,0,0,4,0,2.0
1850,7,1230,2.5,0,0,620,4,0,1.0
1920,8,1920,2.0,0,0,0,2,0,1.0
2110,8,2110,2.25,1,0,0,4,0,2.0
3670,10,3670,2.5,0,0,0,4,0,2.5
3480,9,2460,3.5,1,0,1020,4,0,2.0
1590,8,1590,2.0,0,0,0,3,0,1.0
2540,9,2540,2.5,0,0,0,4,0,2.0
3150,9,3150,3.5,0,0,0,4,0,2.0
1000,7,1000,1.0,0,0,0,2,0,1.0
1070,8,1000,1.5,0,0,70,2,0,2.0
3090,8,3090,2.5,0,0,0,3,0,2.0
2800,9,1890,3.5,0,0,910,4,0,2.0
1680,7,1400,1.75,0,0,280,3,0,1.0
1480,8,1480,1.0,0,1,0,3,0,1.0
2350,8,2350,2.5,0,0,0,3,0,2.0
1280,7,1280,1.75,0,0,0,3,0,1.0
3020,9,3020,3.25,1,0,0,3,0,2.0
1240,6,1240,1.0,0,0,0,3,0,1.0
2040,7,1020,1.5,0,0,1020,4,0,1.0
1020,6,1020,1.0,0,0,0,3,0,1.0
2280,8,2280,2.5,0,0,0,4,0,2.0
1330,7,1330,2.0,0,0,0,3,0,1.0
1940,8,1940,2.5,0,0,0,3,0,2.0
1630,7,890,1.5,0,0,740,2,0,1.0
3090,9,3090,2.75,0,0,0,4,0,2.0
1510,8,1220,3.25,0,0,290,3,0,2.0
4500,10,4500,3.5,0,0,0,3,0,2.0
4610,9,4610,3.25,0,0,0,3,0,2.0
1630,7,1120,2.5,0,0,510,3,0,1.0
1720,6,1720,2.0,0,0,0,3,0,1.0
1730,8,1290,2.25,0,0,440,3,0,1.0
2480,9,2480,2.5,0,0,0,4,0,2.0
2670,8,1400,3.0,0,0,1270,5,0,1.0
1890,9,1470,2.25,1,1,420,4,0,1.0
2610,9,2610,2.5,0,0,0,4,0,2.0
2140,7,1280,3.0,0,0,860,5,0,1.0
2600,7,1600,2.25,0,0,1000,4,0,1.0
3070,9,1740,3.0,1,0,1330,5,0,1.0
3120,9,3120,2.25,1,0,0,5,0,2.0
1450,7,1450,1.0,0,0,0,2,0,1.0
1360,8,1360,2.5,0,0,0,2,0,2.0
1380,7,1380,2.0,0,0,0,3,0,1.0
1550,8,1550,2.25,0,0,0,2,0,2.0
2600,7,1400,2.5,0,0,1200,4,0,1.0
1960,7,1490,2.25,0,0,470,3,0,1.0
1670,8,1670,1.75,1,0,0,3,0,1.0
3350,10,3350,2.5,0,0,0,4,0,2.0
2680,8,2680,2.5,0,0,0,4,0,2.0
2420,7,1400,2.25,0,0,1020,4,0,1.0
1640,10,1640,2.5,0,0,0,2,0,2.0
1550,8,1550,3.25,0,3,0,2,1,3.0
2020,7,1480,2.5,0,0,540,4,0,1.5
1680,7,1680,1.75,1,0,0,3,0,1.0
1080,7,1080,1.5,0,0,0,3,0,1.5
1100,6,1100,1.0,0,0,0,3,0,1.5
1280,8,1280,1.0,0,0,0,3,0,1.5
1780,8,1780,1.5,0,3,0,4,0,1.5
1180,6,1180,1.0,0,0,0,2,0,1.0
1130,7,1130,1.75,0,0,0,3,0,1.0
1340,7,1340,1.75,0,0,0,3,0,1.0
2300,9,2300,2.5,0,0,0,3,0,2.0
1170,7,1170,1.0,0,0,0,3,0,1.0
2160,7,1360,1.75,0,0,800,4,0,1.0
4230,10,2720,3.25,0,0,1510,5,0,2.0
1980,7,1980,2.5,0,0,0,4,0,2.0
2980,10,2370,3.5,0,0,610,5,0,2.0
1260,7,1260,1.5,0,0,0,2,0,1.5
2340,8,2340,2.5,0,0,0,4,0,2.0
2100,6,2100,2.75,0,0,0,4,0,1.0
2990,8,2990,2.5,0,0,0,4,0,2.0
1220,6,1220,1.0,0,0,0,4,0,1.5
2280,8,2280,2.5,0,0,0,3,0,2.0
1850,8,1210,1.75,0,0,640,3,0,1.5
960,5,960,1.0,0,0,0,3,0,1.0
3580,9,3580,2.5,0,0,0,3,0,1.5
2460,8,2460,2.5,0,0,0,4,0,2.0
2120,8,2120,2.25,0,2,0,4,0,2.0
1310,7,1310,2.25,0,0,0,4,0,1.0
1650,7,1650,1.75,0,0,0,3,0,1.0
3260,9,3260,2.75,0,0,0,4,0,2.0
1910,7,1910,2.0,0,0,0,4,0,1.0
1820,7,1820,2.5,0,0,0,4,0,2.0
1650,8,1130,1.5,0,0,520,3,0,1.0
1910,7,1160,2.75,0,0,750,3,0,1.0
1740,7,1740,2.75,0,0,0,3,0,1.0
760,5,760,0.75,0,4,0,1,1,1.0
1590,7,1100,2.25,0,0,490,3,0,1.0
2460,7,2460,2.0,0,4,0,3,1,1.0
3540,10,3540,2.5,0,0,0,4,0,2.0
1820,8,1820,1.75,0,0,0,4,0,1.5
920,6,920,1.0,0,0,0,2,0,1.0
1910,7,1290,1.75,0,0,620,3,0,1.0
2210,7,1710,2.5,0,0,500,3,0,2.0
1770,8,1250,2.75,0,0,520,4,0,1.0
2790,10,2790,2.5,0,0,0,3,0,2.0
2810,8,1860,2.25,0,0,950,4,0,2.0
2160,7,1320,3.0,0,0,840,4,0,1.0
2060,7,1060,2.0,0,0,1000,3,0,1.0
2310,9,2310,2.5,0,0,0,2,0,2.0
1000,5,1000,1.0,0,0,0,2,0,1.0
980,7,980,1.0,0,0,0,2,0,1.0
880,7,880,1.0,0,0,0,2,0,1.0
2560,8,2560,2.0,0,0,0,3,0,1.0
2160,7,1220,2.75,0,0,940,5,0,1.5
1420,7,1420,1.0,0,0,0,4,0,1.0
2270,9,2270,2.0,1,0,0,3,0,1.0
1270,7,1270,1.0,0,0,0,3,0,1.0
1800,8,1800,2.5,0,0,0,3,0,2.0
1040,6,1040,1.0,0,0,0,2,0,1.0
3320,8,2260,1.75,0,3,1060,3,0,1.5
1890,7,1230,2.25,0,0,660,3,0,1.0
850,8,850,2.25,0,0,0,2,0,2.0
2710,7,2170,1.5,0,0,540,3,0,1.5
2430,8,2430,3.0,0,0,0,4,0,2.0
2340,8,1460,2.5,0,0,880,3,0,1.0
1160,7,1160,1.0,0,0,0,3,0,1.0
800,6,800,1.0,0,0,0,2,0,1.0
1850,8,1850,2.0,0,0,0,3,0,1.0
1280,8,1280,2.5,0,0,0,3,0,3.0
2380,7,2380,2.5,0,0,0,4,0,2.0
1620,8,1470,2.5,0,4,150,3,0,3.0
2220,7,1420,1.75,0,0,800,5,0,1.5
1960,8,1960,2.5,0,0,0,4,0,2.0
3030,8,3030,2.75,0,0,0,5,0,2.0
1450,7,1180,2.25,0,0,270,3,0,1.0
2670,9,2670,2.5,0,3,0,3,0,2.0
2240,9,2240,2.5,0,0,0,4,0,2.0
1660,7,970,2.0,0,0,690,3,0,1.0
1380,7,1380,1.5,0,0,0,3,0,1.0
2640,7,2640,3.5,0,0,0,5,0,2.0
2210,8,2210,2.25,1,0,0,4,0,2.0
2190,8,2190,2.5,1,0,0,4,0,2.5
4290,10,4290,2.5,0,0,0,4,0,2.0
1320,6,940,1.0,0,0,380,2,0,1.0
1000,7,1000,1.0,0,0,0,3,0,1.0
1010,5,1010,1.5,0,0,0,2,0,1.5
3110,8,3110,3.5,0,2,0,4,0,2.0
990,7,990,1.0,0,0,0,2,0,1.0
2800,8,1880,5.0,0,0,920,8,0,2.0
1890,7,1470,2.0,1,0,420,3,0,1.0
2280,7,1140,2.0,0,0,1140,4,0,1.0
2190,7,1470,2.75,0,0,720,4,0,1.5
5480,11,3910,4.75,0,4,1570,6,1,1.5
2200,7,1100,2.0,0,0,1100,4,0,1.0
1400,7,1400,1.5,0,0,0,3,0,1.0
1410,7,1410,2.0,0,0,0,3,0,1.0
4070,9,4070,2.75,0,0,0,4,0,2.0
1370,8,1370,1.75,0,0,0,3,0,1.0
2370,8,2370,2.5,0,0,0,4,0,2.0
1440,7,1180,1.75,0,0,260,3,0,1.0
2390,9,2390,2.5,0,0,0,4,0,2.0
770,6,770,1.0,0,0,0,2,0,1.0
1330,7,1330,2.25,0,0,0,3,0,2.0
2030,9,2030,2.5,1,0,0,3,0,3.0
2100,7,2100,2.25,0,0,0,3,0,2.0
2783,8,2783,2.0,0,0,0,3,0,2.0
1370,7,1370,1.0,0,0,0,3,0,1.0
1580,7,1580,2.5,0,0,0,4,0,2.0
2090,8,1340,2.75,0,0,750,3,0,1.0
2200,8,2200,2.5,0,0,0,4,0,2.0
1480,8,1480,2.5,1,0,0,3,0,3.0
2690,9,2690,2.5,0,0,0,4,0,2.0
2960,10,2960,2.5,0,0,0,3,0,2.0
2230,7,2230,1.0,0,0,0,2,0,2.0
1480,7,1120,1.0,0,0,360,2,0,1.0
2180,8,2020,1.75,1,0,160,4,0,1.5
1810,7,1310,2.5,1,0,500,3,0,1.0
890,6,890,0.75,0,0,0,2,0,1.0
1630,8,1630,2.5,0,0,0,3,0,2.0
930,6,930,1.0,0,0,0,2,0,1.0
1610,7,1610,2.0,0,0,0,3,0,2.0
1730,9,1350,3.5,0,0,380,3,0,3.0
4620,10,4620,4.0,0,0,0,4,0,2.0
1530,7,1530,2.0,0,0,0,4,0,1.5
3480,9,2580,3.5,0,0,900,4,0,2.0
3860,10,3860,3.75,0,0,0,4,0,2.5
710,6,710,1.75,0,0,0,3,0,1.0
2470,8,2470,1.75,0,2,0,4,0,2.0
2160,8,2160,2.0,1,0,0,3,0,1.0
1430,7,1430,2.0,0,0,0,3,0,1.0
2040,8,2040,2.5,0,0,0,4,0,2.0
3250,8,1800,2.5,0,1,1450,6,0,1.0
2800,7,1400,1.75,0,0,1400,4,0,1.0
2550,9,2550,2.5,0,0,0,4,0,2.0
3810,9,2560,3.5,0,1,1250,4,0,1.0
1190,7,830,1.5,0,0,360,3,0,1.0
1370,6,1120,1.0,0,0,250,6,0,1.5
1570,9,1570,1.75,1,0,0,2,0,3.0
1590,7,1590,1.75,0,0,0,3,0,1.0
1740,8,1740,2.5,0,0,0,3,0,3.0
3480,8,2340,3.0,0,0,1140,5,0,1.0
1210,7,1210,1.75,1,0,0,3,0,1.0
2770,9,2770,2.5,0,0,0,3,0,2.0
3520,10,3520,2.75,0,0,0,5,0,2.0
2280,8,2280,2.5,0,0,0,3,0,2.0
2160,7,1290,2.0,0,0,870,4,0,2.0
2230,8,1540,2.5,0,0,690,4,0,2.0
1690,8,1150,2.5,0,0,540,3,0,2.0
1900,7,1900,2.5,0,0,0,4,0,1.5
4930,12,4930,4.0,0,3,0,4,0,2.0
1760,8,1760,1.75,0,0,0,3,0,1.0
1570,7,1180,2.5,0,0,390,2,0,2.0
1730,8,1730,2.5,0,0,0,3,0,2.0
610,6,610,1.0,0,0,0,2,0,1.0
2090,7,1320,2.5,0,0,770,4,0,1.0
1760,7,1760,2.0,0,0,0,3,0,1.0
2090,7,1050,1.75,0,0,1040,4,0,1.0
380,5,380,0.75,0,0,0,1,0,1.0
1660,6,850,2.0,0,0,810,4,0,1.0
700,5,700,1.0,0,0,0,2,0,1.0
2160,8,1400,1.5,0,2,760,3,0,1.0
2680,8,1340,1.75,0,0,1340,4,0,1.0
1110,7,1110,1.0,0,0,0,3,0,1.0
1560,8,1560,1.75,0,0,0,3,0,1.0
1500,7,1000,1.75,0,0,500,4,0,1.0
2280,7,2280,2.0,0,0,0,4,0,1.0
1790,7,1110,2.25,0,0,680,4,0,1.0
1460,8,1460,2.25,0,0,0,2,0,2.0
1370,8,1100,3.5,0,0,270,3,0,2.0
1570,7,1320,1.5,0,2,250,2,0,1.5
1210,6,710,1.0,0,0,500,2,0,1.0
1760,6,1760,2.5,0,0,0,5,0,1.5
3150,10,1800,2.5,0,0,1350,5,0,1.0
1300,8,1100,2.5,0,0,200,3,0,2.0
2000,7,2000,2.25,0,1,0,4,0,2.0
980,6,980,1.0,0,0,0,2,0,1.0
3190,9,3190,2.75,0,0,0,4,0,2.0
3190,9,2410,3.5,0,3,780,4,0,1.5
1850,8,1850,1.75,0,0,0,3,0,1.0
2570,8,2570,2.0,0,0,0,3,0,1.5
2160,9,1970,2.5,0,0,190,3,0,2.0
1950,8,1430,2.25,0,0,520,3,0,1.5
1450,6,1450,1.0,0,0,0,3,0,1.0
1560,7,1250,1.75,0,0,310,3,0,1.0
2010,7,1300,1.75,0,1,710,4,0,1.0
1240,7,1240,0.75,1,0,0,3,0,1.0
1290,6,1290,1.0,0,0,0,2,0,1.0
2770,8,1780,1.75,0,0,990,2,0,2.0
1300,8,1000,2.25,0,0,300,3,0,2.0
1510,6,810,1.25,0,3,700,3,0,1.0
720,6,720,1.0,0,0,0,2,0,1.0
6070,12,6070,4.25,0,0,0,5,0,2.0
1690,7,1690,1.75,0,0,0,3,0,1.0
1310,7,1310,1.0,0,0,0,3,0,1.0
1140,6,1140,1.5,0,0,0,2,0,1.0
1740,8,1150,1.75,0,3,590,3,0,1.0
2720,9,2720,2.5,0,0,0,3,0,2.0
1950,6,1950,1.75,0,0,0,4,0,1.5
1860,7,1860,2.25,0,0,0,3,0,2.0
1390,7,1180,2.5,0,0,210,2,0,2.0
3220,9,2450,3.0,0,0,770,4,0,2.0
1560,9,1560,3.0,0,0,0,3,0,2.0
2070,7,2070,2.0,0,0,0,4,0,2.0
2720,8,2000,2.25,0,0,720,4,0,1.0
2400,7,2400,3.0,0,0,0,6,0,2.0
4740,11,3640,3.5,0,3,1100,4,0,2.0
3900,6,3460,2.75,0,0,440,3,0,2.0
1850,8,1430,2.5,0,0,420,4,0,1.0
1220,8,930,3.25,0,0,290,3,0,2.0
1690,7,1430,1.5,0,0,260,3,0,1.0
940,6,940,1.0,0,0,0,2,0,1.0
1430,7,1430,1.75,0,0,0,3,0,1.0
2380,8,2380,2.5,0,0,0,4,0,2.0
980,7,980,1.0,0,0,0,2,0,1.0
1370,7,1370,1.0,0,0,0,1,0,1.5
1580,8,1580,1.0,0,0,0,3,0,2.0
1710,7,1710,1.5,0,0,0,4,0,1.5
2040,8,1580,2.25,0,0,460,4,0,1.0
2410,8,1650,2.25,0,0,760,4,0,2.0
3280,7,3280,2.5,0,0,0,4,0,2.0
1270,8,1270,2.0,0,0,0,2,0,1.5
5020,10,3420,3.25,0,4,1600,3,1,2.0
2220,7,1200,2.0,0,0,1020,4,0,1.0
1980,7,1430,1.0,0,0,550,4,0,1.0
2830,8,1610,2.5,0,1,1220,5,0,1.0
2900,8,1530,3.0,0,3,1370,4,0,1.0
2290,7,2290,2.75,0,0,0,4,0,2.0
2570,9,2570,2.5,0,0,0,4,0,2.0
1320,7,1320,2.5,0,0,0,4,0,1.0
1960,7,980,1.75,0,0,980,2,0,1.0
3000,9,3000,2.5,0,0,0,4,0,2.0
1390,7,1140,3.0,0,0,250,3,0,2.0
2950,7,2310,2.0,0,0,640,3,0,2.0
1110,7,1110,0.75,0,0,0,3,0,1.0
2510,8,1470,2.0,0,0,1040,3,0,1.0
1940,7,1720,1.75,0,0,220,4,0,1.0
1690,7,1160,2.25,0,1,530,3,0,1.0
1240,7,1000,1.0,0,0,240,2,0,1.0
1160,5,1160,1.0,0,0,0,3,0,1.0
1950,7,1950,2.5,0,0,0,4,0,2.0
2850,8,2850,2.5,0,0,0,4,0,2.0
2530,9,2530,2.5,0,0,0,3,0,2.0
2580,8,2580,3.0,0,0,0,4,0,2.0
2200,8,2200,2.75,0,0,0,3,0,2.0
3580,10,3580,3.0,0,0,0,4,0,1.5
2320,7,2170,1.75,0,0,150,4,0,1.5
2100,8,2100,2.5,0,0,0,4,0,2.0
1300,7,770,2.0,0,0,530,2,0,1.0
1300,7,920,1.0,0,0,380,3,0,1.0
1900,7,950,1.75,1,0,950,4,0,1.0
6380,12,6380,4.5,0,0,0,4,0,2.0
2380,8,2380,2.25,1,0,0,3,0,1.0
1680,7,1680,1.75,0,0,0,3,0,1.5
1070,7,1070,2.0,0,0,0,2,0,1.0
2490,9,2490,3.0,0,0,0,4,0,2.0
2120,7,1060,1.75,0,0,1060,4,0,1.0
1390,7,1340,2.25,0,0,50,2,0,3.0
1960,7,980,1.75,0,0,980,4,0,1.0
2250,7,1500,1.75,0,0,750,5,0,1.0
2140,8,2140,2.25,0,0,0,3,0,1.0
1550,7,1550,1.75,0,0,0,3,0,1.0
820,7,820,1.0,0,0,0,2,0,1.0
1660,7,990,1.75,1,0,670,2,0,1.0
2220,8,2220,2.5,0,0,0,3,0,2.0
1350,6,1350,1.0,0,0,0,3,0,1.5
1340,8,1080,3.5,0,2,260,3,0,2.0
1060,6,1060,1.0,0,0,0,2,0,1.0
1640,8,1640,2.25,1,0,0,3,0,3.0
3400,10,2790,3.5,1,0,610,4,0,2.5
1370,7,770,1.75,1,0,600,3,0,1.0
1650,8,1650,3.5,0,0,0,3,0,3.0
2200,8,2200,2.5,0,0,0,4,0,2.0
1450,7,1450,1.75,0,0,0,3,0,1.0
1380,9,1380,2.5,0,0,0,2,0,3.0
4140,10,3300,3.25,1,1,840,4,0,1.0
1600,8,1600,2.5,0,2,0,3,0,2.0
2080,7,1370,1.75,0,0,710,3,0,1.0
2940,9,2940,2.5,0,0,0,4,0,2.0
1370,8,1100,3.25,0,0,270,3,0,2.0
750,7,750,1.0,0,0,0,2,0,1.0
4350,10,2970,3.5,1,0,1380,4,0,2.0
1440,7,1440,2.0,0,0,0,3,0,1.0
1240,7,1240,1.0,0,0,0,3,0,1.0
1270,7,1270,1.0,0,0,0,2,0,1.0
2790,8,2790,2.5,0,0,0,4,0,2.0
2300,7,1220,1.75,0,0,1080,3,0,1.0
2160,8,1260,1.75,0,0,900,3,0,1.0
1590,7,1590,1.75,0,0,0,4,0,2.0
2510,9,2510,2.25,0,0,0,4,0,2.0
4073,8,4073,2.5,0,0,0,4,0,2.0
2450,8,1770,3.25,0,0,680,5,0,2.0
1400,7,900,4.0,0,0,500,5,0,1.0
1410,7,1290,2.25,0,0,120,3,0,2.0
1770,7,1770,1.5,0,0,0,4,0,2.0
2260,9,2260,2.5,0,0,0,4,0,2.0
5930,11,3920,3.5,0,2,2010,5,0,2.0
2020,7,1010,1.75,0,0,1010,4,0,1.0
2040,8,1400,2.25,0,0,640,4,0,1.0
1570,8,1570,2.0,0,0,0,2,0,1.0
2620,7,1760,3.0,0,0,860,6,0,1.0
2370,9,2370,2.5,0,2,0,3,0,2.0
2200,8,2200,2.5,0,0,0,3,0,2.0
1600,7,1600,1.5,0,0,0,3,0,1.0
2180,8,1850,2.5,0,0,330,3,0,1.0
670,6,670,1.0,0,0,0,2,0,1.0
960,7,960,1.0,0,0,0,2,0,1.0
1020,6,880,1.0,0,0,140,3,0,1.0
1450,6,1450,1.0,0,0,0,4,0,1.0
3040,8,3040,2.5,0,0,0,4,0,2.0
3520,9,1950,2.75,0,4,1570,4,1,1.0
4390,9,3170,3.5,0,3,1220,5,0,2.0
3060,8,3060,3.25,0,0,0,5,0,2.0
1980,9,1980,3.75,0,0,0,4,0,2.0
2030,7,1310,1.5,0,0,720,3,0,1.0
2830,8,1500,3.0,1,0,1330,5,0,1.0
2240,8,2240,2.5,0,0,0,4,0,2.0
1460,7,1460,2.0,0,0,0,3,0,1.0
2070,8,2070,2.25,0,0,0,3,0,1.5
1590,7,1590,2.25,0,0,0,3,0,2.0
2370,8,2370,2.5,0,0,0,4,0,2.0
2390,8,2390,2.5,0,0,0,3,0,2.0
1550,6,1550,1.0,0,0,0,2,0,1.0
2050,8,1180,2.0,1,0,870,3,0,1.0
2910,8,1910,2.5,0,0,1000,4,0,1.0
780,6,780,1.0,0,0,0,2,0,1.0
1280,7,880,1.0,0,0,400,3,0,1.0
3160,9,3160,2.5,0,0,0,4,0,2.0
1620,6,920,1.0,0,0,700,2,0,1.0
1050,7,1050,1.0,0,0,0,3,0,1.0
1100,7,1100,1.0,0,0,0,2,0,1.0
1940,7,1940,1.75,0,0,0,5,0,1.5
1320,7,1320,2.0,0,0,0,3,0,1.0
1740,7,1740,1.5,0,0,0,3,0,1.0
3310,9,3310,3.25,0,0,0,3,0,2.0
1280,7,1280,1.5,0,0,0,3,0,1.5
2550,8,2550,2.5,0,0,0,4,0,2.0
2370,8,2370,3.5,0,0,0,4,0,2.5
2630,9,2630,3.0,1,0,0,3,0,1.0
2240,8,2240,2.5,0,0,0,3,0,2.0
1790,7,1350,1.0,0,0,440,5,0,1.0
2740,9,2740,2.5,0,0,0,4,0,2.0
1270,6,1270,1.0,0,0,0,3,0,1.5
2940,8,1780,2.75,0,0,1160,6,0,1.0
1480,7,1480,1.0,0,0,0,4,0,1.5
1440,8,1440,1.75,0,0,0,3,0,1.0
2000,7,1000,1.75,0,4,1000,4,0,1.0
830,6,830,1.0,0,0,0,2,0,1.0
2780,9,2780,3.0,0,0,0,3,0,2.0
2310,9,2310,2.25,0,0,0,4,0,2.0
1550,8,1550,1.75,0,4,0,2,1,1.0
2200,8,1500,2.5,0,0,700,4,0,1.0
1670,7,1320,1.75,0,0,350,3,0,1.0
1420,7,1420,2.0,0,0,0,3,0,2.0
2310,9,2310,2.5,0,0,0,4,0,2.0
2130,7,1330,2.5,0,0,800,4,0,1.0
3480,8,2490,3.5,0,0,990,5,0,2.0
1960,6,980,2.0,0,0,980,4,0,1.0
1150,7,1150,1.75,0,0,0,3,0,1.0
2030,7,1330,2.5,0,0,700,4,0,1.0
1860,7,1110,2.0,0,0,750,3,0,1.5
1670,7,1670,2.0,0,0,0,4,0,1.0
2510,8,1410,2.5,0,0,1100,5,0,1.0
3720,9,1960,1.75,0,3,1760,4,0,1.0
2010,8,2010,2.5,0,0,0,3,0,2.0
860,7,860,1.0,0,0,0,2,0,1.0
3180,9,3180,2.5,1,1,0,4,0,2.0
3200,9,2390,3.25,0,0,810,4,0,2.0
1590,7,1590,2.0,0,0,0,3,0,1.0
1560,7,1560,1.75,0,0,0,3,0,1.5
1830,8,1830,2.25,0,0,0,3,0,2.0
1040,6,1040,1.0,0,3,0,2,0,1.0
5470,11,3730,2.75,0,4,1740,4,1,2.0
1950,8,1950,2.5,0,0,0,3,0,2.0
1260,7,1260,1.0,1,0,0,3,0,2.0
3050,8,1650,1.5,0,0,1400,4,0,1.0
1780,8,1350,2.25,0,0,430,3,0,1.0
980,7,820,1.5,0,0,160,2,0,2.0
2960,9,2960,2.5,0,0,0,4,0,2.0
2110,8,2110,2.25,0,0,0,3,0,2.0
3230,8,3230,2.75,0,0,0,3,0,1.5
1040,7,1040,1.0,0,0,0,3,0,1.0
1950,8,1570,2.25,1,0,380,3,0,1.0
1060,6,1060,1.0,0,0,0,3,0,1.0
1690,7,1690,2.5,0,0,0,3,0,2.0
1620,7,1280,2.25,0,2,340,3,0,1.0
2880,8,1680,2.5,0,0,1200,5,0,1.0
1810,8,1170,1.75,0,0,640,2,0,1.0
2520,8,2010,3.0,0,1,510,5,0,2.0
880,6,880,1.0,0,0,0,3,0,1.5
2460,8,1640,2.75,0,0,820,4,0,2.0
1640,7,1460,1.0,0,0,180,4,0,1.5
2550,8,1290,2.5,0,0,1260,4,0,1.0
750,6,750,1.0,0,0,0,2,0,1.0
1160,7,1160,1.0,0,0,0,3,0,1.0
3753,10,3336,2.5,0,0,417,4,0,2.0
2000,7,1520,1.5,0,0,480,3,0,1.0
1060,7,1060,1.0,0,0,0,3,0,1.0
850,6,850,1.0,0,0,0,2,0,1.0
1210,7,1210,2.0,1,0,0,3,0,1.0
890,7,890,1.0,0,0,0,2,0,1.0
1860,8,1860,2.0,0,0,0,3,0,1.0
2330,7,1310,2.0,0,0,1020,5,0,1.0
1840,8,1840,3.0,0,0,0,4,0,2.0
720,6,720,1.0,0,0,0,2,0,1.0
2020,6,1190,1.5,1,0,830,3,0,1.0
1570,7,1570,1.75,0,0,0,3,0,1.0
770,6,770,1.0,0,0,0,2,0,1.0
2230,8,2230,2.25,0,0,0,4,0,2.0
1620,8,1540,2.25,0,0,80,3,0,2.5
1400,6,700,1.0,0,0,700,3,0,1.0
970,7,970,1.0,0,0,0,3,0,1.0
1220,7,1220,1.0,1,0,0,3,0,1.0
2380,8,2380,2.25,0,0,0,4,0,2.0
1550,7,860,3.0,0,0,690,4,0,1.0
3090,10,3090,2.5,0,0,0,4,0,2.0
2163,7,2163,2.5,0,0,0,4,0,2.0
4430,9,3000,3.5,0,0,1430,6,0,2.0
1400,6,1400,1.0,0,0,0,3,0,1.5
1400,7,700,2.0,0,0,700,3,0,1.0
2240,7,2240,2.5,0,0,0,3,0,2.0
1780,7,1130,1.75,0,0,650,3,0,1.0
2380,9,1930,2.75,0,4,450,3,0,2.0
1730,8,1730,2.5,0,0,0,3,0,2.0
2230,7,1290,2.0,0,0,940,3,0,1.5
1690,7,1690,1.0,0,0,0,3,0,1.5
1000,7,1000,1.5,0,0,0,2,0,1.0
4133,11,4133,3.75,0,0,0,4,0,2.0
2360,8,2360,2.25,1,0,0,4,0,2.0
3400,11,3400,2.5,0,0,0,4,0,2.0
2150,7,1540,3.0,0,0,610,3,0,1.5
2280,8,2280,2.5,0,0,0,3,0,2.0
3020,9,3020,2.5,0,0,0,4,0,2.0
2250,8,1570,3.0,0,0,680,4,0,2.0
1740,8,1210,2.5,1,2,530,2,0,2.0
1300,7,990,1.5,0,0,310,2,0,1.0
3660,10,3660,2.75,0,0,0,4,0,2.0
1090,7,1090,1.75,0,0,0,3,0,1.0
1000,6,1000,1.0,0,0,0,2,0,1.0
3220,9,3220,3.0,0,0,0,4,0,1.5
3730,10,2820,3.75,1,3,910,4,0,2.0
850,7,850,1.0,0,0,0,2,0,1.0
2170,7,2170,2.5,0,0,0,3,0,2.0
4690,10,4030,3.75,0,0,660,4,0,2.0
1670,7,1670,1.5,0,0,0,3,0,1.0
2150,7,1380,2.0,0,0,770,3,0,1.5
1250,7,940,1.0,0,0,310,2,0,1.0
2655,8,2655,2.5,0,0,0,3,0,2.0
1060,7,1060,1.5,0,0,0,3,0,1.0
2020,8,1680,2.25,0,0,340,3,0,2.0
1640,7,920,1.75,0,0,720,4,0,1.0
1100,7,1100,1.75,0,0,0,3,0,1.0
3050,10,3050,1.75,0,0,0,2,0,2.0
2240,7,1390,3.0,0,1,850,5,0,1.0
2390,8,2390,2.25,0,0,0,4,0,1.0
4220,9,2910,3.5,0,0,1310,4,0,2.0
1750,7,1220,1.75,0,0,530,4,0,1.0
1960,7,1960,1.5,0,0,0,4,0,1.5
1060,7,730,2.0,0,0,330,3,0,2.0
2370,7,1600,2.0,0,0,770,2,0,1.5
1660,8,1370,2.25,0,0,290,3,0,1.0
1870,8,1870,2.5,0,0,0,3,0,2.0
4890,11,3090,4.25,1,2,1800,4,0,2.0
3590,10,3590,2.75,0,0,0,4,0,2.0
1690,7,1690,2.5,0,0,0,3,0,2.0
3740,10,3740,3.5,0,0,0,5,0,2.0
2180,9,2180,1.75,0,0,0,3,0,2.0
1440,7,960,1.5,0,1,480,4,0,1.0
2080,7,1460,2.5,0,0,620,5,0,1.0
1190,7,1190,2.5,0,0,0,3,0,1.0
1060,6,1060,1.0,0,0,0,2,0,1.0
2490,9,2490,2.5,0,0,0,3,0,2.0
2280,8,1960,2.25,0,2,320,4,0,1.5
1880,8,1880,2.5,0,0,0,3,0,2.0
3820,9,2830,4.5,0,3,990,5,0,2.0
1560,6,910,1.0,0,0,650,3,0,1.0
1150,8,1150,1.0,0,0,0,3,0,2.0
1400,7,1400,1.0,0,0,0,3,0,1.0
1320,6,880,1.0,0,0,440,3,0,1.0
2380,8,2380,2.5,0,0,0,4,0,2.0
3800,9,3800,2.5,0,0,0,4,0,2.0
3260,9,2630,3.5,0,0,630,4,0,2.0
3110,9,2550,2.5,0,1,560,3,0,2.0
2470,8,1280,2.75,0,0,1190,4,0,1.0
3140,8,3140,2.5,0,0,0,4,0,2.0
1630,8,1630,2.5,0,0,0,3,0,2.0
1950,7,1950,2.5,0,0,0,4,0,2.0
1240,7,1240,1.5,0,0,0,3,0,1.0
1240,8,1240,1.75,0,0,0,2,0,1.0
2520,10,2520,2.25,0,0,0,3,0,1.0
1550,7,940,2.0,0,0,610,3,0,1.0
1850,8,1650,1.75,0,0,200,3,0,1.5
1090,7,950,1.5,0,0,140,2,0,1.0
1830,8,1830,2.75,0,0,0,3,0,2.0
1650,8,1650,1.75,0,0,0,3,0,1.0
2260,9,2260,2.25,0,0,0,4,0,2.0
2803,8,2803,2.5,0,0,0,5,0,1.0
2600,9,2600,2.5,0,0,0,3,0,2.0
3280,7,3280,3.0,0,0,0,4,0,1.5
1430,7,1430,1.75,0,0,0,3,0,2.0
1960,6,1960,1.0,0,0,0,4,0,1.5
1740,7,1140,1.75,0,0,600,3,0,1.0
960,7,960,1.0,0,0,0,3,0,1.0
1660,7,1120,1.5,0,0,540,3,0,1.0
1720,7,1270,2.75,0,0,450,3,0,1.0
1920,8,1920,2.5,0,0,0,3,0,2.0
2310,7,1520,2.75,0,0,790,3,0,1.0
1370,8,1330,2.25,0,0,40,3,0,3.0
1990,8,1680,2.5,0,0,310,4,0,2.0
1650,8,1650,2.0,0,0,0,3,0,2.0
1820,7,1120,2.25,0,0,700,3,0,1.0
1760,8,1760,2.25,0,0,0,3,0,2.0
4160,10,4160,3.25,1,0,0,4,0,2.0
3060,8,3060,2.75,0,0,0,5,0,2.0
1450,6,1450,1.0,0,0,0,4,0,1.5
1880,7,960,1.75,0,0,920,5,0,1.0
3366,8,2966,4.0,0,2,400,5,0,2.5
3100,8,2400,3.5,0,0,700,4,0,2.0
1670,8,1427,3.0,0,0,243,4,0,3.0
1330,8,1330,2.5,0,0,0,3,0,3.0
1830,8,1830,2.25,0,0,0,3,0,2.0
2820,8,1860,2.75,1,0,960,4,0,1.0
2710,7,2710,2.5,0,0,0,4,0,2.0
3940,8,2620,2.5,1,0,1320,4,0,2.0
1350,7,920,1.0,0,0,430,2,0,1.0
2010,7,1470,1.75,0,0,540,4,0,1.0
1440,7,1440,1.0,0,0,0,2,0,1.5
2190,9,2190,2.5,0,0,0,3,0,2.0
2100,7,1240,2.5,0,0,860,4,0,1.0
2130,7,2130,2.5,0,0,0,5,0,2.0
2250,8,2250,2.0,0,0,0,3,0,1.0
2230,8,1850,3.0,0,0,380,3,0,2.5
1400,7,820,1.75,0,0,580,2,0,1.0
2250,7,1750,2.0,0,0,500,5,0,1.5
1140,7,1140,1.5,0,0,0,3,0,1.0
1660,7,1660,2.0,0,0,0,3,0,1.0
2690,8,1790,2.5,0,0,900,5,0,1.0
1370,6,1370,1.0,0,0,0,3,0,2.0
3320,10,3320,2.5,0,0,0,4,0,2.0
2470,7,1140,1.75,0,3,1330,2,0,1.0
2400,8,1540,1.5,0,0,860,3,0,1.0
2040,8,2040,2.5,0,0,0,3,0,2.0
2220,7,2220,2.0,0,0,0,4,0,1.5
4470,11,3230,4.25,0,1,1240,4,0,2.0
1510,7,1010,1.0,0,0,500,3,0,1.0
3100,8,3100,2.75,0,2,0,5,0,2.0
3740,8,2330,2.25,1,0,1410,3,0,2.0
1460,7,1460,1.75,0,0,0,3,0,1.0
1720,8,1420,1.75,0,0,300,4,0,1.0
2990,8,2990,2.0,0,0,0,4,0,1.0
1520,7,1520,1.75,0,0,0,3,0,1.0
640,6,640,1.0,0,0,0,1,0,1.0
1520,7,1520,1.75,0,0,0,4,0,1.0
1640,7,820,1.75,0,0,820,4,0,1.0
2500,8,1770,2.5,0,0,730,3,0,1.0
2200,8,1570,2.5,0,0,630,3,0,1.0
3350,9,3350,2.5,0,0,0,4,0,2.0
3200,9,3200,2.5,0,0,0,4,0,2.0
3620,8,2790,3.25,0,0,830,5,0,2.0
1640,8,1640,2.25,0,0,0,3,0,3.0
1550,7,1550,4.0,0,0,0,4,0,1.5
2430,7,2430,2.5,0,0,0,3,0,2.0
1320,7,1320,1.0,0,0,0,2,0,1.0
2580,8,2580,2.5,0,0,0,4,0,2.0
1460,7,1140,2.25,0,0,320,3,0,1.0
770,6,770,1.0,0,0,0,2,0,1.0
2690,8,2690,2.5,0,0,0,4,0,2.0
1850,8,1850,1.75,0,0,0,3,0,2.5
2623,8,2623,2.5,0,0,0,4,0,2.0
5150,11,4360,3.75,0,3,790,4,0,2.0
2250,8,2250,2.5,0,0,0,3,0,2.0
4860,11,3820,3.25,1,2,1040,5,0,2.0
1820,8,1820,2.0,0,2,0,3,0,2.0
2300,8,2300,2.5,0,0,0,3,0,2.0
2850,8,2490,2.0,1,0,360,4,0,2.0
2130,7,2130,2.0,1,0,0,4,0,1.5
2820,7,1970,2.25,0,2,850,6,0,1.5
1270,7,1270,1.0,0,0,0,3,0,1.0
1610,7,1060,1.75,0,0,550,3,0,1.5
2740,8,2240,3.0,0,0,500,4,0,2.0
1020,6,1020,1.75,0,0,0,3,0,1.0
2480,7,2480,2.5,0,0,0,3,0,2.0
3030,7,1930,3.0,0,0,1100,5,0,1.5
2660,7,1330,2.0,0,0,1330,3,0,1.0
1984,7,1984,3.0,0,0,0,4,0,2.0
2130,8,2130,2.25,1,0,0,4,0,2.0
2910,7,1690,2.5,0,0,1220,5,0,1.0
3273,8,2671,3.5,0,0,602,4,0,2.0
2290,8,2290,2.5,0,0,0,4,0,2.0
2230,8,1400,2.5,0,1,830,4,0,1.0
3130,8,1620,2.5,1,0,1510,4,0,1.0
3110,10,2510,3.0,0,3,600,4,0,2.5
3610,8,3610,2.75,0,0,0,6,0,1.5
2770,8,2770,2.25,1,0,0,4,0,2.0
4010,10,4010,4.25,0,0,0,5,0,2.0
2410,7,1410,2.75,0,0,1000,5,0,1.0
1710,7,1110,1.75,0,0,600,3,0,1.0
3000,8,1900,1.75,0,0,1100,3,0,2.0
3100,9,1660,3.5,0,4,1440,5,0,1.0
4340,11,4340,2.5,0,0,0,4,0,2.5
2390,8,1500,1.75,0,0,890,3,0,1.0
2720,9,2720,2.5,0,0,0,4,0,2.0
1880,6,940,2.0,0,0,940,3,0,1.0
1130,7,1130,1.0,0,0,0,3,0,1.0
3260,8,2310,2.5,0,1,950,5,0,1.5
2480,7,2480,2.5,0,0,0,3,0,2.0
5403,12,5403,2.5,0,4,0,3,1,2.0
2350,8,2350,2.5,0,0,0,3,0,2.0
1180,6,1180,1.0,0,0,0,2,0,1.0
2350,8,1670,3.5,1,3,680,4,0,2.0
2080,7,1250,2.0,0,0,830,3,0,1.0
1780,8,1780,2.5,0,0,0,3,0,2.0
2440,9,1980,2.5,0,2,460,3,0,2.0
1470,7,1470,2.5,0,0,0,3,0,2.0
1210,8,1210,1.75,0,0,0,2,0,2.0
2380,8,2380,2.5,0,0,0,3,0,2.0
1710,7,1710,1.75,0,0,0,4,0,1.0
1020,6,1020,1.0,0,0,0,3,0,1.0
3290,10,2220,3.5,0,4,1070,4,0,2.0
1260,8,1260,2.5,0,0,0,3,0,3.0
2100,7,1200,2.0,0,0,900,4,0,1.0
1802,7,1802,1.0,0,0,0,2,0,1.0
900,6,900,1.0,0,0,0,2,0,1.0
3950,10,2910,2.25,0,4,1040,2,0,2.0
1540,7,1540,1.5,0,0,0,3,0,1.0
2530,8,1530,2.25,0,1,1000,4,0,1.0
1240,7,1240,2.5,0,0,0,2,0,2.0
1320,7,1320,1.0,0,0,0,3,0,1.0
1900,7,950,2.0,0,0,950,3,0,1.0
1770,8,1770,2.5,0,2,0,4,0,1.0
2620,7,1660,2.25,0,0,960,3,0,1.0
2050,8,1520,3.5,1,0,530,3,0,2.0
2020,7,2020,1.75,0,0,0,4,0,1.0
1000,7,1000,1.0,0,0,0,2,0,1.0
1080,7,1080,1.0,0,0,0,3,0,1.0
2620,8,2620,2.5,0,0,0,4,0,2.0
2830,9,1730,2.5,0,3,1100,3,0,1.0
1450,7,1450,1.5,0,0,0,3,0,1.0
2240,8,1730,2.25,0,0,510,4,0,1.0
2850,8,1950,3.5,0,0,900,4,0,2.0
1980,8,1980,2.25,0,0,0,3,0,1.0
2550,8,1750,3.0,0,0,800,4,0,1.5
2970,7,2130,2.75,1,1,840,4,0,1.5
2300,8,2300,2.5,0,0,0,3,0,2.0
900,7,900,1.0,0,0,0,2,0,1.0
1010,7,1010,1.0,0,0,0,3,0,1.0
1040,7,1040,1.0,0,0,0,3,0,1.0
960,7,960,1.0,0,0,0,3,0,1.0
2400,7,1370,3.75,0,0,1030,4,0,1.0
1880,7,940,1.75,0,0,940,4,0,1.0
5430,10,4010,3.5,1,2,1420,5,0,2.0
1560,7,1560,1.75,0,0,0,4,0,1.0
2800,8,1700,2.5,0,0,1100,4,0,1.0
3190,9,3190,2.5,0,0,0,3,0,2.0
4410,11,4410,3.5,1,0,0,4,0,2.0
1800,8,1800,2.5,0,0,0,3,0,2.0
1200,7,1200,1.5,0,0,0,3,0,1.0
2600,8,1820,3.5,0,0,780,4,0,2.0
2070,8,1360,2.25,1,0,710,4,0,1.0
1540,7,1020,2.0,0,0,520,2,0,1.0
1790,7,1090,1.0,0,0,700,3,0,1.5
1800,8,1440,1.75,0,0,360,3,0,1.0
2280,6,1760,1.75,0,0,520,3,0,1.5
2900,9,2900,2.25,0,0,0,3,0,2.0
2640,8,2640,2.5,0,0,0,4,0,2.0
3320,10,3320,2.5,0,0,0,3,0,1.0
1600,7,1600,1.0,0,0,0,3,0,1.0
3910,10,3910,2.5,0,0,0,3,0,2.0
2290,9,1670,2.0,0,0,620,3,0,1.0
3000,9,3000,2.5,0,0,0,4,0,2.0
3060,9,3060,2.5,0,0,0,4,0,2.0
1210,8,1210,1.0,1,1,0,3,0,1.0
1210,7,1210,1.5,0,0,0,3,0,1.0
1930,7,1930,2.5,0,0,0,4,0,2.0
2080,7,1550,2.25,0,0,530,3,0,1.5
1420,8,1070,1.0,0,0,350,2,0,1.0
2380,9,2380,2.5,0,0,0,3,0,2.0
5850,11,4670,3.5,1,2,1180,5,0,2.0
2520,7,2520,2.5,0,0,0,4,0,2.0
2260,7,1130,2.0,0,3,1130,3,0,1.0
1030,7,1030,1.0,0,0,0,3,0,1.0
720,5,720,1.0,0,0,0,2,0,1.0
1490,8,1490,1.75,0,2,0,2,0,1.0
4270,10,3180,4.0,0,3,1090,4,0,2.0
1430,7,1430,2.0,0,0,0,3,0,1.0
1910,8,1910,1.75,0,0,0,3,0,1.5
1150,6,1150,1.0,0,0,0,4,0,1.5
1750,8,1410,2.5,0,0,340,4,0,1.0
3170,9,3170,2.5,0,2,0,4,0,2.0
3790,11,3790,3.5,0,0,0,3,0,2.0
1410,7,1000,1.75,0,0,410,3,0,1.0
1481,7,1481,2.25,0,0,0,3,0,2.0
3780,11,3780,3.25,0,0,0,4,0,2.0
1100,7,900,1.5,0,0,200,2,0,2.0
2740,7,1370,1.75,0,0,1370,5,0,1.0
2760,10,2760,2.5,0,0,0,3,0,2.0
1690,8,1690,1.75,1,0,0,4,0,1.0
2240,8,2240,3.0,0,0,0,5,0,2.0
1190,6,1190,1.0,0,0,0,3,0,1.0
910,6,910,1.0,0,0,0,2,0,1.0
6530,11,6530,5.5,0,2,0,4,0,2.0
3200,9,2600,2.5,0,3,600,4,0,3.0
2830,9,2830,2.5,0,0,0,4,0,2.0
1700,9,1320,2.5,0,2,380,3,0,2.0
840,6,840,1.0,0,0,0,3,0,1.0
1020,7,1020,1.0,0,0,0,3,0,1.5
2790,9,2790,2.5,0,0,0,3,0,2.0
4250,7,3020,3.0,0,0,1230,6,0,2.5
2120,7,2120,2.0,0,0,0,3,0,2.0
2640,9,2640,2.5,0,0,0,4,0,2.0
1650,8,1650,2.5,0,0,0,3,0,2.0
1660,9,1660,3.0,0,0,0,3,0,3.0
5010,12,5010,3.25,1,0,0,4,0,2.0
780,5,780,1.0,0,0,0,1,0,1.0
3160,7,2190,3.25,0,0,970,5,0,1.0
2390,8,2390,3.0,0,0,0,3,0,1.5
1560,7,810,1.75,0,0,750,3,0,1.0
800,6,800,2.0,0,0,0,2,0,1.0
3480,11,3480,2.5,0,0,0,4,0,2.0
1440,7,1440,1.75,0,0,0,3,0,1.0
2120,8,2120,2.5,0,0,0,3,0,2.0
1270,6,980,1.75,0,0,290,3,0,1.5
1860,8,1310,1.75,0,0,550,3,0,1.0
390,4,390,1.0,0,0,0,0,0,1.0
1170,6,1170,1.0,0,0,0,3,0,1.0
1980,8,1380,1.75,0,1,600,4,0,1.0
2420,8,1370,2.5,0,0,1050,4,0,1.0
1170,6,1170,1.5,0,0,0,2,0,1.0
1660,8,1660,1.75,0,0,0,2,0,1.0
1790,8,1790,1.5,0,0,0,3,0,1.5
4830,11,3710,4.25,0,2,1120,5,0,2.5
1240,7,940,1.0,0,0,300,2,0,1.0
1420,7,1420,1.75,0,0,0,3,0,1.0
1440,7,1440,1.75,0,0,0,4,0,1.0
1470,4,1470,1.0,0,0,0,2,0,1.5
1650,7,1000,2.0,0,0,650,4,0,1.0
3360,10,3360,2.5,0,0,0,4,0,2.0
3560,11,3560,2.5,0,0,0,3,0,2.0
3000,10,3000,2.25,0,0,0,3,0,1.0
3284,8,3284,2.5,0,0,0,4,0,2.0
1410,6,1410,2.0,0,0,0,3,0,1.0
2940,9,2940,2.5,0,0,0,4,0,2.0
980,8,670,2.5,0,0,310,2,0,2.0
1590,7,1110,2.25,0,0,480,3,0,1.0
1850,6,1850,1.75,0,0,0,3,0,2.0
2300,9,2300,2.5,0,2,0,3,0,2.0
1590,6,1590,1.75,0,0,0,3,0,1.5
4060,9,2150,2.5,0,4,1910,4,0,1.0
1720,7,1720,2.5,0,0,0,3,0,2.0
980,8,980,2.5,0,0,0,2,0,3.0
1320,7,1320,1.75,0,0,0,3,0,1.0
2220,8,1450,2.25,1,0,770,4,0,1.0
2440,9,2440,2.5,0,0,0,3,0,2.0
1800,7,1800,2.5,0,0,0,3,0,2.0
850,7,850,1.0,0,0,0,2,0,1.0
1540,6,1540,2.0,0,0,0,3,0,1.5
2251,8,1390,1.75,0,1,861,4,0,1.0
2510,8,2510,2.5,0,0,0,4,0,2.0
2320,8,2320,2.5,0,0,0,3,0,2.0
1358,7,1358,2.25,0,0,0,3,0,3.0
2000,7,1140,1.75,0,0,860,3,0,1.0
3310,8,2200,3.5,0,2,1110,4,0,2.0
2440,7,1970,3.5,0,0,470,3,0,2.0
2750,8,1500,2.25,0,0,1250,4,0,1.0
1000,6,1000,1.0,0,0,0,3,0,1.0
1700,8,1700,2.5,0,0,0,4,0,2.0
1030,5,1030,1.0,0,2,0,3,0,1.0
900,5,900,1.0,0,0,0,2,0,1.0
3190,10,3190,2.5,0,0,0,4,0,2.0
1610,6,1610,1.5,0,0,0,3,0,1.0
2260,9,2260,2.5,0,0,0,4,0,2.0
2650,8,2650,2.5,0,0,0,4,0,2.0
1470,7,1180,3.25,0,0,290,3,0,2.0
3560,9,3560,2.0,0,2,0,6,0,2.5
1810,7,1810,1.75,0,0,0,4,0,2.0
2180,8,2180,2.5,0,0,0,3,0,1.0
1510,7,1090,2.25,0,0,420,3,0,1.0
4060,9,2660,1.75,0,0,1400,4,0,2.0
850,7,850,1.0,0,0,0,2,0,1.0
4070,10,4070,3.5,0,0,0,4,0,2.0
1510,8,1230,1.75,0,0,280,3,0,1.0
2640,8,2640,2.5,0,0,0,4,0,2.0
4560,9,3800,2.5,0,0,760,3,0,2.0
2230,9,2230,3.0,1,0,0,3,0,2.0
1480,6,940,1.5,0,0,540,2,0,1.0
1450,8,1450,2.0,0,0,0,3,0,1.5
1890,7,1230,1.75,0,0,660,3,0,1.0
1420,7,1160,2.25,0,0,260,3,0,1.0
1900,7,1900,2.5,0,0,0,4,0,2.0
1990,8,1990,2.25,0,0,0,3,0,2.0
1910,8,1910,2.25,0,0,0,3,0,2.0
2280,6,2280,2.0,0,0,0,5,0,1.5
1990,8,1190,1.75,0,0,800,3,0,1.0
2790,8,2790,2.75,0,0,0,4,0,2.0
2610,7,1360,2.75,0,0,1250,4,0,1.0
2850,10,1450,2.0,0,4,1400,4,0,1.0
1730,6,1730,1.0,0,0,0,4,0,1.5
810,6,810,1.0,0,0,0,2,0,1.0
1076,7,1076,1.5,0,0,0,2,0,3.0
1352,8,1352,2.25,0,0,0,3,0,3.0
4190,7,4190,2.5,0,0,0,4,0,2.0
1140,7,1140,1.0,0,0,0,2,0,1.0
1750,7,1050,1.75,0,0,700,4,0,1.5
1780,8,1780,2.5,0,0,0,3,0,2.0
1570,8,1570,1.0,0,0,0,3,0,2.0
2510,8,2510,1.75,0,0,0,5,0,1.5
1350,7,1350,1.0,0,0,0,3,0,1.0
2510,9,2510,2.5,0,0,0,3,0,2.0
1068,7,1068,1.5,0,0,0,2,0,2.0
860,7,860,1.0,0,0,0,2,0,1.0
970,7,770,1.0,0,0,200,2,0,1.0
2320,7,1720,3.5,0,0,600,5,0,2.0
1790,7,1790,1.75,0,0,0,3,0,1.5
2400,7,1460,2.25,0,0,940,4,0,1.5
5740,11,3610,4.5,1,2,2130,6,0,2.0
2310,8,2310,2.5,0,0,0,4,0,2.0
3600,9,3600,3.0,1,0,0,4,0,2.0
1140,6,1140,1.0,0,0,0,2,0,1.0
720,6,720,1.0,0,0,0,2,0,1.0
2100,7,1220,1.5,0,0,880,3,0,1.0
1240,7,1240,1.75,0,0,0,3,0,1.5
1190,7,1190,1.0,0,0,0,3,0,1.0
1620,6,1620,1.0,0,0,0,3,0,1.0
670,6,670,1.0,0,0,0,2,0,1.0
3360,9,3360,2.5,0,0,0,2,0,2.0
980,7,980,1.0,0,0,0,2,0,1.5
3800,10,2730,2.5,0,0,1070,3,0,2.0
2060,8,2060,2.5,0,0,0,4,0,2.0
1450,7,1450,1.75,0,0,0,4,0,1.0
1850,7,1850,2.0,0,0,0,3,0,1.0
700,6,700,1.0,0,0,0,2,0,1.0
2110,8,1440,1.75,0,0,670,3,0,1.0
1400,7,1160,3.25,0,0,240,3,0,2.0
1240,8,910,2.25,0,0,330,4,0,1.0
1620,8,1620,2.25,0,0,0,3,0,2.0
2980,8,1910,2.5,0,0,1070,4,0,1.0
3490,9,3490,3.0,0,0,0,5,0,2.0
1260,7,1260,2.0,0,0,0,3,0,2.0
3150,8,1870,2.5,0,0,1280,5,0,2.0
2300,7,1430,2.75,0,0,870,3,0,1.0
2570,8,2570,1.75,0,0,0,4,0,1.0
1370,7,1090,1.75,0,0,280,2,0,1.0
1180,7,1180,1.0,0,0,0,3,0,1.0
2403,9,2403,2.5,0,0,0,4,0,2.0
1880,8,1880,1.75,0,0,0,4,0,1.0
1550,7,1550,2.5,0,0,0,3,0,2.0
1010,7,1010,1.0,0,0,0,3,0,1.0
2900,8,1650,2.5,0,0,1250,5,0,1.0
2190,9,1520,3.0,0,0,670,4,0,1.0
1740,7,1160,2.25,0,2,580,4,0,1.0
1270,7,1270,1.5,0,0,0,3,0,1.0
1500,7,1500,1.75,0,0,0,3,0,1.0
1760,8,1760,2.25,0,0,0,3,0,2.0
1920,8,1920,2.0,0,0,0,3,0,1.0
1030,7,1030,1.5,0,0,0,3,0,1.0
1680,7,1680,2.0,0,0,0,3,0,1.0
3520,9,3520,2.5,0,0,0,3,0,2.5
880,7,880,1.0,0,0,0,2,0,1.0
2200,8,1430,2.5,0,0,770,4,0,2.0
1210,7,1210,1.0,0,0,0,3,0,1.5
2280,8,2280,2.5,1,0,0,4,0,2.0
1250,7,1250,1.75,0,0,0,3,0,1.0
750,6,750,1.0,0,0,0,2,0,1.0
2030,7,1150,2.5,0,0,880,4,0,1.0
1300,7,1300,1.75,0,0,0,3,0,1.0
3090,9,3090,3.25,0,0,0,5,0,2.0
2000,8,2000,2.5,0,0,0,3,0,2.0
1170,7,1170,1.0,0,0,0,2,0,1.0
1590,7,1590,2.5,0,0,0,3,0,2.0
1170,8,1170,2.25,0,0,0,3,0,3.0
3266,8,3266,3.25,0,0,0,4,0,2.0
2110,9,2110,2.5,0,0,0,4,0,2.0
2440,10,2440,2.5,0,0,0,4,0,2.0
1400,7,1400,1.75,0,0,0,3,0,1.0
3360,7,2040,2.75,0,0,1320,6,0,1.0
1630,8,1630,1.5,0,0,0,3,0,1.5
2040,7,1340,1.75,1,0,700,3,0,1.0
1830,8,1830,2.0,0,0,0,4,0,2.0
1500,8,1100,1.0,0,0,400,2,0,1.0
1600,8,1600,1.75,0,0,0,3,0,1.0
1090,8,1090,1.75,0,0,0,2,0,1.0
1700,8,1700,2.0,0,0,0,3,0,2.0
4150,9,4150,4.75,0,0,0,4,0,3.0
1710,8,1120,1.75,0,0,590,3,0,1.0
2500,7,1040,2.0,0,0,1460,5,0,1.0
4370,10,4370,3.0,0,0,0,4,0,2.0
2730,8,2730,2.75,0,0,0,5,0,2.0
1570,7,1570,1.0,0,0,0,3,0,2.0
2210,8,2210,1.0,0,0,0,4,0,2.0
1610,7,1610,2.25,0,0,0,3,0,2.0
1260,7,1260,2.0,0,0,0,3,0,1.0
1740,7,1220,2.5,0,0,520,4,0,1.0
2600,8,2600,2.5,0,0,0,3,0,2.0
1750,8,1750,2.5,0,0,0,3,0,2.0
1380,7,1380,1.75,0,0,0,3,0,1.0
2910,7,1920,2.0,0,0,990,3,0,2.0
2600,8,2600,2.5,0,0,0,4,0,2.0
1700,7,1700,2.5,0,0,0,4,0,1.0
3040,7,1520,2.25,0,0,1520,4,0,1.0
3600,10,2680,3.5,0,3,920,5,0,2.0
2810,9,1810,2.75,1,0,1000,4,0,1.0
2430,7,1410,1.75,0,0,1020,3,0,1.0
2390,8,1460,3.0,0,0,930,4,0,1.5
1620,7,1620,2.0,0,0,0,4,0,2.0
1900,7,1900,2.5,0,0,0,4,0,2.0
2200,7,1240,1.75,0,0,960,3,0,1.0
3080,8,1940,4.5,1,3,1140,4,0,2.0
760,5,760,1.0,0,0,0,3,0,1.0
900,7,900,1.0,0,0,0,2,0,1.0
800,6,800,1.0,0,0,0,2,0,1.0
4460,12,4460,2.5,1,0,0,3,0,2.0
4410,9,4410,3.5,0,0,0,5,0,2.0
710,6,710,1.0,0,0,0,2,0,1.0
3880,10,3060,3.5,0,0,820,4,0,2.0
1730,9,1730,2.5,0,0,0,3,0,3.0
2095,9,2095,2.5,0,0,0,4,0,2.0
1240,7,1240,1.75,0,0,0,2,0,1.5
2660,8,2660,3.25,0,0,0,3,0,2.5
4300,10,2710,3.5,0,0,1590,4,0,2.0
2790,8,2790,2.75,0,0,0,4,0,2.0
1620,7,1620,2.25,0,0,0,3,0,1.0
970,6,970,1.0,0,0,0,2,0,1.0
2390,6,1240,1.75,0,0,1150,3,0,1.0
2760,8,2760,2.25,0,0,0,3,0,1.0
4340,10,4340,4.5,0,4,0,5,0,3.0
1050,7,1050,1.0,0,0,0,3,0,1.0
970,7,970,1.0,0,0,0,3,0,1.0
1940,8,1290,1.75,1,0,650,3,0,1.0
1810,7,1810,2.25,0,0,0,4,0,2.0
1740,8,1740,2.0,0,0,0,3,0,1.0
2420,8,1420,2.25,0,0,1000,3,0,1.0
1740,8,1130,2.5,1,0,610,3,0,2.0
1690,7,1690,1.75,0,0,0,3,0,1.0
970,6,970,1.0,0,0,0,3,0,1.0
1620,7,1620,2.5,0,0,0,3,0,1.0
2160,7,1360,2.5,0,0,800,3,0,1.0
3170,9,3170,2.5,0,0,0,4,0,2.0
2090,8,2090,2.5,0,0,0,4,0,2.0
1060,5,1060,1.0,0,0,0,2,0,1.0
1210,8,1120,2.25,0,0,90,2,0,2.0
890,6,890,1.0,0,0,0,2,0,1.0
2200,8,2200,2.25,0,0,0,3,0,2.0
2283,8,2283,2.5,0,0,0,3,0,2.0
3190,8,2430,3.5,0,0,760,5,0,2.0
2620,8,1320,1.75,0,0,1300,3,0,1.0
1780,8,1780,2.5,0,0,0,4,0,2.0
1240,7,1060,1.0,0,0,180,3,0,1.0
1150,7,1150,1.0,0,0,0,3,0,1.0
740,6,740,1.0,0,0,0,2,0,1.0
3270,9,3270,2.5,0,0,0,4,0,2.0
2690,7,1840,2.5,0,0,850,3,0,2.0
2240,9,2240,2.25,0,0,0,3,0,2.0
840,6,840,1.0,0,0,0,2,0,1.0
1660,7,1660,2.0,0,0,0,4,0,1.0
1490,7,1490,2.0,0,0,0,3,0,1.0
3370,9,2650,2.75,0,0,720,3,0,2.0
1730,8,1730,2.5,0,0,0,2,0,3.5
1000,7,1000,1.75,0,0,0,3,0,1.0
1230,7,1230,1.0,0,0,0,2,0,1.0
3100,8,3100,4.5,0,0,0,5,0,2.0
1810,8,1310,2.5,0,0,500,3,0,1.0
1970,7,1970,2.5,0,0,0,3,0,2.0
1960,7,1220,2.5,0,0,740,4,0,1.0
1230,7,1090,1.75,1,1,140,4,0,1.0
1520,8,1520,2.25,0,0,0,3,0,3.0
3230,9,3230,3.25,0,0,0,4,0,2.0
590,6,590,0.75,0,0,0,1,0,1.0
1060,6,1060,1.0,0,2,0,3,0,1.0
1380,7,1380,1.0,0,0,0,3,0,1.5
1420,8,1420,1.75,0,0,0,3,0,1.0
2420,9,2420,2.5,0,0,0,4,0,2.0
2030,7,1220,2.0,0,0,810,3,0,1.0
2460,8,2460,1.75,0,0,0,4,0,2.0
1970,7,1140,1.75,0,0,830,4,0,1.0
2580,9,2580,2.5,1,2,0,3,0,1.0
1140,8,1140,2.25,0,0,0,3,0,3.0
1110,6,970,1.0,0,0,140,2,0,1.5
2210,7,1540,2.25,0,0,670,3,0,1.0
2070,8,2070,2.5,0,0,0,4,0,2.0
2300,8,1150,2.25,1,0,1150,3,0,1.0
1070,9,720,2.0,0,0,350,2,0,2.0
880,7,880,1.0,0,0,0,2,0,1.0
3070,9,3070,2.5,0,0,0,3,0,2.0
1670,7,1170,1.0,0,0,500,3,0,1.5
2040,6,810,2.0,0,0,1230,3,0,1.0
1940,8,1940,2.5,0,0,0,3,0,2.0
2100,7,1240,2.75,0,0,860,4,0,1.0
2130,7,1250,2.0,0,0,880,4,0,1.0
1790,7,1790,2.5,0,0,0,4,0,1.0
1490,7,1090,1.0,1,0,400,2,0,1.0
1200,7,1070,1.0,0,0,130,2,0,1.0
1300,7,1300,2.0,0,0,0,2,0,1.0
1330,7,1330,1.0,0,0,0,4,0,1.5
2770,9,2770,2.5,0,0,0,4,0,2.0
1570,8,1570,2.5,0,0,0,3,0,3.0
2900,7,2900,2.0,0,0,0,5,0,2.0
1170,6,1170,1.0,0,0,0,2,0,1.0
1060,6,1060,1.0,0,0,0,3,0,1.0
760,6,760,1.0,0,0,0,2,0,1.0
1500,7,1500,1.0,0,0,0,4,0,1.0
2730,8,2730,2.25,0,0,0,4,0,2.0
3040,9,1760,2.75,0,3,1280,6,0,1.0
1170,7,1170,1.0,0,0,0,3,0,1.0
1960,7,1260,1.75,0,0,700,4,0,1.0
1580,7,1580,2.25,1,0,0,3,0,2.0
1880,7,1880,2.5,0,0,0,3,0,2.0
2610,7,1980,2.25,1,0,630,3,0,2.0
3920,10,3920,2.5,0,0,0,4,0,2.0
880,7,880,1.0,0,0,0,2,0,1.0
1690,8,1150,2.5,0,0,540,3,0,2.0
1740,7,1740,2.5,0,0,0,3,0,2.0
1830,9,1530,2.5,0,0,300,2,0,2.0
1940,8,1940,2.5,0,0,0,3,0,2.0
3650,10,1850,2.25,1,0,1800,5,0,1.0
1920,8,1920,2.0,0,0,0,3,0,1.0
960,7,960,1.0,0,0,0,3,0,1.0
2570,8,1470,2.25,0,1,1100,5,0,1.0
1590,7,1590,2.5,0,0,0,3,0,2.0
3920,9,2820,3.5,0,0,1100,5,0,2.0
2130,8,1330,2.5,0,0,800,2,0,1.0
1850,7,1850,2.5,0,0,0,3,0,2.0
1240,7,1240,1.0,0,0,0,3,0,1.0
3500,8,2760,3.25,0,0,740,5,0,2.0
2520,8,2520,2.5,0,0,0,4,0,2.0
1660,8,1660,1.5,0,0,0,3,0,2.0
1010,6,1010,1.0,0,0,0,3,0,1.0
960,7,760,1.0,1,0,200,1,0,1.0
2510,8,2510,2.5,0,0,0,4,0,2.0
2910,9,1830,3.25,0,3,1080,4,0,2.0
2230,7,1390,1.75,0,0,840,6,0,1.0
1270,7,1270,1.0,0,0,0,3,0,1.0
1540,7,1540,2.0,0,0,0,2,0,2.0
1480,7,1480,2.0,0,0,0,3,0,2.0
2830,8,2830,2.5,0,0,0,4,0,2.0
1950,7,1010,1.75,0,0,940,2,0,1.0
3430,10,2390,4.0,0,0,1040,4,0,2.0
2810,9,2810,2.75,0,0,0,4,0,2.0
2680,8,1440,2.5,0,0,1240,3,0,1.0
2470,8,2470,3.0,0,0,0,3,0,2.0
1740,7,1740,1.0,0,0,0,3,0,1.5
3370,10,3370,2.5,0,0,0,4,0,2.0
2850,10,1790,2.5,0,4,1060,3,1,1.5
1000,6,1000,1.0,0,0,0,2,0,1.0
4470,9,3240,2.25,1,2,1230,3,0,2.0
1870,8,1870,2.5,0,0,0,3,0,2.0
1660,7,1660,2.5,0,0,0,3,0,2.0
1590,7,990,2.0,0,2,600,4,0,1.0
1170,7,1170,2.0,0,0,0,2,0,1.0
1220,7,1220,2.0,0,0,0,4,0,1.0
1830,7,930,2.5,0,0,900,2,0,1.0
2480,8,1500,3.0,0,0,980,3,0,1.0
1780,7,900,2.0,0,0,880,4,0,1.0
1560,8,1560,1.75,0,0,0,3,0,1.0
1690,8,1690,2.5,1,0,0,3,0,1.0
1980,7,1440,2.0,0,0,540,3,0,1.5
2880,8,1580,1.75,0,0,1300,3,0,1.0
1490,8,1490,2.5,0,0,0,3,0,2.0
1760,7,1060,1.75,0,0,700,3,0,1.0
2070,7,1170,2.25,0,0,900,3,0,1.0
970,7,970,1.0,0,0,0,2,0,1.0
1330,6,710,1.75,0,0,620,3,0,1.0
2120,7,1720,2.25,0,0,400,5,0,1.5
1600,7,1600,2.0,0,0,0,4,0,1.0
2560,8,1510,2.25,0,0,1050,3,0,1.0
2000,7,2000,2.0,0,0,0,4,0,1.5
1940,7,1940,1.0,0,0,0,4,0,1.5
1800,8,1340,2.25,0,0,460,3,0,1.0
1500,8,1500,2.0,0,0,0,3,0,2.0
1440,7,1000,2.5,0,0,440,3,0,1.0
1310,8,1310,2.5,0,0,0,2,0,2.0
2260,8,2260,2.5,0,0,0,3,0,2.0
1210,8,1000,3.25,0,0,210,3,0,2.0
1150,6,1150,1.0,0,0,0,2,0,1.0
2420,8,2420,2.75,0,0,0,4,0,2.0
1840,7,920,1.0,0,0,920,3,0,1.0
1660,6,1010,1.75,0,0,650,4,0,1.0
1840,6,1840,2.0,0,0,0,3,0,1.0
2770,8,2770,2.75,0,0,0,4,0,2.0
3440,11,2560,3.5,0,0,880,4,0,2.0
870,6,870,1.0,0,0,0,2,0,1.0
2090,8,2090,2.25,0,0,0,3,0,2.0
2450,7,1340,2.25,0,2,1110,6,0,1.0
3340,9,3340,2.75,0,0,0,4,0,2.0
1000,8,1000,1.0,0,0,0,3,0,1.0
1030,7,1030,1.0,1,0,0,3,0,1.0
1970,7,1970,2.5,0,0,0,4,0,2.0
1100,7,780,1.75,0,0,320,3,0,2.0
1570,7,1570,2.0,0,0,0,3,0,1.0
2010,8,1390,2.5,0,0,620,3,0,2.0
1920,10,1780,2.5,0,2,140,3,0,2.0
1350,7,1350,2.0,0,0,0,3,0,1.0
3720,10,3720,2.5,0,0,0,4,0,2.0
3350,8,2180,3.0,0,0,1170,5,0,2.0
2470,8,2470,2.5,0,0,0,4,0,2.0
3600,9,2510,4.5,0,0,1090,6,0,2.0
2680,8,2680,2.5,0,0,0,4,0,2.0
960,7,960,1.0,0,0,0,2,0,1.0
1560,7,1130,1.0,0,0,430,2,0,1.0
930,6,930,1.0,0,0,0,2,0,1.0
2100,9,2100,2.5,1,0,0,3,0,2.0
1490,6,990,1.75,0,0,500,3,0,1.0
1200,7,1200,1.0,0,0,0,3,0,1.0
2090,7,1470,2.5,0,0,620,4,0,1.0
2432,9,2432,2.5,0,2,0,3,0,2.0
2770,10,2770,2.25,0,0,0,3,0,2.0
2310,8,2310,2.0,1,0,0,5,0,1.5
4200,9,2910,2.25,1,0,1290,5,0,2.5
2730,9,2730,2.25,0,2,0,3,0,2.0
1610,7,1610,2.0,0,0,0,3,0,1.0
1350,6,1350,1.0,0,0,0,3,0,1.5
2130,8,2130,2.5,0,0,0,3,0,2.0
1960,7,1750,2.25,0,0,210,3,0,2.0
2990,8,2990,2.5,0,0,0,4,0,2.0
1590,7,1590,2.5,0,0,0,3,0,2.0
1450,7,1450,1.5,0,0,0,3,0,1.0
1200,7,1200,2.0,0,0,0,3,0,1.0
2280,7,1510,2.5,0,0,770,4,0,1.5
1640,7,1640,2.5,0,0,0,3,0,2.0
1620,6,1620,1.0,0,0,0,3,0,1.0
2240,8,2240,2.5,0,0,0,3,0,2.0
2640,8,1440,2.75,0,2,1200,4,0,1.0
2510,9,2510,1.75,0,0,0,2,0,2.0
810,6,810,1.0,0,0,0,2,0,1.0
2810,9,1900,3.5,0,0,910,5,0,2.0
1700,8,1700,1.0,0,0,0,3,0,1.5
2330,9,1920,3.0,0,0,410,3,0,2.0
1460,8,1130,3.25,0,0,330,3,0,2.0
1880,6,940,1.0,0,0,940,2,0,1.0
2120,8,1500,2.5,1,0,620,4,0,1.0
1210,6,1210,1.0,0,0,0,3,0,1.0
760,7,760,1.0,0,0,0,2,0,1.0
1000,6,600,1.75,0,0,400,2,0,1.0
1010,6,1010,1.0,0,0,0,2,0,1.0
1960,8,1290,2.25,1,0,670,5,0,1.0
1680,7,1330,1.75,0,0,350,4,0,1.0
1500,7,1500,1.0,0,0,0,3,0,1.0
1410,7,1410,1.75,0,0,0,3,0,1.0
1540,7,1540,2.0,0,0,0,2,0,2.0
1320,7,1320,1.75,0,0,0,3,0,1.0
840,6,840,0.75,0,0,0,1,0,1.5
1680,8,1680,1.75,0,0,0,2,0,1.0
1270,7,1270,1.0,0,0,0,3,0,1.5
2550,7,2550,2.5,0,0,0,2,0,2.5
1410,7,1410,1.5,0,0,0,3,0,1.0
1710,7,1710,1.5,0,0,0,3,0,2.0
3840,9,3840,3.5,0,0,0,5,0,2.0
3780,9,3780,2.5,1,0,0,4,0,2.0
1830,7,1490,1.75,0,0,340,3,0,2.0
1760,8,1760,1.75,0,0,0,3,0,1.0
1830,7,1830,2.5,0,0,0,4,0,2.0
1260,7,810,1.75,0,0,450,3,0,2.0
2610,9,2610,2.5,0,0,0,4,0,2.0
860,5,860,1.0,0,0,0,2,0,1.0
2500,8,2500,3.0,0,0,0,3,0,2.0
3940,10,3230,4.75,1,0,710,5,0,2.0
1870,7,1100,2.5,0,0,770,4,0,1.0
2350,8,1520,2.75,1,0,830,5,0,1.5
1820,7,1820,2.0,0,0,0,4,0,2.0
1700,7,1700,2.0,1,2,0,3,0,2.0
810,7,810,1.0,0,0,0,2,0,1.0
1770,7,960,1.0,0,0,810,2,0,1.5
1490,8,1490,2.0,1,0,0,3,0,1.0
2160,7,1080,2.25,0,0,1080,4,0,1.0
1210,8,1210,1.75,0,0,0,3,0,1.5
2060,7,2060,2.5,0,0,0,4,0,2.0
1770,7,1770,2.25,0,0,0,4,0,2.0
1930,8,1280,1.75,0,0,650,4,0,1.0
2590,8,2590,2.5,0,0,0,4,0,2.0
1380,7,940,1.0,0,0,440,3,0,1.0
1760,8,1290,1.5,0,3,470,3,0,1.5
2690,8,2020,2.25,1,3,670,5,0,1.0
1880,8,1880,2.5,0,0,0,3,0,2.0
1960,7,1340,1.75,0,0,620,4,0,1.0
2120,7,1060,1.0,0,0,1060,2,0,1.0
1540,9,1540,2.25,0,0,0,2,0,3.0
1390,7,1390,1.75,0,0,0,3,0,1.0
1860,8,1860,2.5,0,0,0,3,0,2.0
950,7,850,1.5,0,0,100,2,0,2.0
2880,8,1520,2.5,1,4,1360,3,0,1.0
710,6,710,1.0,0,0,0,2,0,1.0
2280,8,1250,1.0,0,2,1030,3,0,1.0
2510,7,2510,2.5,0,0,0,3,0,2.0
2670,10,2670,2.5,0,0,0,3,0,1.0
790,6,790,1.0,0,0,0,2,0,1.0
2440,8,2440,2.5,0,0,0,4,0,2.5
1990,7,1030,2.25,0,0,960,4,0,1.0
1100,7,1100,1.0,0,0,0,3,0,1.0
9640,12,4820,6.75,1,4,4820,5,1,1.0
2500,8,1590,2.5,0,0,910,4,0,1.0
1150,7,1150,1.75,0,0,0,3,0,1.0
1800,7,1690,2.5,0,0,110,3,0,2.0
1550,7,1550,1.75,0,0,0,5,0,1.5
2070,7,1260,1.75,0,0,810,2,0,1.0
2480,9,1330,2.25,0,4,1150,3,0,1.0
2250,8,1200,2.75,0,0,1050,4,0,1.0
1010,5,1010,1.0,0,0,0,3,0,1.0
2670,8,1940,2.5,0,0,730,4,0,2.0
2180,9,2180,2.25,0,0,0,3,0,2.0
2130,8,2130,2.5,0,0,0,4,0,2.0
2030,8,1530,1.5,0,0,500,4,0,1.5
2650,8,2650,2.5,0,0,0,4,0,2.0
3130,9,2140,2.75,0,0,990,4,0,2.0
1540,7,1540,2.25,0,0,0,3,0,3.0
1930,8,1930,2.0,0,0,0,2,0,1.0
1730,7,980,1.75,1,0,750,4,0,1.0
2370,9,2370,2.5,1,0,0,4,0,2.0
700,6,700,1.0,0,0,0,2,0,1.0
1730,8,1730,1.75,0,0,0,3,0,1.0
2060,8,1050,2.5,1,0,1010,3,0,1.0
2150,8,2150,2.25,0,0,0,4,0,2.0
2460,7,2460,2.5,0,0,0,4,0,2.0
1310,7,1310,1.75,0,0,0,3,0,1.0
2170,8,2170,2.25,0,0,0,3,0,1.0
870,6,740,2.0,0,0,130,2,0,1.0
3444,8,2714,3.25,0,0,730,4,0,2.0
1300,7,1300,1.0,0,0,0,3,0,1.0
2870,9,2870,2.75,0,0,0,5,0,2.0
2730,9,2730,2.5,1,0,0,4,0,2.0
4210,10,4210,3.5,0,0,0,4,0,2.0
1580,8,900,1.5,0,0,680,3,0,1.0
800,6,680,1.0,0,0,120,1,0,1.0
770,6,770,1.0,0,0,0,2,0,1.0
1570,7,1570,2.5,0,0,0,2,0,3.0
3000,8,2400,3.5,0,2,600,6,0,2.0
2020,7,2020,2.25,0,0,0,4,0,2.0
2390,8,1970,2.5,0,0,420,3,0,2.0
1800,7,1200,1.5,0,0,600,3,0,1.0
1714,8,1714,2.5,0,0,0,4,0,2.0
1400,7,1400,1.5,0,0,0,3,0,1.0
830,7,830,1.5,0,0,0,2,0,2.0
1580,7,1580,1.0,0,2,0,4,0,1.5
3310,9,2400,3.5,0,0,910,4,0,2.0
1840,8,1370,2.25,0,0,470,3,0,1.0
2190,8,1760,2.5,1,0,430,3,0,1.0
2040,6,1430,1.75,0,0,610,2,0,1.0
1060,7,1060,1.5,0,0,0,3,0,1.0
2680,8,2680,2.5,1,0,0,4,0,2.0
1820,8,1240,2.25,0,0,580,3,0,1.0
2250,7,1250,2.0,0,0,1000,3,0,1.0
1420,7,1420,2.0,0,0,0,3,0,1.0
2560,7,2560,2.25,0,0,0,4,0,2.0
1440,6,720,1.75,0,0,720,4,0,1.0
2280,8,1270,2.0,0,3,1010,4,0,1.0
1980,7,1310,1.75,0,0,670,3,0,1.0
2610,9,1660,3.25,0,0,950,3,0,1.5
2320,8,2320,2.75,0,0,0,4,0,2.0
1040,7,1040,1.0,0,0,0,3,0,1.0
1410,7,1410,1.0,0,0,0,2,0,1.0
2160,7,2160,2.5,0,0,0,4,0,2.0
1180,7,1180,1.0,0,0,0,3,0,1.5
1480,7,1170,1.5,0,0,310,3,0,1.0
1890,7,1190,1.5,0,0,700,3,0,1.0
1230,6,1230,1.0,0,0,0,4,0,1.5
2920,10,2920,2.5,0,0,0,4,0,2.0
2260,8,2260,2.5,0,0,0,4,0,2.0
840,7,840,1.0,0,0,0,2,0,1.0
860,6,860,1.0,0,0,0,2,0,1.0
1830,7,1830,1.75,0,0,0,3,0,1.0
1520,7,1520,1.0,0,0,0,3,0,1.5
2160,8,2160,2.5,0,0,0,3,0,2.0
1740,8,1130,2.5,0,0,610,3,0,1.0
1370,7,1370,2.0,0,0,0,3,0,1.0
3190,9,3190,2.0,0,0,0,3,0,2.0
2500,8,2500,3.5,0,0,0,3,0,2.0
2120,7,2120,2.5,0,0,0,3,0,2.0
4010,12,4010,2.5,0,0,0,4,0,2.0
1090,8,1090,1.5,0,0,0,2,0,3.0
1640,6,1640,1.0,0,0,0,3,0,1.5
3210,10,3210,2.5,0,0,0,4,0,2.0
3140,10,3140,2.5,0,0,0,3,0,2.0
1510,7,1510,2.0,0,0,0,4,0,1.5
1140,7,1140,1.5,0,0,0,3,0,2.0
1780,8,1350,1.75,0,0,430,3,0,1.0
1040,7,1040,1.0,0,0,0,3,0,1.0
2370,8,2370,2.5,0,0,0,4,0,2.0
4460,9,4460,3.25,0,0,0,3,0,2.0
3090,7,1590,2.0,0,0,1500,4,0,1.0
2320,7,2320,1.75,0,0,0,3,0,2.0
1320,7,1320,1.75,0,0,0,4,0,1.0
1920,7,1170,1.75,0,0,750,4,0,1.0
1960,7,1260,1.0,0,0,700,3,0,1.0
2780,8,2180,3.5,0,0,600,5,0,2.0
1920,7,1060,1.5,0,0,860,2,0,1.0
3420,9,2270,3.0,1,0,1150,6,0,1.0
1670,7,1170,2.5,0,0,500,4,0,1.0
1450,7,1450,2.25,0,0,0,3,0,2.0
1650,7,1100,1.5,0,0,550,3,0,1.0
2520,7,1260,1.75,0,0,1260,4,0,1.0
1280,8,1280,2.0,0,0,0,2,0,2.0
1250,7,1250,1.0,0,0,0,3,0,1.0
2120,7,1620,2.5,0,0,500,4,0,1.0
1810,7,1810,2.75,0,0,0,4,0,1.5
1640,8,1640,2.25,0,0,0,2,0,2.0
1600,7,1600,2.0,0,0,0,4,0,1.0
1060,7,1060,1.75,0,0,0,2,0,2.0
2090,8,1340,2.75,0,0,750,3,0,1.0
1780,9,1780,1.75,0,0,0,3,0,1.0
1520,7,1520,2.5,0,0,0,3,0,2.0
3620,8,1900,3.0,1,2,1720,5,0,1.0
1700,6,1200,1.0,0,0,500,3,0,1.5
1950,8,1230,2.75,0,0,720,3,0,1.0
3090,8,3090,2.0,0,0,0,4,0,2.5
3220,8,2610,2.5,0,0,610,4,0,2.0
1970,8,1970,2.5,0,0,0,3,0,2.0
1900,7,1900,2.5,0,0,0,4,0,2.0
3120,9,3120,2.5,0,0,0,4,0,2.0
1910,7,1410,2.0,0,0,500,3,0,1.0
1540,8,1540,2.5,0,0,0,4,0,2.0
1210,8,1210,1.75,0,0,0,2,0,2.0
1340,7,1340,1.75,0,0,0,3,0,1.5
1430,7,1150,1.0,0,0,280,2,0,1.5
2230,7,1300,2.25,0,0,930,4,0,1.0
770,7,770,1.0,0,0,0,2,0,1.0
1430,6,730,1.0,0,0,700,4,0,1.0
1960,8,1210,1.5,0,0,750,2,0,1.0
1680,7,1680,2.0,0,0,0,3,0,1.0
1850,7,1850,1.5,0,2,0,2,0,1.5
4270,10,3170,3.5,0,3,1100,4,0,2.0
4390,11,3060,3.5,1,3,1330,4,0,2.0
2890,8,2890,2.5,0,2,0,4,0,2.0
880,6,880,1.0,0,0,0,2,0,1.0
1610,7,1080,1.75,0,0,530,3,0,1.0
2150,7,2150,1.5,0,0,0,4,0,1.0
1010,6,1010,1.0,0,0,0,3,0,1.0
1820,7,910,2.0,0,0,910,5,0,1.0
3320,10,3320,2.5,1,0,0,4,0,2.0
3160,7,3160,3.0,0,0,0,2,0,2.0
3820,11,3310,3.25,1,1,510,4,0,2.0
1730,5,1730,1.5,0,0,0,4,0,1.5
3390,9,3390,2.75,0,0,0,5,0,2.0
2640,8,1620,2.25,0,0,1020,4,0,1.0
2780,9,1560,1.75,1,0,1220,4,0,1.0
2643,8,2643,2.5,0,0,0,4,0,2.0
2340,8,1510,1.75,0,0,830,3,0,1.5
2040,8,2040,2.5,0,0,0,3,0,2.0
2190,7,2190,2.25,0,0,0,4,0,2.0
2640,10,2640,2.75,0,0,0,4,0,2.0
1220,7,1220,1.75,0,0,0,3,0,1.0
1640,7,870,1.75,0,0,770,4,0,1.5
1450,6,1150,1.0,0,0,300,3,0,1.0
1620,8,1620,2.0,0,0,0,3,0,1.5
1300,6,1300,1.0,0,0,0,3,0,1.0
1030,7,1030,1.0,0,0,0,3,0,1.0
1510,6,1510,1.0,0,0,0,3,0,1.5
950,7,950,1.0,0,0,0,3,0,1.0
1370,7,1370,1.75,0,0,0,3,0,1.0
1140,5,1140,1.0,0,0,0,4,0,1.0
2100,7,1080,1.75,0,0,1020,3,0,1.0
1760,7,780,2.0,0,1,980,4,0,1.0
2180,7,1100,2.25,0,0,1080,4,0,1.0
910,5,910,1.0,0,0,0,2,0,1.0
1320,7,1320,1.0,0,0,0,3,0,1.5
3200,9,2500,3.5,0,2,700,4,0,2.0
3640,10,3640,3.25,0,0,0,4,0,2.0
2770,8,1650,2.75,0,0,1120,3,0,1.0
1480,9,1480,1.75,0,0,0,3,0,2.5
2220,8,2220,1.75,0,0,0,3,0,1.0
2950,7,1810,2.75,0,0,1140,4,0,2.0
1790,8,1790,2.5,0,0,0,3,0,2.0
1630,7,1080,1.75,0,0,550,3,0,1.0
2580,8,2580,2.5,1,0,0,4,0,2.0
1150,7,1150,1.0,0,0,0,3,0,1.0
1780,7,1780,2.5,0,0,0,3,0,2.0
1350,8,1350,1.0,0,0,0,4,0,1.5
2490,9,1580,2.5,0,4,910,3,1,1.0
2760,8,1690,2.75,1,0,1070,3,0,1.0
1900,7,1900,2.75,0,0,0,3,0,1.0
1650,8,1470,1.75,1,0,180,3,0,1.0
2740,9,2740,3.25,0,0,0,4,0,2.5
1330,7,1330,1.75,0,0,0,3,0,1.0
3300,8,3300,4.5,0,0,0,6,0,2.0
1410,7,1410,2.5,0,0,0,3,0,2.0
1720,7,1720,1.0,0,0,0,3,0,1.0
1430,7,1430,2.25,0,0,0,3,0,2.0
1350,8,1350,1.75,0,0,0,2,0,1.0
960,6,960,1.0,0,0,0,2,0,1.5
1880,7,1280,2.25,0,0,600,3,0,1.0
2200,7,1910,3.25,0,2,290,3,0,2.0
1460,7,1460,1.5,0,0,0,2,0,1.5
3550,10,3550,2.5,0,0,0,3,0,2.0
1210,7,1210,1.75,0,0,0,3,0,1.0
2610,8,1920,2.5,0,0,690,4,0,1.5
3200,8,2000,2.0,0,0,1200,3,0,1.0
1710,7,1200,1.0,0,0,510,3,0,1.5
1980,7,1170,2.25,0,0,810,4,0,1.0
1470,7,1470,2.5,0,0,0,3,0,2.0
2300,8,1290,2.5,0,0,1010,5,0,1.0
2160,7,1580,2.25,0,0,580,3,0,2.0
1520,7,1520,1.5,0,0,0,3,0,1.0
1010,7,1010,1.0,0,0,0,2,0,1.0
1820,8,1570,2.5,0,0,250,3,0,2.0
4700,11,3910,4.25,1,1,790,4,0,2.0
2120,7,1220,1.75,0,0,900,6,0,1.5
2980,8,1590,2.75,1,0,1390,3,0,1.5
2050,7,1300,2.75,0,0,750,4,0,1.0
3500,9,3500,2.5,0,2,0,4,0,2.0
1420,6,1090,1.0,0,0,330,3,0,1.0
2610,8,2610,2.5,0,0,0,4,0,2.0
2630,8,2630,2.5,0,0,0,5,0,1.5
3520,10,3520,2.5,0,0,0,4,0,2.0
1280,7,850,1.5,0,0,430,2,0,1.0
1650,7,1650,2.25,0,0,0,3,0,2.0
1100,7,1100,1.0,0,0,0,2,0,1.0
3760,9,2780,3.75,0,0,980,5,0,2.0
1300,7,1300,1.75,0,0,0,3,0,1.0
1890,7,1890,2.5,0,0,0,3,0,2.0
4010,11,3150,3.5,1,3,860,4,0,2.0
1820,7,1820,2.25,0,0,0,3,0,1.0
1760,7,1760,2.25,0,0,0,3,0,2.0
1820,7,930,1.75,0,0,890,4,0,1.0
2050,7,1050,1.5,0,0,1000,4,0,1.0
1520,8,1520,2.5,0,0,0,4,0,2.0
4410,9,2350,2.5,0,2,2060,6,0,1.0
2200,8,2200,2.5,0,0,0,3,0,2.0
2460,9,2460,2.5,0,0,0,3,0,2.0
1445,7,1300,2.25,0,0,145,3,0,2.0
2320,8,2270,1.75,0,0,50,4,0,1.0
1510,7,1510,1.75,0,0,0,3,0,1.0
1750,5,1750,2.0,0,0,0,4,0,1.0
3020,9,3020,2.25,0,0,0,3,0,2.0
4290,10,3590,3.25,1,0,700,5,0,2.5
1670,7,1670,1.5,0,2,0,3,0,2.0
5240,10,5240,5.25,0,2,0,4,0,2.0
1140,7,1140,1.0,0,0,0,2,0,1.0
1820,7,1820,2.5,0,0,0,4,0,2.0
2950,9,2450,3.25,0,0,500,3,0,2.0
1460,7,1460,2.5,0,0,0,3,0,2.0
1540,7,1440,1.75,0,0,100,3,0,1.0
2290,7,2290,2.0,0,3,0,4,0,1.5
1280,8,1060,2.5,0,0,220,2,0,2.0
720,6,720,1.0,0,0,0,2,0,1.0
760,6,760,1.0,0,0,0,2,0,1.0
2425,9,2425,2.5,0,0,0,4,0,2.0
2260,8,1760,3.25,0,0,500,3,0,2.0
920,7,920,1.5,0,0,0,2,0,2.0
1220,7,1220,1.5,1,0,0,3,0,2.0
3020,9,3020,2.5,0,0,0,4,0,2.5
2220,10,2220,2.5,0,2,0,3,0,3.0
1320,7,1320,1.5,0,0,0,3,0,1.0
800,6,800,1.0,0,0,0,2,0,1.0
2660,9,2660,2.5,1,0,0,4,0,2.0
2690,7,2690,2.5,0,0,0,4,0,2.0
2030,7,2030,2.5,0,0,0,3,0,2.0
1100,7,1100,1.5,0,0,0,4,0,1.0
1330,7,1330,1.0,0,0,0,3,0,1.0
1330,8,1060,2.25,0,0,270,2,0,2.0
1140,5,1140,1.0,0,0,0,2,0,1.0
2730,8,1410,2.0,0,0,1320,4,0,1.0
2490,9,2150,2.5,0,0,340,4,0,2.0
1370,7,1370,1.75,0,0,0,3,0,1.0
2480,8,2480,2.5,0,2,0,4,0,2.0
2590,9,2240,3.0,0,2,350,4,0,2.0
1470,8,1470,1.75,0,0,0,3,0,1.0
1980,8,1980,2.5,0,0,0,3,0,2.0
2701,9,2701,2.5,0,0,0,4,0,2.0
1140,6,840,1.0,0,0,300,3,0,1.0
4280,10,4280,4.5,0,0,0,5,0,2.0
1790,7,1490,1.75,0,0,300,4,0,1.0
2650,8,1680,2.5,0,0,970,4,0,1.0
2230,8,2230,2.5,0,0,0,3,0,1.0
2240,7,1380,2.75,0,0,860,4,0,2.0
990,7,990,1.5,0,0,0,3,0,1.0
3010,8,3010,2.5,0,0,0,6,0,2.0
1490,8,1350,1.75,0,0,140,4,0,1.0
2220,8,2220,2.5,0,0,0,3,0,2.0
3680,9,2340,3.25,0,0,1340,3,0,2.0
2260,9,1690,2.25,0,0,570,3,0,1.0
1780,7,1780,1.75,0,0,0,4,0,1.0
2290,8,2290,2.5,0,0,0,4,0,2.0
1820,7,1220,2.0,0,0,600,4,0,1.0
1270,6,650,1.0,0,0,620,3,0,1.0
2170,8,2170,2.5,0,0,0,2,0,1.0
2890,9,2890,2.75,1,0,0,4,0,2.0
3170,10,2360,2.5,0,0,810,3,0,2.0
2720,8,1790,3.0,0,0,930,4,0,1.5
1760,8,1760,2.5,0,0,0,3,0,2.0
2840,8,1420,2.5,0,2,1420,4,0,1.0
1010,7,860,1.0,0,0,150,3,0,1.0
1840,8,1840,2.5,0,0,0,4,0,2.0
2130,9,2130,2.25,1,0,0,4,0,2.0
2100,7,2100,1.75,0,0,0,3,0,1.0
1260,8,1260,2.5,0,0,0,2,0,3.0
1640,7,1640,1.5,0,0,0,3,0,2.0
1876,9,1876,3.25,0,0,0,3,0,3.0
3140,7,1940,2.0,0,1,1200,4,0,1.0
1280,6,1280,1.0,0,0,0,2,0,1.5
2200,7,1440,1.5,1,0,760,3,0,2.0
1990,7,1870,1.75,0,0,120,4,0,2.0
2840,8,2240,2.25,1,0,600,4,0,1.0
1790,8,1790,2.5,0,0,0,3,0,2.0
2330,10,2330,2.5,0,2,0,3,0,1.0
1750,7,1180,2.5,0,0,570,3,0,1.0
1490,7,1490,1.75,0,0,0,3,0,1.0
1490,6,970,1.75,0,0,520,4,0,1.0
1010,7,1010,1.0,0,0,0,3,0,1.0
1520,7,1520,2.5,0,0,0,3,0,2.0
1340,7,1080,1.0,0,0,260,3,0,1.0
7880,13,7880,4.75,0,2,0,5,0,2.0
1290,7,1290,1.75,0,0,0,3,0,1.0
2701,7,2701,2.5,0,0,0,4,0,2.0
1130,6,1130,1.0,0,0,0,2,0,1.0
2150,7,1240,2.5,0,0,910,4,0,1.0
3120,9,3120,2.5,0,0,0,3,0,2.0
2259,7,1491,1.75,0,3,768,3,0,1.5
1230,6,1230,1.0,0,0,0,3,0,1.0
1670,7,1670,2.5,0,0,0,3,0,2.0
2400,7,2400,2.5,0,0,0,5,0,2.0
2820,7,1540,1.75,0,0,1280,3,0,1.0
1890,8,1890,1.75,1,0,0,2,0,2.0
1530,7,1010,2.5,0,0,520,3,0,1.5
2180,8,2180,2.5,0,0,0,3,0,2.0
1060,7,1060,1.5,0,0,0,3,0,1.0
1690,8,1150,2.5,0,0,540,3,0,2.0
2780,9,2780,2.5,0,0,0,3,0,1.0
2260,8,2260,2.75,0,0,0,4,0,1.0
2450,8,2450,2.5,0,0,0,4,0,2.0
2850,7,2040,3.5,0,0,810,4,0,1.5
2280,9,2280,2.0,0,0,0,2,0,2.0
3760,11,1910,4.0,1,3,1850,5,0,1.0
2320,8,2320,2.25,0,4,0,2,1,2.0
1410,7,1410,1.5,0,0,0,3,0,1.0
1850,7,1150,2.0,0,0,700,3,0,1.0
2910,9,2910,3.5,0,0,0,4,0,2.0
2080,8,2080,2.5,0,0,0,4,0,1.0
1422,7,1422,2.25,0,0,0,3,0,2.0
1400,7,1400,1.75,0,0,0,4,0,1.5
2990,8,2990,2.5,0,0,0,4,0,2.0
1580,8,1010,2.5,1,0,570,3,0,2.0
2340,8,1670,2.5,0,0,670,5,0,1.0
3530,9,3530,2.5,0,0,0,4,0,2.0
1100,7,1100,1.0,0,0,0,3,0,1.0
2240,8,2240,2.5,0,0,0,4,0,2.0
1990,9,1990,2.0,0,0,0,4,0,2.0
4570,11,4570,3.5,0,0,0,4,0,2.0
1690,7,1690,2.5,0,0,0,3,0,2.0
2710,8,2040,3.5,0,0,670,4,0,2.0
2160,7,2160,2.5,0,0,0,3,0,1.0
1570,7,1570,1.5,0,0,0,3,0,1.0
1310,8,1060,3.25,0,0,250,3,0,2.0
800,6,800,1.0,0,0,0,1,0,1.0
1600,8,1600,1.75,0,2,0,3,0,1.0
2100,7,2100,2.5,0,0,0,4,0,2.0
1780,7,1780,2.5,0,0,0,3,0,2.0
2920,9,2920,2.5,0,0,0,3,0,2.0
3580,10,1840,2.75,0,0,1740,4,0,1.0
1280,6,1280,1.0,0,0,0,3,0,1.0
1060,7,940,1.0,0,0,120,2,0,1.0
2150,7,2150,1.5,0,0,0,4,0,1.0
2860,7,1800,3.25,0,0,1060,5,0,1.0
2180,8,2180,2.5,0,0,0,4,0,2.0
2130,8,1290,2.5,0,0,840,4,0,1.0
1140,7,620,1.75,0,0,520,3,0,1.0
1970,7,1970,2.5,0,0,0,4,0,2.0
1660,7,1240,1.75,0,0,420,3,0,1.0
1220,7,1220,1.5,0,0,0,3,0,1.0
1140,7,1140,1.0,0,0,0,2,0,1.0
2760,8,2760,2.5,1,0,0,4,0,2.0
790,6,790,1.0,0,0,0,2,0,1.0
2600,8,2600,2.5,0,0,0,3,0,2.0
3060,8,1530,2.5,0,0,1530,6,0,1.0
3560,8,3560,2.5,0,0,0,4,0,3.0
1830,8,1830,2.25,0,0,0,3,0,2.0
1040,6,1040,1.0,0,0,0,3,0,1.0
1920,7,1920,3.0,0,0,0,4,0,1.0
1233,7,963,2.5,0,0,270,2,0,2.0
1150,7,1150,2.25,0,0,0,2,0,2.0
1260,7,1040,3.0,0,0,220,3,0,2.0
1660,8,1660,1.75,0,0,0,4,0,1.0
3810,10,3810,2.75,1,0,0,5,0,2.0
2240,7,2240,2.25,0,0,0,5,0,2.0
2190,8,2190,2.5,0,0,0,4,0,2.0
1180,7,1180,1.0,0,0,0,2,0,1.0
1510,6,1250,2.0,0,0,260,2,0,1.0
1620,8,1100,2.5,1,0,520,3,0,2.0
1350,7,1350,1.75,0,0,0,3,0,1.0
1830,8,1830,2.75,0,0,0,4,0,2.0
1870,8,1230,2.0,0,0,640,3,0,1.0
2630,9,1700,2.5,0,0,930,4,0,1.0
1180,6,1180,1.0,0,2,0,1,0,1.0
3050,8,1650,3.25,0,4,1400,3,1,1.0
2410,7,1600,1.75,0,0,810,4,0,1.0
5080,11,5080,3.25,1,0,0,4,0,2.0
1390,6,860,1.75,0,0,530,3,0,1.0
3730,10,3730,2.5,0,0,0,4,0,2.0
1280,7,1280,2.0,0,0,0,3,0,1.0
3190,9,1940,2.75,1,3,1250,4,0,1.0
950,7,780,1.0,0,0,170,3,0,1.0
3230,8,2000,3.0,0,0,1230,5,0,1.5
1600,6,1600,1.5,0,0,0,4,0,1.5
1570,7,1570,1.75,0,0,0,3,0,2.0
3610,8,3610,3.0,0,0,0,5,0,2.0
1540,7,1540,2.0,0,0,0,4,0,1.0
1560,7,1260,2.0,0,0,300,3,0,1.0
2100,8,2100,2.5,0,2,0,4,0,1.0
1500,7,1060,2.0,0,0,440,3,0,1.0
2180,8,1660,2.25,1,0,520,3,0,1.0
3370,8,1920,2.75,0,3,1450,4,0,1.0
1040,7,1040,2.5,0,0,0,3,0,3.0
1740,7,1240,1.75,0,0,500,3,0,1.0
1830,7,1230,2.0,0,0,600,3,0,1.0
2610,7,1750,2.25,0,0,860,5,0,2.0
1630,7,1630,1.75,0,0,0,4,0,1.5
2550,7,2550,2.5,0,0,0,4,0,2.0
1950,9,1950,2.5,0,0,0,3,0,2.0
1390,9,1150,4.0,0,0,240,3,0,2.0
2540,10,2540,2.5,0,0,0,3,0,2.0
1660,7,1660,2.5,0,0,0,3,0,2.0
2910,9,1850,2.5,0,0,1060,4,0,1.5
1590,7,1590,2.0,0,0,0,3,0,1.0
3270,11,3270,2.75,0,0,0,3,0,1.5
1460,7,1460,1.0,0,0,0,3,0,1.5
1450,9,1450,2.0,0,0,0,2,0,3.0
3150,7,2430,2.75,0,0,720,4,0,1.5
3300,10,3300,2.75,0,0,0,5,0,2.0
2730,10,1900,3.25,0,1,830,3,0,2.0
1610,7,1610,1.0,0,0,0,3,0,1.5
2185,9,2185,2.5,0,0,0,3,0,2.0
960,5,960,1.0,0,0,0,3,0,1.0
1300,7,1300,1.0,1,0,0,3,0,1.0
1330,8,1330,2.25,0,0,0,2,0,3.0
3450,8,2970,2.5,0,0,480,3,0,3.0
2270,8,1300,1.75,0,0,970,4,0,1.0
2490,8,1720,3.5,0,0,770,3,0,2.0
3450,9,3450,3.5,0,3,0,5,0,2.0
2430,9,2430,2.5,1,1,0,3,0,2.0
1750,7,950,2.0,0,0,800,3,0,1.0
1900,8,1720,2.0,0,2,180,5,0,1.0
1790,7,1090,1.0,0,0,700,3,0,1.5
2540,8,1340,1.75,0,0,1200,6,0,1.0
4150,11,4150,3.5,0,0,0,5,0,2.0
1400,7,700,1.75,0,0,700,3,0,1.0
3850,9,2290,3.0,1,0,1560,5,0,1.0
3010,8,3010,2.5,0,0,0,4,0,2.0
820,7,820,1.0,0,0,0,2,0,1.0
2200,8,2200,1.75,0,0,0,4,0,2.0
1200,7,1200,1.0,0,0,0,3,0,1.0
1914,8,1914,2.5,0,0,0,4,0,2.0
3450,10,3450,2.5,0,0,0,4,0,2.0
2570,7,2570,1.75,0,0,0,3,0,2.0
3180,10,3180,2.25,0,0,0,4,0,2.0
1160,7,890,1.5,0,0,270,2,0,2.0
2000,8,1430,2.0,1,0,570,3,0,1.0
1590,7,1080,1.5,0,0,510,3,0,1.0
1414,8,1414,2.5,1,0,0,2,0,2.0
1460,7,990,1.75,0,0,470,3,0,1.0
1500,7,1500,1.5,0,0,0,3,0,1.0
3490,9,3170,3.0,0,0,320,3,0,2.5
2390,9,2390,2.5,0,0,0,4,0,2.0
1460,7,850,1.75,0,0,610,2,0,1.0
2070,7,2070,2.5,0,0,0,5,0,2.0
2670,8,2670,2.5,0,0,0,4,0,2.0
1400,7,710,1.75,0,0,690,2,0,1.0
1690,7,1290,1.5,0,0,400,4,0,1.0
3000,10,2410,3.25,0,0,590,2,0,1.0
1495,8,1405,2.5,0,0,90,3,0,3.0
3580,7,3480,3.25,0,4,100,4,1,1.5
2760,8,1900,3.25,0,0,860,4,0,2.0
1880,7,1180,1.75,0,0,700,4,0,1.0
780,6,780,1.0,0,0,0,1,0,1.5
1550,6,1550,1.0,0,0,0,3,0,1.5
3260,8,1630,2.75,0,0,1630,5,0,1.0
2330,8,2330,2.25,0,0,0,4,0,2.0
2200,8,1480,2.25,0,0,720,4,0,1.0
2010,8,1440,2.25,0,0,570,4,0,1.0
1270,8,1270,2.5,0,0,0,3,0,2.0
1330,8,1330,1.75,0,0,0,3,0,1.0
1090,6,790,1.0,0,0,300,3,0,1.0
1430,7,1430,1.5,0,0,0,0,0,3.0
2320,8,2320,2.5,0,0,0,4,0,2.0
2620,9,2620,2.5,0,0,0,3,0,2.0
1860,7,1240,1.75,0,0,620,3,0,1.0
1930,8,1930,1.75,0,0,0,2,0,1.0
1540,7,1540,1.5,0,0,0,2,0,2.0
2440,9,2440,2.5,0,0,0,4,0,2.0
2240,8,2240,2.25,1,0,0,4,0,2.0
1880,8,1880,1.75,1,0,0,3,0,1.0
2040,7,1300,2.25,0,0,740,4,0,1.0
950,8,950,1.0,0,0,0,2,0,1.0
1470,7,1470,2.0,0,0,0,4,0,1.0
1060,7,1060,1.0,0,0,0,2,0,1.0
2400,9,2400,2.5,0,0,0,3,0,1.0
2630,7,1830,2.0,0,0,800,4,0,1.5
1580,7,1180,1.75,0,0,400,3,0,1.0
2600,8,1390,2.25,0,0,1210,4,0,1.0
1660,7,1660,1.5,0,0,0,3,0,1.5
3490,9,3490,2.5,0,0,0,4,0,2.0
1010,7,1010,1.0,0,0,0,3,0,1.0
1000,6,1000,1.0,0,0,0,3,0,1.0
1710,8,1710,1.75,0,0,0,4,0,1.0
3040,8,3040,2.25,0,0,0,5,0,2.0
2120,7,2120,2.75,0,0,0,3,0,1.0
2460,9,2460,2.75,0,0,0,3,0,2.0
630,7,630,1.0,0,0,0,1,0,1.0
1930,7,1430,2.0,0,0,500,4,0,1.0
1230,7,1230,2.0,0,0,0,3,0,1.0
1870,7,1870,2.5,0,0,0,3,0,2.0
960,6,820,1.0,0,0,140,3,0,1.0
1320,7,1320,1.0,1,0,0,3,0,1.0
4420,10,3410,4.25,0,0,1010,4,0,2.0
1580,7,1580,2.0,0,2,0,4,0,1.5
1190,8,1050,2.25,0,0,140,3,0,2.0
1590,7,1590,1.75,0,0,0,4,0,2.0
1200,7,1200,1.75,0,0,0,3,0,1.0
1180,7,1180,1.0,0,0,0,3,0,1.0
2060,8,2060,2.5,0,0,0,3,0,2.0
1320,7,1320,2.0,0,0,0,3,0,3.0
1760,7,1150,1.75,0,0,610,3,0,1.0
2230,9,2230,2.5,1,0,0,3,0,2.0
3910,10,2490,3.5,0,0,1420,4,0,2.0
3010,9,2000,3.75,0,0,1010,6,0,2.0
2450,8,2450,2.25,0,0,0,4,0,2.0
2540,7,1270,1.75,0,0,1270,3,0,1.0
1870,7,1270,2.0,0,0,600,3,0,1.0
2510,8,1990,3.5,0,0,520,4,0,2.0
1020,6,1020,1.75,0,0,0,2,0,1.0
2890,8,1560,2.75,0,0,1330,4,0,1.0
1820,7,1820,1.5,0,0,0,4,0,1.5
1980,9,1320,1.75,0,2,660,3,0,1.0
1390,8,1390,1.75,0,0,0,3,0,1.0
2190,8,2190,2.75,0,0,0,3,0,2.0
3400,8,2740,3.25,0,0,660,5,0,2.0
2770,7,2770,2.5,0,0,0,4,0,2.0
3070,9,3070,3.0,1,0,0,5,0,2.0
880,6,880,1.0,0,0,0,2,0,1.0
1310,7,1310,1.5,0,0,0,3,0,1.0
960,7,960,1.0,0,0,0,3,0,1.0
2640,7,2640,2.5,0,0,0,4,0,2.0
1110,7,1110,1.0,0,0,0,3,0,1.0
3230,10,2220,3.0,0,3,1010,3,0,2.0
4386,10,2356,3.25,0,0,2030,4,0,1.0
6670,12,4960,4.0,1,0,1710,5,0,2.0
2600,9,2600,2.5,0,0,0,4,0,2.0
1090,7,1090,1.0,0,0,0,3,0,1.0
2470,7,1550,2.25,0,2,920,3,0,1.0
2080,9,2080,2.5,0,0,0,4,0,2.0
1300,7,1300,2.0,0,0,0,3,0,1.0
1030,7,1030,1.0,0,0,0,3,0,1.0
1630,7,1630,1.0,0,0,0,3,0,1.0
860,7,860,1.0,0,0,0,2,0,1.0
1400,7,1200,2.5,0,0,200,3,0,1.0
1370,6,1370,1.5,0,0,0,3,0,1.0
2217,7,2217,2.5,0,0,0,3,0,2.0
3420,9,3420,3.5,0,0,0,3,0,1.5
2906,9,2906,2.5,0,0,0,4,0,2.0
1130,7,1130,1.0,0,0,0,2,0,1.0
1313,8,1313,2.0,0,0,0,2,0,1.0
1540,7,1190,1.75,0,0,350,2,0,1.0
2220,7,1380,2.0,0,0,840,4,0,1.5
3310,9,3310,3.5,0,0,0,3,0,2.0
1300,7,860,2.75,0,0,440,3,0,1.0
1830,7,1830,2.5,0,0,0,4,0,2.0
2010,8,1170,2.25,0,0,840,4,0,1.0
1810,7,1240,1.75,0,0,570,3,0,1.0
1560,7,910,2.0,0,0,650,3,0,1.0
2470,8,2470,2.5,0,0,0,4,0,3.0
1280,8,1280,2.5,0,0,0,3,0,3.0
3200,10,3200,4.0,0,0,0,4,0,2.0
2880,9,2220,3.0,0,0,660,3,0,2.0
2286,8,2286,2.5,0,0,0,4,0,2.0
1770,7,1340,2.25,0,0,430,3,0,1.0
1270,8,1270,2.0,0,0,0,3,0,3.0
1010,6,1010,1.0,0,0,0,3,0,1.5
1392,7,1392,0.75,0,0,0,2,0,1.5
3630,10,3630,3.5,0,0,0,4,0,2.0
1510,7,1510,1.5,0,0,0,3,0,1.0
1910,7,1010,1.0,0,0,900,3,0,1.0
890,7,890,1.0,0,0,0,2,0,1.0
1800,9,900,1.0,0,2,900,3,0,1.0
1750,7,1330,2.5,0,0,420,3,0,1.0
1290,7,1290,1.0,0,0,0,3,0,1.0
1130,7,1130,1.0,0,0,0,2,0,1.0
2330,8,2330,2.5,0,0,0,4,0,2.0
2050,8,1370,3.25,1,0,680,4,0,2.0
1860,7,1860,1.5,0,1,0,3,0,2.0
1480,8,1480,2.5,0,0,0,3,0,3.0
820,6,820,1.0,0,2,0,2,0,1.0
1620,7,1620,1.5,0,0,0,3,0,2.0
1400,6,1400,1.75,0,0,0,3,0,2.0
1960,8,1960,2.25,0,0,0,3,0,2.0
2740,9,2740,4.0,0,0,0,4,0,2.0
1580,7,1200,2.25,0,0,380,3,0,1.0
1820,7,1820,1.75,0,0,0,4,0,2.5
2420,8,2420,2.5,0,0,0,4,0,2.0
1470,7,1470,1.0,0,0,0,3,0,1.0
1270,7,1270,1.5,0,0,0,2,0,1.0
2100,8,2100,2.25,0,0,0,4,0,2.0
1690,8,1410,2.5,0,0,280,3,0,2.0
1390,7,1390,1.5,0,0,0,3,0,1.0
2270,7,2270,2.0,0,0,0,4,0,1.0
3150,8,1810,2.75,0,3,1340,4,0,1.0
2120,7,2120,2.5,0,0,0,4,0,2.0
2510,9,2510,2.0,0,0,0,4,0,1.0
3080,9,3080,2.5,0,0,0,4,0,2.0
1350,7,1110,2.0,0,0,240,3,0,1.0
2180,8,2180,2.5,0,0,0,3,0,2.0
1530,8,1530,1.5,1,0,0,3,0,1.0
3200,9,3200,3.5,0,0,0,4,0,2.0
1230,7,1230,2.5,0,0,0,3,0,1.0
1750,7,1750,1.0,0,0,0,4,0,1.0
1690,7,1140,2.5,0,0,550,4,0,1.5
3860,8,2300,2.5,0,3,1560,5,0,1.0
1240,7,1240,0.75,0,0,0,3,0,1.0
1530,8,1530,2.0,1,0,0,3,0,1.0
1430,6,1430,2.0,0,0,0,5,0,1.5
2100,7,1720,1.75,0,0,380,4,0,1.5
1100,6,1100,2.0,0,0,0,3,0,1.0
2420,8,2200,1.5,0,0,220,3,0,2.0
3290,9,3290,2.5,0,0,0,4,0,2.0
1720,8,1720,2.5,0,0,0,2,0,2.0
1810,8,1230,1.75,0,0,580,3,0,1.0
2560,8,1690,2.5,1,0,870,2,0,2.0
1420,7,1420,2.0,0,0,0,4,0,1.0
1890,8,1890,1.75,0,0,0,3,0,1.0
2530,7,2530,3.0,0,0,0,4,0,2.0
1580,6,1580,1.5,0,0,0,3,0,1.0
2060,8,2060,2.25,0,0,0,3,0,2.0
2110,7,1460,1.0,0,0,650,2,0,1.5
2450,8,2450,2.5,0,0,0,4,0,2.0
1620,7,1620,2.0,0,0,0,3,0,1.0
4490,11,3800,4.5,1,2,690,4,0,2.0
1290,7,1290,1.0,0,0,0,2,0,2.0
2670,8,2320,1.5,0,0,350,7,0,1.5
1930,8,1260,2.0,0,0,670,3,0,1.0
2166,8,2166,2.75,0,0,0,5,0,2.0
2680,9,1590,2.5,0,4,1090,4,1,1.0
1730,8,1730,2.0,0,0,0,4,0,2.0
1560,8,1320,2.0,0,0,240,4,0,1.0
1480,8,1480,1.75,0,0,0,3,0,1.0
4600,9,2300,2.5,0,3,2300,5,0,1.0
1660,9,1660,2.5,0,0,0,3,0,3.0
1500,8,1150,3.25,0,0,350,3,0,2.0
1270,7,1270,2.0,0,0,0,3,0,1.0
2160,7,1760,2.25,0,0,400,3,0,1.5
1220,7,1220,1.5,0,0,0,3,0,1.5
1200,6,1200,1.0,0,0,0,3,0,1.0
1540,8,1540,2.0,0,0,0,3,0,1.0
1230,7,1230,1.75,0,0,0,3,0,1.0
2140,8,1680,2.0,0,0,460,3,0,2.0
1860,7,1200,1.5,0,0,660,3,0,1.0
700,5,700,1.0,0,0,0,2,0,1.0
1860,7,1400,2.25,0,0,460,4,0,1.0
800,5,800,1.0,0,0,0,2,0,1.0
1810,7,1130,1.0,0,0,680,3,0,1.0
2720,9,2720,1.75,0,0,0,3,0,1.5
1590,8,1590,3.5,0,0,0,3,0,3.0
2310,7,2310,1.5,0,0,0,4,0,2.0
2730,9,2730,2.5,0,0,0,2,0,2.0
2300,8,1360,2.5,0,0,940,4,0,1.0
1740,8,1740,2.5,0,0,0,3,0,3.0
1180,7,1180,1.0,1,0,0,3,0,1.5
2360,7,2360,2.5,0,0,0,3,0,2.0
1413,8,1413,2.25,0,0,0,3,0,2.0
1630,8,1630,2.5,0,0,0,3,0,3.0
1610,8,1610,2.5,0,0,0,3,0,2.0
1410,9,1410,2.25,0,0,0,3,0,3.0
720,6,720,1.0,0,0,0,2,0,1.0
1980,7,1290,2.25,0,0,690,3,0,1.0
5100,10,3640,3.75,0,0,1460,7,0,2.0
3250,9,3250,2.25,1,0,0,4,0,2.0
1610,7,1070,1.75,1,0,540,3,0,1.0
1890,7,1890,2.5,0,0,0,4,0,2.0
2520,9,2520,2.5,0,0,0,4,0,2.0
2240,7,2240,3.0,0,0,0,4,0,2.0
3210,9,3210,2.75,0,0,0,5,0,2.0
1760,7,1190,2.25,0,0,570,3,0,1.0
1010,6,1010,1.0,1,0,0,3,0,1.0
4070,11,4070,3.5,1,0,0,3,0,2.0
2000,7,2000,2.5,0,0,0,4,0,2.0
910,7,910,1.0,0,2,0,3,0,1.0
2519,8,2519,1.75,0,0,0,3,0,2.0
2420,7,2420,2.75,0,0,0,4,0,1.5
2130,7,1330,2.75,0,0,800,4,0,1.0
1830,7,1610,1.75,0,0,220,5,0,1.5
2700,8,2700,3.5,0,0,0,4,0,1.5
1070,7,1070,1.0,0,0,0,3,0,1.0
760,6,760,1.0,0,0,0,2,0,1.0
910,7,910,1.0,0,0,0,3,0,1.0
1520,7,1520,2.25,0,0,0,3,0,2.0
2290,7,1400,2.75,0,0,890,3,0,1.0
2850,9,2850,1.75,0,0,0,5,0,1.0
1500,7,1120,1.0,0,0,380,3,0,1.0
1320,7,1320,1.0,0,0,0,3,0,1.0
1410,7,960,2.5,0,0,450,3,0,2.0
2960,9,2960,3.5,0,0,0,4,0,2.0
1730,7,1730,1.5,0,0,0,4,0,1.0
1820,8,1340,2.25,0,0,480,4,0,1.0
2630,8,2630,2.5,0,0,0,3,0,2.0
1940,8,1940,2.5,0,0,0,3,0,2.0
2230,7,2230,2.5,0,0,0,3,0,2.0
2280,7,1150,2.25,0,1,1130,3,0,1.0
2720,7,1580,1.75,0,0,1140,3,0,1.5
4770,12,4770,4.0,1,0,0,5,0,2.0
1000,5,1000,1.0,0,4,0,2,0,1.0
1220,7,860,1.75,0,0,360,2,0,1.0
1590,7,1590,1.5,0,0,0,3,0,1.5
1960,7,1020,1.5,1,0,940,3,0,1.0
1460,8,1000,1.75,0,0,460,2,0,2.0
1990,7,1230,2.0,1,0,760,3,0,1.5
2020,8,2020,2.5,0,0,0,4,0,2.0
2440,8,2440,2.0,1,0,0,5,0,2.0
1010,6,1010,2.0,1,0,0,3,0,1.0
2410,8,2410,2.5,0,0,0,3,0,2.0
3250,9,3250,2.5,0,2,0,4,0,1.0
1430,7,1430,2.0,0,0,0,3,0,1.0
1120,7,1000,1.5,0,0,120,2,0,2.0
1920,8,1320,2.75,0,0,600,3,0,1.0
2020,7,1220,3.0,0,0,800,5,0,1.0
1120,7,1120,1.0,0,0,0,3,0,1.0
2460,8,2460,2.25,0,0,0,4,0,1.0
1980,7,1220,3.0,0,0,760,5,0,1.0
2360,7,1440,2.5,0,0,920,4,0,1.0
780,6,780,1.0,0,0,0,2,0,1.0
5710,11,5710,4.25,0,0,0,4,0,2.0
1740,7,950,1.0,0,0,790,2,0,1.0
2670,8,2670,1.5,0,0,0,4,0,2.0
1130,7,1130,1.0,0,0,0,3,0,1.0
3510,10,2700,3.5,0,0,810,5,0,2.0
1880,7,940,1.75,0,0,940,2,0,1.0
1650,7,1650,1.75,0,0,0,3,0,1.0
2846,8,1976,2.5,0,0,870,4,0,1.5
2400,7,1440,3.0,0,0,960,3,0,1.0
1870,7,1060,2.0,0,0,810,3,0,1.0
1420,7,1420,1.75,0,0,0,4,0,1.5
2920,10,2920,2.5,0,0,0,4,0,2.0
1530,7,830,1.75,0,1,700,2,0,1.0
3810,9,3810,3.0,0,0,0,4,0,2.0
890,6,890,1.0,0,0,0,2,0,1.0
1500,7,1190,1.0,0,0,310,2,0,1.0
1420,7,1420,1.75,0,0,0,3,0,1.0
1410,7,1410,2.0,0,0,0,3,0,1.0
3510,10,3510,2.75,0,0,0,3,0,2.0
3340,9,3340,2.75,0,0,0,4,0,2.0
2190,7,2190,2.25,0,0,0,4,0,2.0
3810,10,3810,4.5,0,0,0,5,0,2.0
1670,7,1670,1.75,0,0,0,3,0,1.0
2110,6,1220,2.0,0,0,890,3,0,1.5
2060,8,2060,2.5,0,0,0,3,0,2.0
3090,9,3090,2.5,0,0,0,4,0,2.0
2320,9,2320,2.5,0,2,0,3,0,2.0
3500,7,3500,4.5,0,0,0,6,0,2.0
2380,8,2380,2.5,0,0,0,3,0,2.0
1010,7,1010,1.0,0,0,0,3,0,1.0
1670,8,1670,2.25,0,0,0,3,0,3.0
4490,12,4490,3.5,0,4,0,3,1,2.0
1500,8,1500,2.0,0,3,0,2,0,3.0
1590,7,1190,1.0,0,0,400,5,0,1.5
1960,6,980,2.0,0,3,980,3,0,1.0
1930,8,1930,2.5,0,0,0,3,0,2.0
1170,7,1170,1.5,0,0,0,3,0,1.0
2680,8,2680,3.0,0,0,0,3,0,1.0
1470,7,1470,2.0,0,0,0,3,0,1.0
4240,10,3500,3.5,1,0,740,3,0,2.0
2460,7,1230,1.75,1,0,1230,3,0,1.0
2060,6,2060,2.5,0,0,0,4,0,2.0
2120,8,2120,4.5,1,4,0,5,1,2.0
2550,7,1850,2.5,0,0,700,3,0,1.5
1530,7,1530,1.0,0,0,0,3,0,1.0
2830,8,2830,2.25,1,0,0,5,0,2.0
2030,8,1630,1.75,0,0,400,3,0,1.0
2930,9,2310,2.75,1,0,620,4,0,1.0
1640,7,840,1.75,0,0,800,2,0,1.0
1920,8,1460,2.25,1,2,460,3,0,1.0
2040,8,1260,2.75,1,0,780,4,0,1.0
1960,8,1960,2.5,0,0,0,3,0,2.0
3560,7,3560,4.5,0,0,0,6,0,2.0
2720,8,2100,3.5,0,0,620,4,0,2.0
1030,7,765,1.75,0,0,265,2,0,2.0
3550,10,2180,3.0,0,0,1370,4,0,1.5
4560,12,4560,3.5,0,2,0,3,0,2.0
3400,9,3400,3.5,0,0,0,4,0,2.0
1480,8,1480,2.25,0,0,0,3,0,3.0
1590,7,1590,1.75,0,0,0,3,0,1.0
2330,8,2330,2.5,0,0,0,4,0,2.0
1040,7,1040,1.5,0,0,0,3,0,1.0
1900,7,1170,2.0,0,0,730,6,0,1.0
2070,8,2070,2.5,0,0,0,4,0,2.0
1270,7,1270,1.0,0,0,0,3,0,1.0
920,7,920,1.0,0,0,0,3,0,1.0
2180,6,1280,1.5,0,0,900,4,0,1.0
1820,7,1820,2.5,0,0,0,4,0,2.0
4560,9,4170,3.5,1,0,390,4,0,2.0
1670,7,1670,1.75,0,0,0,4,0,1.0
1770,7,1770,2.0,1,0,0,3,0,1.0
2180,8,2180,2.5,0,0,0,3,0,2.0
1890,8,1460,2.5,0,0,430,3,0,1.5
2510,8,2510,2.5,0,0,0,4,0,2.0
1010,7,1010,1.0,0,0,0,2,0,1.0
2250,8,2250,2.25,0,0,0,4,0,2.0
3760,10,2640,3.0,0,0,1120,3,0,1.0
710,7,710,1.0,0,0,0,2,0,2.0
3370,8,2140,3.25,0,0,1230,5,0,2.0
2880,9,2100,2.75,0,0,780,4,0,1.5
1210,6,1210,1.75,0,0,0,3,0,1.0
2040,8,2040,2.5,0,0,0,3,0,2.0
3320,10,2600,2.5,0,0,720,3,0,1.0
2720,8,2120,2.5,0,0,600,4,0,1.0
1800,7,1050,2.75,0,0,750,4,0,1.0
3030,8,3030,2.75,0,0,0,4,0,2.0
1800,8,1800,1.75,0,3,0,4,0,2.0
680,6,680,1.0,0,0,0,2,0,1.0
790,6,790,1.0,0,0,0,2,0,1.0
2150,7,1240,2.5,0,0,910,4,0,1.0
1580,7,790,2.0,0,0,790,3,0,1.0
2800,8,2320,2.0,0,0,480,3,0,1.0
1370,7,1010,2.5,0,0,360,3,0,2.0
3910,9,2710,3.25,0,0,1200,5,0,2.0
1680,7,1680,2.0,0,0,0,4,0,2.0
1610,8,1310,1.75,0,0,300,3,0,1.0
2331,8,2331,2.5,0,0,0,4,0,2.0
2410,8,1410,1.75,0,0,1000,3,0,1.0
1570,7,1310,1.75,0,0,260,3,0,1.0
2180,7,1190,2.5,0,0,990,4,0,1.0
1370,8,1370,2.0,0,0,0,2,0,1.0
1770,8,1270,2.25,0,0,500,3,0,1.0
3000,8,3000,2.25,0,0,0,5,0,2.0
1520,7,1520,1.0,0,0,0,2,0,2.0
2700,8,2700,2.5,0,0,0,4,0,2.0
1850,7,1850,1.75,0,0,0,2,0,2.5
1040,6,1040,1.0,0,0,0,2,0,1.0
1300,7,840,1.75,0,0,460,3,0,2.0
2530,9,2530,2.5,0,0,0,3,0,2.0
1590,6,1590,1.0,0,0,0,3,0,1.5
2810,9,1750,2.5,0,0,1060,3,0,1.0
790,6,790,1.0,0,0,0,2,0,1.0
2090,7,1090,2.5,0,0,1000,4,0,1.0
820,6,820,1.0,0,0,0,2,0,1.0
2980,8,2980,3.75,0,0,0,5,0,3.0
1820,7,910,2.5,0,0,910,3,0,1.0
2320,7,1270,2.25,0,0,1050,5,0,1.0
1780,8,1780,2.5,0,0,0,3,0,2.0
1740,7,1640,1.5,0,0,100,3,0,1.5
1060,6,560,0.75,0,2,500,2,1,1.0
2800,9,2800,2.5,0,0,0,4,0,2.0
1180,6,1180,1.0,0,0,0,3,0,1.0
2590,8,2590,1.75,0,0,0,3,0,1.0
1180,8,1180,1.5,0,0,0,2,0,3.0
1870,7,1870,2.5,0,0,0,3,0,2.0
1160,7,1160,1.0,0,0,0,3,0,1.0
3569,10,3569,3.25,0,0,0,4,0,2.0
1260,7,1260,1.75,0,0,0,5,0,1.5
1100,6,820,1.0,0,0,280,1,0,1.0
2070,9,1270,2.5,0,0,800,3,0,1.5
720,6,720,1.0,0,0,0,1,0,1.0
3160,8,3160,2.5,0,0,0,4,0,2.0
1290,7,1060,1.75,0,0,230,3,0,2.0
2170,8,2170,2.5,0,2,0,2,0,1.0
2320,7,2320,2.0,0,0,0,3,0,1.0
1850,9,1850,2.25,0,0,0,3,0,2.0
1460,7,1460,1.75,0,0,0,2,0,1.0
1230,7,990,2.0,0,0,240,3,0,1.0
2320,7,1290,1.75,0,0,1030,5,0,1.0
2120,7,1720,2.0,0,0,400,4,0,1.5
1740,7,1740,1.0,0,0,0,4,0,1.5
1240,7,1240,1.5,0,0,0,3,0,1.0
4560,12,2230,3.5,1,3,2330,4,0,1.0
2320,7,2320,2.5,0,0,0,4,0,2.0
1390,7,1090,1.5,0,0,300,3,0,1.0
1880,7,1280,1.75,0,0,600,4,0,1.0
2320,8,2320,2.0,0,0,0,6,0,2.0
1530,7,1530,1.0,0,0,0,3,0,1.5
1360,7,1360,2.5,0,0,0,3,0,2.0
2260,7,2260,3.0,0,0,0,3,0,2.0
3210,10,3210,2.5,0,0,0,4,0,2.0
3390,8,2190,1.0,0,0,1200,4,0,1.5
1670,7,1300,2.5,0,0,370,3,0,1.0
1150,6,1150,1.5,0,0,0,3,0,1.0
2410,7,2410,2.5,0,0,0,4,0,2.0
1970,8,1680,2.25,0,0,290,3,0,2.0
1350,8,1350,1.75,0,0,0,2,0,1.0
2580,8,2580,2.5,1,0,0,4,0,2.0
2720,7,1530,2.5,0,0,1190,5,0,1.5
1000,7,1000,1.0,1,0,0,3,0,1.0
1240,7,1240,2.5,0,0,0,2,0,2.0
1660,8,1660,2.5,0,0,0,3,0,2.0
1890,9,1510,3.0,0,0,380,4,0,1.0
960,6,960,1.0,0,0,0,3,0,1.0
1760,8,1760,1.5,0,0,0,3,0,2.0
1180,7,1180,1.0,0,0,0,3,0,1.0
1080,7,1080,1.0,0,0,0,2,0,1.5
3600,11,3600,2.5,0,0,0,4,0,2.0
1530,8,1530,2.5,0,0,0,3,0,3.0
2300,7,2300,2.5,0,0,0,4,0,2.0
3060,10,3060,2.25,1,0,0,3,0,2.0
1510,7,1510,1.75,0,0,0,3,0,1.0
2390,7,2390,3.0,0,0,0,6,0,2.0
1930,7,1230,1.75,0,0,700,3,0,1.0
1540,7,770,2.0,0,0,770,4,0,1.0
1210,7,1210,1.75,0,0,0,2,0,1.0
1040,6,1040,1.5,0,0,0,2,0,1.5
940,7,810,1.5,0,0,130,2,0,1.0
1747,6,1747,1.0,0,0,0,2,0,2.5
2070,7,2070,2.5,0,0,0,4,0,2.0
2280,8,1460,1.75,0,0,820,3,0,1.0
1300,8,1300,1.75,0,0,0,3,0,1.0
1120,7,1120,1.0,0,0,0,2,0,1.0
1280,6,840,1.0,0,0,440,2,0,1.0
1710,8,1300,2.5,0,0,410,3,0,2.0
2760,7,2760,2.5,0,0,0,4,0,2.0
3090,10,2250,2.5,0,0,840,2,0,1.0
1460,7,1460,1.0,0,0,0,3,0,1.5
1850,7,1850,2.5,0,0,0,4,0,2.0
2410,8,2410,2.5,0,0,0,4,0,2.0
1490,7,1010,1.5,0,0,480,3,0,1.0
1530,8,1530,3.0,0,0,0,3,0,2.0
1980,8,1980,1.75,0,0,0,3,0,2.0
800,6,800,1.0,0,0,0,2,0,1.0
1690,7,1690,2.5,0,0,0,3,0,2.0
1860,8,1860,2.5,0,0,0,3,0,2.0
2500,9,2500,2.5,0,0,0,4,0,2.0
3230,10,3230,2.5,0,0,0,4,0,2.0
1340,7,1340,1.5,0,0,0,3,0,1.0
1730,7,1260,1.75,0,0,470,3,0,1.0
1820,7,1820,2.5,0,0,0,4,0,2.0
2390,7,2390,2.0,0,0,0,3,0,2.0
1980,8,1980,2.5,0,0,0,4,0,2.0
2000,8,2000,2.0,0,0,0,4,0,1.5
2450,9,2450,2.5,0,0,0,3,0,2.0
1580,8,1290,1.5,0,0,290,3,0,1.0
4883,10,3859,4.25,0,3,1024,4,0,2.0
3980,9,3980,3.5,0,2,0,4,0,2.0
790,6,790,1.0,0,0,0,2,0,1.0
1300,6,1300,1.0,0,0,0,4,0,1.5
2720,8,1700,2.5,0,1,1020,2,0,1.0
2740,9,2740,2.5,0,0,0,3,0,2.0
2130,8,2130,2.5,0,0,0,4,0,2.0
1340,7,1340,1.75,0,0,0,3,0,1.0
1560,6,780,1.75,0,0,780,3,0,1.0
910,6,910,1.0,0,0,0,2,0,1.0
3070,10,3070,2.5,0,0,0,4,0,2.0
2230,7,1180,2.5,0,0,1050,4,0,1.0
2790,9,2790,2.5,0,0,0,4,0,2.0
4570,10,4570,2.5,1,0,0,5,0,2.0
1240,7,1240,1.0,0,0,0,3,0,1.0
800,6,800,1.0,0,0,0,2,0,1.0
1480,7,970,1.0,0,0,510,3,0,1.0
1640,7,1640,1.75,0,0,0,3,0,1.0
2200,8,1270,1.75,0,0,930,3,0,1.0
2980,10,2980,2.5,0,0,0,4,0,2.0
1200,8,1030,1.5,1,0,170,3,0,1.0
2290,8,2290,2.5,0,0,0,3,0,2.0
3000,8,1760,2.5,0,0,1240,3,0,1.0
1500,7,1500,2.5,0,0,0,3,0,2.0
4050,10,2780,4.0,1,0,1270,5,0,2.0
1340,7,1340,1.0,0,0,0,2,0,1.0
1790,7,1790,1.75,0,0,0,3,0,1.0
2490,8,1540,1.75,0,2,950,5,0,1.0
3470,9,3470,2.5,0,0,0,4,0,2.0
2130,7,1300,2.75,0,0,830,5,0,1.0
2330,9,2330,3.25,1,3,0,4,0,2.0
1170,7,740,1.75,0,0,430,2,0,1.0
1170,9,780,1.75,0,0,390,2,0,2.0
920,6,780,1.0,0,0,140,3,0,1.0
1270,8,1110,3.0,0,0,160,2,0,2.0
1020,7,1020,1.0,0,0,0,3,0,1.0
1510,6,1510,2.0,0,0,0,5,0,2.0
2720,8,2720,2.5,0,0,0,4,0,2.0
1810,7,1200,2.75,0,0,610,4,0,1.0
3530,8,2860,2.25,0,0,670,4,0,2.0
1502,7,1502,2.5,0,0,0,3,0,3.0
1540,6,770,1.75,0,0,770,3,0,1.0
1910,8,1270,1.0,0,0,640,3,0,1.0
1150,7,950,1.0,0,0,200,2,0,1.0
1970,7,1140,1.75,0,0,830,4,0,1.0
2680,8,2680,2.5,0,0,0,3,0,2.0
1790,8,1790,2.0,0,0,0,4,0,1.0
1530,9,1050,2.25,0,0,480,3,0,2.0
2780,8,1390,1.75,0,0,1390,5,0,1.0
1530,8,1530,1.0,0,0,0,3,0,2.0
1210,7,1210,2.0,0,0,0,4,0,1.0
1960,8,1960,2.5,0,0,0,3,0,2.0
1110,8,1110,1.75,0,0,0,2,0,2.0
1270,7,890,1.75,0,0,380,2,0,1.0
3030,8,3030,2.5,0,0,0,3,0,2.0
3150,9,3150,3.0,0,0,0,4,0,2.0
1870,8,1870,2.5,0,0,0,3,0,2.0
1250,6,1250,1.0,0,0,0,2,0,1.0
1660,7,1660,1.0,0,0,0,3,0,1.0
2550,9,2550,2.5,0,0,0,4,0,2.0
1180,7,1180,1.5,0,0,0,3,0,1.0
1740,7,1040,1.75,0,0,700,3,0,1.0
3070,9,1870,2.25,1,3,1200,4,0,1.0
2780,8,1590,2.5,1,0,1190,5,0,1.0
1390,7,1390,2.0,0,0,0,4,0,3.0
1480,7,740,1.75,0,0,740,4,0,1.0
1980,7,1470,2.5,0,0,510,3,0,2.0
1060,7,1060,1.75,0,0,0,3,0,1.0
1540,8,1540,1.75,0,0,0,3,0,3.0
2770,9,2770,2.5,0,0,0,4,0,2.0
1170,7,1170,1.0,0,0,0,3,0,1.0
1230,7,780,1.0,0,0,450,3,0,1.0
1340,5,1340,1.0,0,0,0,3,0,1.5
1270,6,1270,2.0,0,0,0,2,0,1.0
3790,8,2120,3.5,0,1,1670,5,0,1.0
2330,8,2330,2.5,0,0,0,4,0,2.0
2070,8,1370,3.5,0,0,700,3,0,1.0
1580,7,1580,2.5,0,0,0,3,0,2.0
1550,6,1550,1.0,0,0,0,4,0,1.5
1020,6,1020,1.0,0,0,0,2,0,1.0
1430,8,1340,2.25,0,0,90,2,0,2.0
1090,7,1090,2.5,0,0,0,3,0,1.0
1880,7,1880,2.5,0,0,0,3,0,2.0
2641,7,2641,2.5,0,0,0,4,0,2.0
1050,7,1050,1.0,0,0,0,3,0,1.0
1440,8,1440,2.5,0,0,0,3,0,3.0
1200,7,1090,1.0,1,2,110,2,0,2.0
1960,7,1960,2.25,0,0,0,4,0,2.0
1750,7,1150,2.25,0,0,600,3,0,1.0
2340,8,2340,2.25,0,0,0,5,0,2.0
2320,9,1930,3.25,0,0,390,3,0,2.0
1830,7,1550,1.0,0,0,280,3,0,1.0
1680,8,1200,1.75,0,0,480,3,0,1.0
1350,7,1350,1.75,0,0,0,3,0,1.0
2380,10,2380,2.5,0,0,0,4,0,2.0
1800,7,1800,2.5,0,0,0,3,0,2.0
2115,7,2115,2.25,0,0,0,4,0,2.0
1750,9,1470,2.25,0,0,280,3,0,2.5
1830,7,1290,2.0,0,0,540,3,0,1.5
2660,8,2660,2.5,0,0,0,4,0,2.0
1490,7,1490,1.75,0,0,0,3,0,1.0
1530,7,1530,2.5,0,0,0,3,0,2.0
1650,8,1300,1.0,0,0,350,3,0,1.0
4220,11,3420,3.75,1,2,800,5,0,2.0
2940,10,2940,2.75,0,0,0,3,0,2.0
940,7,940,1.0,0,0,0,2,0,1.0
1776,8,1604,2.5,0,0,172,3,0,3.0
820,5,820,1.0,0,0,0,2,0,1.0
2930,10,2930,2.5,0,0,0,3,0,2.0
2730,9,2730,2.5,0,0,0,4,0,2.0
2370,7,2370,2.5,0,0,0,3,0,2.0
1810,8,1810,2.5,0,0,0,3,0,2.0
5550,11,5550,4.25,0,0,0,4,0,2.0
2910,10,2910,2.5,1,0,0,4,0,2.0
1010,8,950,1.5,0,0,60,1,0,2.0
1700,7,950,2.0,0,0,750,2,0,1.0
1340,7,1090,1.75,0,0,250,3,0,1.0
1710,8,1510,2.5,0,0,200,3,0,3.0
1440,8,1180,2.25,0,0,260,3,0,1.0
2620,9,1430,2.25,0,3,1190,4,0,1.0
1950,8,1950,2.5,0,0,0,4,0,2.0
2370,8,1340,3.0,0,2,1030,5,0,1.5
1820,8,1820,1.75,0,0,0,3,0,2.0
1660,7,960,1.0,0,0,700,3,0,1.0
1930,8,1930,2.5,0,0,0,4,0,2.0
3220,9,3220,3.5,0,0,0,4,0,2.0
1400,7,1400,1.75,0,0,0,3,0,1.0
1340,7,1340,1.0,0,0,0,3,0,1.5
1250,7,1250,1.0,0,0,0,3,0,1.0
890,7,890,1.0,0,0,0,2,0,1.0
1250,6,1250,1.0,0,0,0,3,0,1.0
970,6,970,1.0,0,0,0,2,0,1.0
940,7,940,1.0,0,0,0,3,0,1.0
2160,8,2160,2.5,0,0,0,3,0,2.0
1330,7,1330,1.5,0,0,0,3,0,1.0
1639,8,1479,2.5,0,0,160,3,0,2.0
2910,10,2910,2.5,0,2,0,3,0,2.0
1380,7,1380,1.75,0,0,0,3,0,1.0
2300,7,2300,2.5,0,0,0,4,0,2.0
2290,8,1550,2.25,0,3,740,4,0,1.0
2798,9,2798,2.5,0,0,0,4,0,2.0
1400,7,1400,2.0,0,0,0,3,0,1.0
1780,9,1780,1.75,1,0,0,4,0,1.0
3010,8,1560,2.75,0,0,1450,4,0,1.0
2060,9,1500,1.75,0,0,560,3,0,2.0
2160,8,1960,2.5,0,0,200,3,0,1.5
1260,7,860,1.75,0,0,400,4,0,1.0
2300,8,2300,2.5,0,0,0,2,0,1.0
1280,7,1280,2.0,0,0,0,3,0,1.0
2840,9,1780,2.5,0,0,1060,4,0,1.0
840,6,840,1.0,0,0,0,3,0,1.0
940,7,940,1.0,1,0,0,3,0,1.0
3270,9,2470,2.25,1,2,800,5,0,2.0
1870,7,1870,2.0,0,0,0,5,0,1.5
3330,9,3330,3.25,0,0,0,4,0,2.0
1590,7,1110,2.5,0,0,480,3,0,2.0
1060,6,770,1.0,0,0,290,2,0,1.5
1320,7,870,1.75,0,0,450,3,0,1.0
1460,6,880,1.0,0,0,580,2,0,1.0
3080,9,3080,2.5,0,2,0,3,0,2.0
3010,8,3010,2.5,0,0,0,3,0,2.0
1690,7,1310,2.5,0,0,380,3,0,1.0
1930,8,1300,2.25,0,0,630,4,0,1.0
1500,7,1110,2.5,0,2,390,3,0,3.0
1770,7,1770,2.5,0,0,0,2,0,1.0
2520,8,1400,2.0,0,0,1120,4,0,1.0
2090,8,2090,2.75,0,0,0,3,0,2.0
1920,8,1920,2.5,0,0,0,3,0,2.0
1780,10,1780,2.0,0,0,0,1,0,2.0
1740,8,1280,1.75,0,0,460,2,0,1.0
3050,8,1650,2.75,1,0,1400,5,0,1.0
2090,8,1420,2.5,0,0,670,4,0,1.0
2370,9,1270,1.75,0,0,1100,4,0,1.0
1720,7,1720,1.75,1,0,0,3,0,1.0
2360,7,1560,1.0,0,0,800,3,0,1.0
2180,7,1330,2.75,0,0,850,4,0,1.0
2490,8,2490,3.5,0,0,0,4,0,2.0
1700,6,1700,1.75,0,0,0,3,0,1.5
1480,8,1480,1.0,1,0,0,3,0,2.0
2620,8,2620,3.0,0,0,0,4,0,2.0
1260,7,780,1.5,0,0,480,3,0,1.0
1980,7,1080,1.0,0,0,900,3,0,1.0
1360,6,1360,1.0,0,0,0,3,0,1.5
1620,9,1080,1.5,0,0,540,2,0,2.0
1600,7,1390,1.0,0,0,210,2,0,1.0
1410,8,1140,3.0,0,0,270,2,0,2.0
830,6,830,1.0,0,0,0,2,0,1.0
1530,7,1116,2.25,0,0,414,3,0,2.0
2710,9,2710,2.5,0,0,0,4,0,2.0
2020,7,1250,2.5,0,0,770,3,0,1.0
1484,7,1484,2.5,0,0,0,3,0,3.0
840,6,840,1.0,0,0,0,3,0,1.0
2020,8,2020,2.5,1,0,0,3,0,2.0
2640,7,1500,1.75,0,0,1140,4,0,1.0
1490,7,1490,2.5,0,0,0,3,0,2.0
4420,11,3510,4.25,0,0,910,5,0,2.0
3000,8,3000,2.5,0,0,0,4,0,2.0
2550,8,1440,2.75,0,0,1110,4,0,1.0
2280,8,2280,2.5,0,0,0,3,0,2.0
1810,8,1210,1.5,0,0,600,4,0,1.0
1770,7,1770,2.5,0,0,0,4,0,2.0
1200,6,1200,1.0,0,0,0,4,0,1.5
1470,7,1020,1.0,0,0,450,3,0,1.0
1790,8,1790,2.25,0,0,0,3,0,1.0
3030,8,2150,3.25,0,0,880,5,0,2.0
960,5,960,1.0,0,0,0,3,0,1.0
1240,8,1240,1.25,0,0,0,2,0,2.0
2420,8,2420,1.75,0,1,0,3,0,2.0
2050,8,2050,2.75,0,0,0,4,0,2.0
2280,8,2280,2.25,0,2,0,3,0,2.0
3430,9,3430,2.5,0,0,0,3,0,2.0
1840,7,960,2.0,0,0,880,3,0,1.0
2520,8,2520,2.5,0,0,0,4,0,2.0
1720,7,1020,1.75,0,0,700,4,0,1.0
1700,8,1200,1.75,0,0,500,3,0,1.0
3880,7,3880,2.5,0,0,0,6,0,2.0
2830,9,2830,2.75,0,0,0,5,0,2.0
2390,10,1980,2.25,0,1,410,3,0,1.0
1800,7,1200,2.5,0,0,600,4,0,1.0
1260,7,1260,1.0,0,0,0,2,0,1.0
2050,9,2050,2.5,0,0,0,3,0,2.0
2060,8,2060,2.5,0,0,0,3,0,2.0
2020,7,1010,1.75,0,0,1010,4,0,1.0
2510,8,1520,2.5,0,0,990,4,0,1.0
1230,7,1020,2.0,0,0,210,3,0,2.0
1250,7,1250,1.75,0,0,0,3,0,1.0
1190,7,1190,2.5,0,0,0,3,0,2.0
960,6,580,1.75,0,0,380,4,0,1.0
590,6,590,1.0,0,0,0,2,0,1.0
2850,9,2850,2.5,0,0,0,4,0,2.0
840,6,840,1.0,0,0,0,3,0,1.0
2570,9,2570,2.5,0,0,0,4,0,2.0
1460,7,1460,2.5,1,0,0,3,0,1.0
1770,8,1770,2.25,0,0,0,4,0,2.0
2430,7,1370,3.0,0,0,1060,5,0,1.0
790,7,790,1.0,0,0,0,2,0,1.0
1400,9,1400,2.25,0,0,0,3,0,2.0
1500,7,1210,2.25,0,0,290,3,0,1.0
2060,9,1610,2.25,1,0,450,3,0,1.0
1730,8,1730,2.0,0,0,0,3,0,1.0
1150,6,1150,1.75,1,0,0,3,0,1.5
1980,7,1980,3.25,0,0,0,3,0,3.0
2530,7,2530,2.25,0,0,0,5,0,2.0
1080,7,1080,1.75,0,0,0,2,0,2.0
2497,8,2497,2.5,0,0,0,3,0,2.0
2040,9,2040,2.25,0,0,0,3,0,2.0
2370,9,2370,2.5,0,0,0,3,0,2.0
2080,8,2080,2.25,0,0,0,3,0,2.0
4270,9,4270,3.5,0,0,0,4,0,2.0
2870,7,1520,3.5,0,0,1350,7,0,1.0
1300,7,1300,1.0,0,0,0,3,0,1.0
2620,8,1970,3.5,0,0,650,3,0,2.0
3480,7,1750,2.5,0,0,1730,3,0,1.0
2900,8,1520,2.0,0,2,1380,3,0,1.0
1980,7,1980,1.5,0,0,0,3,0,1.0
1700,7,850,1.75,1,0,850,4,0,1.0
2800,7,1400,3.0,0,2,1400,7,0,1.0
2815,9,2815,3.5,0,0,0,5,0,2.0
3190,10,2300,2.25,0,0,890,4,0,2.0
1760,7,940,1.75,0,0,820,2,0,1.0
2010,8,2010,2.0,0,2,0,3,0,1.5
1970,7,1370,2.25,0,0,600,4,0,1.0
2400,8,1640,3.5,0,0,760,6,0,2.0
1900,5,1900,1.0,0,0,0,3,0,1.5
1750,8,1750,2.75,0,0,0,4,0,1.5
1670,7,990,1.75,0,0,680,3,0,1.0
1090,7,1090,1.0,0,0,0,3,0,1.0
3190,9,3190,2.5,0,0,0,5,0,2.0
1710,8,1710,1.75,0,0,0,3,0,1.0
1060,6,1060,1.0,0,0,0,2,0,1.5
2190,8,1170,2.5,1,2,1020,4,0,1.0
710,6,710,1.0,0,0,0,2,0,1.0
2930,9,2930,2.5,0,2,0,3,0,2.0
1650,7,1230,2.75,0,0,420,3,0,1.0
2300,8,1550,2.0,0,0,750,4,0,1.5
2430,8,2430,3.0,0,0,0,4,0,2.0
1220,7,890,1.0,0,0,330,3,0,1.0
1310,7,1310,1.5,0,0,0,3,0,2.0
1170,7,1170,1.0,0,0,0,3,0,1.0
1320,9,1320,1.75,0,0,0,3,0,3.0
2040,8,1340,2.5,0,0,700,3,0,1.0
3828,9,3828,3.5,0,0,0,4,0,2.5
4350,11,4350,4.5,0,0,0,5,0,2.0
2500,9,2500,2.5,0,0,0,4,0,2.0
4630,11,4630,5.0,0,3,0,4,0,2.0
1600,6,1600,1.5,0,0,0,4,0,1.5
930,7,930,1.0,0,2,0,2,0,1.0
2340,8,2100,1.5,0,0,240,4,0,2.0
2190,7,1190,1.75,0,2,1000,5,0,1.0
3040,9,1970,3.0,1,0,1070,5,0,1.0
1810,8,1810,2.25,0,0,0,3,0,2.0
2460,7,1340,1.75,0,0,1120,5,0,1.5
1540,8,1540,2.0,1,0,0,3,0,2.0
1810,8,1810,2.5,0,0,0,3,0,2.0
2640,8,1760,2.5,0,0,880,6,0,2.0
950,6,950,1.0,0,0,0,2,0,1.0
960,6,740,1.0,0,0,220,2,0,1.0
4310,10,2510,2.5,0,4,1800,3,0,1.5
2320,8,2320,2.5,0,0,0,4,0,2.0
1030,7,1030,1.0,0,0,0,3,0,1.0
5190,11,5190,5.5,0,2,0,5,0,2.0
1060,8,1060,2.5,0,0,0,3,0,2.0
1810,8,1470,2.5,0,0,340,4,0,1.0
1660,7,1660,1.75,0,0,0,3,0,1.0
1010,7,1010,1.0,0,0,0,3,0,1.0
2590,8,2590,2.5,0,0,0,4,0,2.0
700,6,700,1.0,0,0,0,2,0,1.0
1560,7,1560,2.5,0,0,0,3,0,2.0
950,7,950,1.0,0,2,0,2,0,1.0
1790,7,1250,2.25,0,0,540,3,0,1.0
1750,7,1750,2.5,0,0,0,3,0,2.0
2710,7,1850,2.25,0,0,860,4,0,1.0
1470,7,1470,2.0,0,0,0,3,0,1.0
1840,7,1220,1.75,0,0,620,3,0,1.0
1180,7,1060,1.0,0,0,120,3,0,1.0
1820,7,1820,1.75,0,0,0,4,0,1.0
770,6,770,1.0,0,0,0,2,0,1.0
960,5,960,1.0,0,0,0,2,0,1.5
2360,7,1180,1.75,0,0,1180,3,0,1.0
2820,9,2820,2.75,0,0,0,3,0,2.0
1400,6,1100,1.0,0,0,300,2,0,1.5
1860,7,1320,2.0,0,0,540,3,0,1.0
1360,7,1000,1.75,0,0,360,3,0,1.0
2460,8,1620,2.5,1,0,840,4,0,2.0
3340,8,3340,2.25,0,0,0,5,0,2.0
4080,11,4080,2.5,1,2,0,4,0,2.0
1300,6,1300,1.0,0,0,0,3,0,2.0
1100,7,1100,1.0,0,0,0,3,0,1.0
3000,8,1500,2.0,0,0,1500,3,0,1.0
1200,7,1200,1.5,0,0,0,3,0,1.0
1840,7,980,1.75,0,0,860,4,0,1.0
901,7,901,1.5,0,0,0,2,0,3.0
2640,8,2640,2.5,0,0,0,4,0,2.0
1900,8,1900,1.5,0,0,0,3,0,1.0
2110,7,1640,3.0,0,2,470,4,0,1.5
930,6,930,1.0,0,0,0,2,0,1.0
1320,8,1320,1.0,0,0,0,3,0,1.0
800,6,800,1.0,0,0,0,2,0,1.0
2150,7,2150,1.0,0,0,0,5,0,1.5
2180,8,1680,2.25,0,0,500,4,0,1.0
1270,7,1270,1.75,0,0,0,3,0,1.0
1490,7,1490,1.0,0,0,0,3,0,1.0
3120,8,1560,2.75,0,4,1560,4,1,1.0
2530,7,1520,2.75,0,0,1010,5,0,1.0
1600,8,1600,1.75,1,0,0,3,0,1.0
1170,7,1170,1.75,0,0,0,3,0,1.0
2180,8,2180,2.25,0,0,0,4,0,2.0
1500,7,1500,1.0,0,0,0,3,0,1.0
1320,7,1320,1.0,0,0,0,2,0,1.0
700,6,700,1.0,0,0,0,2,0,1.0
1850,7,1850,2.75,0,0,0,3,0,1.5
1260,7,1260,1.75,0,0,0,3,0,1.0
1800,6,900,1.75,0,0,900,4,0,1.0
1160,7,1160,1.0,0,0,0,3,0,1.0
1460,8,1460,1.75,0,0,0,3,0,1.0
1060,7,1060,1.0,1,0,0,3,0,1.0
4150,9,3130,3.75,1,0,1020,4,0,1.0
3410,8,2410,2.25,0,0,1000,4,0,2.0
1020,7,1020,1.0,0,0,0,3,0,1.0
3020,8,1980,2.25,0,2,1040,3,0,3.0
4090,11,2920,3.5,0,0,1170,5,0,1.0
1240,7,1060,1.0,0,1,180,2,0,1.0
1620,7,1620,2.5,0,0,0,3,0,2.0
1590,7,1140,1.75,0,0,450,3,0,1.0
1300,7,1300,2.75,0,0,0,4,0,1.0
1250,7,1250,1.5,0,0,0,3,0,1.0
790,6,790,1.0,0,0,0,2,0,1.0
1912,8,1912,2.5,0,0,0,4,0,2.0
1710,8,1710,2.5,0,0,0,3,0,2.0
1070,6,1070,1.0,0,0,0,2,0,1.0
2380,8,1190,1.75,0,2,1190,3,0,1.0
2620,8,1350,2.75,0,0,1270,5,0,1.0
1960,8,1960,2.5,0,0,0,4,0,2.0
3430,7,2230,1.5,0,2,1200,3,0,1.0
2030,8,2030,2.5,0,0,0,3,0,2.0
1580,7,1580,2.75,0,0,0,3,0,2.0
2280,8,2280,1.75,0,0,0,3,0,2.0
1650,8,1650,1.75,0,0,0,4,0,1.0
3200,7,3200,3.5,0,0,0,5,0,2.0
2520,9,2520,2.5,0,1,0,3,0,2.0
1610,7,1510,1.0,0,0,100,4,0,1.5
2160,7,1320,3.0,0,0,840,4,0,1.0
1570,7,820,2.0,0,0,750,3,0,1.0
1470,6,900,1.0,0,0,570,2,0,1.0
1160,6,580,1.75,0,0,580,3,0,1.0
850,7,850,1.0,0,0,0,2,0,1.0
1210,7,1210,1.0,0,0,0,3,0,1.0
1520,7,1520,1.0,0,0,0,3,0,1.0
1740,8,1740,1.75,0,0,0,4,0,1.5
1890,8,1890,1.5,0,0,0,4,0,1.5
1550,8,1550,1.75,1,0,0,4,0,1.5
1800,7,1230,2.25,0,0,570,4,0,1.0
1090,6,1090,1.0,0,0,0,3,0,1.0
2080,8,2080,2.0,0,0,0,3,0,2.0
2980,8,2980,3.5,0,2,0,5,0,2.0
2110,8,1630,2.25,0,0,480,4,0,1.0
2160,8,1440,2.5,0,0,720,4,0,1.0
1020,7,1020,1.0,0,0,0,3,0,1.0
1970,7,1970,1.5,0,0,0,4,0,1.5
1100,7,780,1.0,0,0,320,2,0,1.0
1120,7,1120,1.0,0,0,0,2,0,1.5
3830,9,2440,2.25,0,2,1390,6,0,1.0
2390,8,1430,2.75,1,0,960,4,0,1.0
2300,8,2300,2.5,0,0,0,3,0,2.0
2860,10,2860,2.25,0,0,0,4,0,2.0
1300,8,1120,1.5,0,0,180,3,0,2.0
740,6,740,1.0,0,0,0,2,0,1.0
3400,8,2860,2.75,0,2,540,6,0,2.0
1850,6,1850,3.0,0,0,0,3,0,1.5
1170,6,1170,2.0,0,0,0,3,0,1.0
1720,9,1720,2.0,0,0,0,3,0,1.0
4350,10,4350,3.75,1,0,0,4,0,2.0
3800,9,3800,3.25,0,3,0,3,0,2.0
940,6,940,1.0,0,0,0,3,0,1.0
2650,8,1350,2.25,0,1,1300,5,0,1.0
2540,8,1640,2.5,1,0,900,4,0,1.0
1070,7,1070,1.0,0,0,0,3,0,1.0
1480,9,1180,2.5,0,0,300,3,0,2.0
1780,7,1780,2.0,0,0,0,4,0,1.0
1410,7,910,2.0,0,0,500,3,0,1.0
1360,7,1360,1.0,0,0,0,3,0,1.0
2640,7,2640,2.5,0,0,0,5,0,2.0
3020,8,1510,1.75,1,0,1510,4,0,1.0
1760,8,1760,1.75,0,0,0,3,0,1.0
1380,8,1380,2.0,0,0,0,3,0,3.0
3550,9,3550,2.5,0,0,0,4,0,2.0
3010,9,3010,2.75,0,0,0,5,0,2.0
980,7,980,1.0,0,0,0,3,0,1.0
3340,8,2600,3.25,0,0,740,5,0,2.0
1470,8,1160,2.5,0,0,310,3,0,2.0
5310,10,3650,4.75,1,0,1660,7,0,2.0
3460,10,3460,3.5,0,0,0,3,0,2.0
2320,8,2320,2.5,0,0,0,4,0,2.0
1740,8,1740,2.0,1,0,0,4,0,1.0
1600,7,1070,1.75,0,0,530,3,0,1.0
2010,8,2010,2.25,0,0,0,3,0,2.0
2580,7,2580,2.5,0,0,0,4,0,2.0
2400,7,2400,3.0,0,0,0,6,0,2.0
1580,7,1580,2.0,1,0,0,4,0,1.0
2460,7,1230,2.0,0,0,1230,4,0,1.0
1010,8,1010,2.0,0,0,0,3,0,1.0
1460,8,1340,1.0,0,0,120,4,0,1.5
4115,9,4115,3.25,0,0,0,5,0,2.0
2060,8,1160,2.5,0,0,900,3,0,1.0
1460,8,1150,3.5,0,0,310,3,0,2.0
1520,6,1520,1.75,0,0,0,4,0,1.0
860,7,860,1.0,0,0,0,2,0,1.0
1380,7,1380,1.0,0,0,0,3,0,1.0
1100,7,1100,1.0,0,0,0,2,0,1.0
2030,7,1630,2.0,0,0,400,4,0,2.0
2860,8,2860,3.0,1,0,0,4,0,1.0
1880,8,1420,2.25,0,0,460,3,0,1.0
1350,7,1350,2.0,0,0,0,3,0,1.0
2130,8,1590,2.25,1,0,540,3,0,1.0
2530,8,1470,3.0,0,0,1060,4,0,1.0
3150,7,3150,3.5,0,0,0,4,0,2.0
1620,7,1120,1.0,0,0,500,3,0,1.0
2080,8,1400,2.5,0,0,680,4,0,1.0
3490,9,2610,3.75,0,0,880,4,0,2.0
1320,6,1320,1.0,0,0,0,2,0,1.5
2130,7,1430,1.75,0,0,700,3,0,1.0
2360,8,2360,2.0,0,0,0,3,0,1.0
1480,7,1140,1.75,0,0,340,3,0,2.0
3640,8,2740,3.0,0,0,900,4,0,2.0
3960,10,3960,5.0,0,0,0,5,0,2.0
1400,8,1160,2.5,0,0,240,2,0,2.0
2360,9,2360,2.25,0,0,0,3,0,1.0
2370,8,2370,2.0,0,0,0,4,0,2.0
2380,7,1540,2.25,0,0,840,4,0,1.0
